# Gboard Dictionary version:1
aavi	AA制	zh-CN
aba	爱不爱	zh-CN
abai	爱不爱	zh-CN
abg	熬不过	zh-CN
abgo	熬不过	zh-CN
abj	矮半截	zh-CN
abjp	矮半截	zh-CN
abl	阿波罗	zh-CN
ablo	阿波罗	zh-CN
abv	熬不住	zh-CN
abvu	熬不住	zh-CN
ade	安道尔	zh-CN
ader	安道尔	zh-CN
adl	按道理	zh-CN
adli	奥地利	zh-CN
aef	阿尔法	zh-CN
aefa	阿尔法	zh-CN
ael	爱尔兰	zh-CN
aelj	爱尔兰	zh-CN
afh	阿富汗	zh-CN
afhj	阿富汗	zh-CN
aft	阿凡提	zh-CN
afti	阿凡提	zh-CN
agl	安哥拉	zh-CN
agla	安哥拉	zh-CN
agt	阿根廷	zh-CN
agtk	阿根廷	zh-CN
agv	爱国者	zh-CN
agve	爱国者	zh-CN
ahu	安徽省	zh-CN
ahug	安徽省	zh-CN
ahv	爱好者	zh-CN
ahve	爱好者	zh-CN
ail	按常理	zh-CN
aizu	阿昌族	zh-CN
ajl	安静了	zh-CN
ajle	安静了	zh-CN
ajs	氨基酸	zh-CN
ajsr	氨基酸	zh-CN
alb	阿拉伯	zh-CN
alba	阿鲁巴	zh-CN
albo	阿拉伯	zh-CN
ald	阿拉丁	zh-CN
aldk	阿拉丁	zh-CN
alh	安理会	zh-CN
alhv	安理会	zh-CN
alq	阿联酋	zh-CN
alqq	阿联酋	zh-CN
als	安乐死	zh-CN
alsi	安乐死	zh-CN
alu	按理说	zh-CN
aluj	阿里山	zh-CN
aluo	按理说	zh-CN
alw	安乐窝	zh-CN
alwo	安乐窝	zh-CN
amy	安眠药	zh-CN
amyc	安眠药	zh-CN
amz	爱面子	zh-CN
amzi	爱面子	zh-CN
aqg	安全感	zh-CN
aqgj	安全感	zh-CN
aqh	爱琴海	zh-CN
aqhd	爱琴海	zh-CN
aqj	安全局	zh-CN
aqju	安全局	zh-CN
aqp	爱情片	zh-CN
aqpm	爱情片	zh-CN
ask	奥斯卡	zh-CN
aska	奥斯卡	zh-CN
asl	奥斯陆	zh-CN
aslu	奥斯陆	zh-CN
atj	凹透镜	zh-CN
atjk	凹透镜	zh-CN
atu	安徒生	zh-CN
atug	安徒生	zh-CN
aum	阿诗玛	zh-CN
auma	阿诗玛	zh-CN
avb	安装版	zh-CN
avbj	安装版	zh-CN
awh	奥委会	zh-CN
awhv	奥委会	zh-CN
ayh	奥运会	zh-CN
ayhv	奥运会	zh-CN
azb	艾滋病	zh-CN
azbk	艾滋病	zh-CN
baq	不安全	zh-CN
bazu	保安族	zh-CN
bbbi	并不比	zh-CN
bbdc	办不到	zh-CN
bbde	巴不得	zh-CN
bbh	并不会	zh-CN
bbi	办不成	zh-CN
bbig	办不成	zh-CN
bbk	不包括	zh-CN
bbko	不包括	zh-CN
bbl	八百里	zh-CN
bbly	巴比伦	zh-CN
bbq	北半球	zh-CN
bbqq	北半球	zh-CN
bbt	棒棒糖	zh-CN
bbth	棒棒糖	zh-CN
bbu	并不是	zh-CN
bbuh	比不上	zh-CN
bbui	并不是	zh-CN
bbv	八宝粥	zh-CN
bbvz	八宝粥	zh-CN
bbwj	北部湾	zh-CN
bby	不必要	zh-CN
bbyc	不必要	zh-CN
bbyh	北冰洋	zh-CN
bbz	半辈子	zh-CN
bbzi	半辈子	zh-CN
bcl	不错了	zh-CN
bdb	不得不	zh-CN
bdd	不单单	zh-CN
bddj	不单单	zh-CN
bdfg	白癜风	zh-CN
bdi	不动产	zh-CN
bdij	不动产	zh-CN
bdj	不对劲	zh-CN
bdl	不得了	zh-CN
bdli	背地里	zh-CN
bdln	不得了	zh-CN
bdq	不定期	zh-CN
bdqi	不定期	zh-CN
bds	不打算	zh-CN
bdsr	不打算	zh-CN
bdv	别当真	zh-CN
bdvf	别当真	zh-CN
bdw	本单位	zh-CN
bdx	北斗星	zh-CN
bdy	不等于	zh-CN
bdyi	不得已	zh-CN
bdyk	不答应	zh-CN
bdz	半吊子	zh-CN
beg	巴尔干	zh-CN
begj	巴尔干	zh-CN
bfbd	百分百	zh-CN
bfbi	百分比	zh-CN
bfbm	不方便	zh-CN
bfh	百分号	zh-CN
bfhc	百分号	zh-CN
bfhu	暴发户	zh-CN
bfq	不服气	zh-CN
bfuo	比方说	zh-CN
bfx	不放心	zh-CN
bfxb	不放心	zh-CN
bfy	暴风雨	zh-CN
bfyu	暴风雨	zh-CN
bfz	不负责	zh-CN
bfze	不负责	zh-CN
bgd	不敢当	zh-CN
bgdh	不敢当	zh-CN
bgjk	白骨精	zh-CN
bgjn	不干胶	zh-CN
bgl	不管了	zh-CN
bgle	不管了	zh-CN
bglu	不归路	zh-CN
bgpk	不公平	zh-CN
bgtz	包工头	zh-CN
bgui	办公室	zh-CN
bgv	半个钟	zh-CN
bgvs	半个钟	zh-CN
bgx	不高兴	zh-CN
bgxb	不甘心	zh-CN
bgy	半个月	zh-CN
bgyt	半个月	zh-CN
bgyu	不甘于	zh-CN
bhb	不会吧	zh-CN
bhba	不会吧	zh-CN
bhdc	北海道	zh-CN
bhg	不合格	zh-CN
bhge	不合格	zh-CN
bhh	白花花	zh-CN
bhhx	白花花	zh-CN
bhl	不合理	zh-CN
bhld	不回来	zh-CN
bhma	巴哈马	zh-CN
bhq	不回去	zh-CN
bhqu	不回去	zh-CN
bhqy	不合群	zh-CN
bhre	不好惹	zh-CN
bhsj	保护伞	zh-CN
bhsr	不划算	zh-CN
bhui	不合适	zh-CN
bhuo	不好说	zh-CN
bhxk	保护性	zh-CN
bjde	不见得	zh-CN
bjg	不及格	zh-CN
bjh	比较好	zh-CN
bjj	不仅仅	zh-CN
bjle	不见了	zh-CN
bjlk	冰激凌	zh-CN
bjmg	不结盟	zh-CN
bjn	比基尼	zh-CN
bjni	比基尼	zh-CN
bjpb	保健品	zh-CN
bjq	不久前	zh-CN
bjrj	不尽然	zh-CN
bju	北京市	zh-CN
bjx	百家姓	zh-CN
bjy	不经意	zh-CN
bjz	败家子	zh-CN
bkl	不考虑	zh-CN
bklv	不考虑	zh-CN
bkn	不可能	zh-CN
bkng	不可能	zh-CN
bkpu	不靠谱	zh-CN
bkx	不开心	zh-CN
bkxb	不开心	zh-CN
bky	不可以	zh-CN
blb	玻璃杯	zh-CN
blbo	白萝卜	zh-CN
blc	不理睬	zh-CN
blcd	不理睬	zh-CN
bld	便利店	zh-CN
bldi	白兰地	zh-CN
bldm	便利店	zh-CN
blf	别浪费	zh-CN
blfw	别浪费	zh-CN
blg	巴拉圭	zh-CN
blgv	巴拉圭	zh-CN
blh	博览会	zh-CN
blhv	博览会	zh-CN
bli	碧螺春	zh-CN
bliy	碧螺春	zh-CN
blj	不了解	zh-CN
bljp	不了解	zh-CN
bljy	八路军	zh-CN
blk	不离开	zh-CN
blkd	不离开	zh-CN
bll	不聊了	zh-CN
blle	不聊了	zh-CN
blm	爆冷门	zh-CN
blmf	爆冷门	zh-CN
blmi	菠萝蜜	zh-CN
blp	舶来品	zh-CN
blpb	舶来品	zh-CN
blq	保龄球	zh-CN
blqq	保龄球	zh-CN
blt	柏拉图	zh-CN
bltu	柏拉图	zh-CN
blu	不论是	zh-CN
blui	比利时	zh-CN
blv	避雷针	zh-CN
blvf	避雷针	zh-CN
blw	芭蕾舞	zh-CN
blwu	芭蕾舞	zh-CN
bly	不利于	zh-CN
blyu	不利于	zh-CN
blz	伯利兹	zh-CN
blzu	布朗族	zh-CN
bmb	不明白	zh-CN
bmn	本命年	zh-CN
bmnm	本命年	zh-CN
bmvh	不买账	zh-CN
bmvz	北美洲	zh-CN
bmy	并没有	zh-CN
bmys	兵马俑	zh-CN
bndu	本年度	zh-CN
bnf	不耐烦	zh-CN
bnfj	不耐烦	zh-CN
bnl	别闹了	zh-CN
bnma	巴拿马	zh-CN
bnv	白内障	zh-CN
bph	不平衡	zh-CN
bphg	不平衡	zh-CN
bpi	不排除	zh-CN
bps	不怕死	zh-CN
bpu	白皮书	zh-CN
bpy	不便宜	zh-CN
bqd	不确定	zh-CN
bqdk	不确定	zh-CN
bqi	不清楚	zh-CN
bqiu	不清楚	zh-CN
bql	冰淇淋	zh-CN
bqlb	冰淇淋	zh-CN
bqr	不求人	zh-CN
bqrf	不求人	zh-CN
bqt	包青天	zh-CN
bqtm	包青天	zh-CN
bqy	不起眼	zh-CN
brd	不认得	zh-CN
brde	不认得	zh-CN
brh	白热化	zh-CN
brm	白日梦	zh-CN
brmg	白日梦	zh-CN
brq	哺乳期	zh-CN
brqi	哺乳期	zh-CN
bru	比如说	zh-CN
brui	不认识	zh-CN
bruo	不如说	zh-CN
brv	不认账	zh-CN
brx	必然性	zh-CN
brxk	包容性	zh-CN
bry	不容易	zh-CN
bryi	不容易	zh-CN
bsl	变色龙	zh-CN
bsls	变色龙	zh-CN
bsu	不算数	zh-CN
bsuu	不算数	zh-CN
bsw	波斯湾	zh-CN
bswj	波斯湾	zh-CN
bsx	不死心	zh-CN
bsxb	不死心	zh-CN
btd	不太懂	zh-CN
btds	不太懂	zh-CN
btf	白头发	zh-CN
btfa	白头发	zh-CN
bth	不太好	zh-CN
bthc	不太好	zh-CN
bti	不提倡	zh-CN
btih	不提倡	zh-CN
btj	不推荐	zh-CN
btjm	不推荐	zh-CN
btl	别提了	zh-CN
btle	拜托了	zh-CN
btm	半透明	zh-CN
btmk	半透明	zh-CN
btq	不听劝	zh-CN
btqr	趵突泉	zh-CN
btt	扁桃体	zh-CN
btti	扁桃体	zh-CN
btu	半桶水	zh-CN
btuv	半桶水	zh-CN
btw	别太晚	zh-CN
btwg	白头翁	zh-CN
btx	不太像	zh-CN
bty	不同意	zh-CN
btyi	不同意	zh-CN
btyu	不同于	zh-CN
bub	不是吧	zh-CN
buba	不是吧	zh-CN
bud	辨识度	zh-CN
buh	不适合	zh-CN
bui	办事处	zh-CN
buiu	办事处	zh-CN
bule	不说了	zh-CN
bum	不是吗	zh-CN
buw	不失为	zh-CN
buy	不适应	zh-CN
bvd	不知道	zh-CN
bvdc	不知道	zh-CN
bvde	不值得	zh-CN
bvdn	不着调	zh-CN
bvf	辩证法	zh-CN
bvfa	辩证法	zh-CN
bvh	标准化	zh-CN
bvi	不支持	zh-CN
bvii	不支持	zh-CN
bvj	不着急	zh-CN
bvjb	保证金	zh-CN
bvm	不知名	zh-CN
bvmk	不知名	zh-CN
bvq	不值钱	zh-CN
bvqi	保质期	zh-CN
bvqk	不知情	zh-CN
bvqm	不值钱	zh-CN
bvqt	不正确	zh-CN
bvqu	不知趣	zh-CN
bvr	班主任	zh-CN
bvrf	班主任	zh-CN
bvt	不折腾	zh-CN
bvtg	不折腾	zh-CN
bvtk	不中听	zh-CN
bvu	不只是	zh-CN
bvui	不只是	zh-CN
bvv	标志着	zh-CN
bvve	标志着	zh-CN
bvw	不指望	zh-CN
bvx	标志性	zh-CN
bvxk	标志性	zh-CN
bvy	不至于	zh-CN
bwd	不稳定	zh-CN
bwdk	不稳定	zh-CN
bwg	博物馆	zh-CN
bwhu	不外乎	zh-CN
bwqr	包围圈	zh-CN
bwv	保卫战	zh-CN
bwwa	布娃娃	zh-CN
bxb	便携版	zh-CN
bxba	不行吧	zh-CN
bxbk	白血病	zh-CN
bxd	不晓得	zh-CN
bxde	不晓得	zh-CN
bxf	不相符	zh-CN
bxfa	变戏法	zh-CN
bxfu	不相符	zh-CN
bxg	不习惯	zh-CN
bxgr	不习惯	zh-CN
bxh	不喜欢	zh-CN
bxhj	不稀罕	zh-CN
bxhr	不喜欢	zh-CN
bxhx	不像话	zh-CN
bxi	别瞎扯	zh-CN
bxif	不相称	zh-CN
bxj	步行街	zh-CN
bxjp	步行街	zh-CN
bxl	不行了	zh-CN
bxle	不行了	zh-CN
bxm	不行吗	zh-CN
bxma	不行吗	zh-CN
bxn	不像你	zh-CN
bxni	不像你	zh-CN
bxp	必需品	zh-CN
bxpb	必需品	zh-CN
bxq	保修期	zh-CN
bxqi	保修期	zh-CN
bxu	半小时	zh-CN
bxui	八小时	zh-CN
bxw	不希望	zh-CN
bxwh	不希望	zh-CN
bxx	不小心	zh-CN
bxxb	不相信	zh-CN
bxxp	不信邪	zh-CN
bxy	不需要	zh-CN
bxyc	不需要	zh-CN
bxyu	不屑于	zh-CN
byb	不一般	zh-CN
bybj	不一般	zh-CN
byc	贬义词	zh-CN
byci	褒义词	zh-CN
byd	不一定	zh-CN
bydi	比亚迪	zh-CN
bydk	不一定	zh-CN
byf	八月份	zh-CN
byff	八月份	zh-CN
byg	不应该	zh-CN
bygd	不应该	zh-CN
bygr	不用管	zh-CN
byh	边缘化	zh-CN
byj	不要紧	zh-CN
byjb	不要紧	zh-CN
byl	不用了	zh-CN
bylm	不要脸	zh-CN
byn	比翼鸟	zh-CN
bynn	比翼鸟	zh-CN
byq	变压器	zh-CN
byqi	变压器	zh-CN
byt	不要太	zh-CN
bytc	避孕套	zh-CN
byu	不要说	zh-CN
byug	毕业生	zh-CN
byuo	不要说	zh-CN
byv	不一致	zh-CN
byvi	不一致	zh-CN
byw	本以为	zh-CN
byww	本以为	zh-CN
byx	不允许	zh-CN
byxk	必要性	zh-CN
byxl	不影响	zh-CN
byxp	不用谢	zh-CN
byy	不一样	zh-CN
byyc	避孕药	zh-CN
byyi	不愿意	zh-CN
byyu	不亚于	zh-CN
byz	布依族	zh-CN
byzo	白羊座	zh-CN
byzu	布依族	zh-CN
bzh	不在乎	zh-CN
bzhu	不在乎	zh-CN
bzi	不赞成	zh-CN
bzig	不赞成	zh-CN
bzih	不在场	zh-CN
bzj	不在家	zh-CN
bzjt	不自觉	zh-CN
bzjx	不在家	zh-CN
bzl	不早了	zh-CN
bzle	不早了	zh-CN
bzm	不怎么	zh-CN
bzme	不怎么	zh-CN
bzq	不足取	zh-CN
bzqu	不足取	zh-CN
bzr	不自然	zh-CN
bzrj	不自然	zh-CN
bzu	不早说	zh-CN
bzug	不吱声	zh-CN
bzui	不再是	zh-CN
bzuo	不早说	zh-CN
bzw	不作为	zh-CN
bzww	不作为	zh-CN
bzy	不在意	zh-CN
bzyi	不足以	zh-CN
bzyu	不在于	zh-CN
bzz	不自在	zh-CN
bzzd	不自在	zh-CN
cahv	残奥会	zh-CN
cbc	从不曾	zh-CN
cbcg	从不曾	zh-CN
cbd	猜不到	zh-CN
cbdc	猜不到	zh-CN
cbl	错不了	zh-CN
cbln	错不了	zh-CN
cbq	擦边球	zh-CN
cbqq	擦边球	zh-CN
cbu	才不是	zh-CN
cbui	才不是	zh-CN
cbz	错别字	zh-CN
cbzi	错别字	zh-CN
ccp	残次品	zh-CN
ccpb	残次品	zh-CN
cgj	踩过界	zh-CN
cgjp	踩过界	zh-CN
cgl	错过了	zh-CN
cgle	错过了	zh-CN
chj	催化剂	zh-CN
chji	催化剂	zh-CN
chl	词汇量	zh-CN
cjxk	刺激性	zh-CN
ckn	才可能	zh-CN
ckng	才可能	zh-CN
clb	从来不	zh-CN
clbu	从来不	zh-CN
clc	擦了擦	zh-CN
clca	擦了擦	zh-CN
cld	催泪弹	zh-CN
cldj	催泪弹	zh-CN
cmq	催眠曲	zh-CN
cmqu	催眠曲	zh-CN
cmy	从没有	zh-CN
cmyz	从没有	zh-CN
cng	才能够	zh-CN
cngz	才能够	zh-CN
cpg	擦屁股	zh-CN
cpgu	擦屁股	zh-CN
cql	藏起来	zh-CN
cqld	藏起来	zh-CN
crn	凑热闹	zh-CN
crnc	凑热闹	zh-CN
ctz	醋坛子	zh-CN
ctzi	醋坛子	zh-CN
cub	测试版	zh-CN
cvj	财政局	zh-CN
cvju	财政局	zh-CN
cvy	侧重于	zh-CN
cxf	磁悬浮	zh-CN
cxfu	磁悬浮	zh-CN
cyb	搓衣板	zh-CN
cybj	搓衣板	zh-CN
cyc	猜一猜	zh-CN
cycd	猜一猜	zh-CN
cyd	参与度	zh-CN
cydu	参与度	zh-CN
czg	存在感	zh-CN
czgj	存在感	zh-CN
czt	操作台	zh-CN
cztd	操作台	zh-CN
dazu	德昂族	zh-CN
dbd	对不对	zh-CN
dbdc	得不到	zh-CN
dbds	动不动	zh-CN
dbdv	对不对	zh-CN
dbf	大部分	zh-CN
dbff	大部分	zh-CN
dbh	都不会	zh-CN
dbhu	东北虎	zh-CN
dbhv	都不会	zh-CN
dbi	打不出	zh-CN
dbj	等不及	zh-CN
dbji	等不及	zh-CN
dbjq	低不就	zh-CN
dbk	打不开	zh-CN
dbkd	打不开	zh-CN
dbl	大不了	zh-CN
dbln	打不了	zh-CN
dbm	道不明	zh-CN
dbmk	道不明	zh-CN
dbn	都不能	zh-CN
dbnm	大半年	zh-CN
dbq	对不起	zh-CN
dbqi	对不起	zh-CN
dbr	倒不如	zh-CN
dbru	倒不如	zh-CN
dbt	大白天	zh-CN
dbts	打不通	zh-CN
dbu	倒不是	zh-CN
dbui	倒不是	zh-CN
dbv	对不住	zh-CN
dbvi	蛋白质	zh-CN
dbvu	对不住	zh-CN
dbx	代表性	zh-CN
dbxk	代表性	zh-CN
dbxl	电冰箱	zh-CN
dby	大本营	zh-CN
dbye	大半夜	zh-CN
dbyk	大本营	zh-CN
dbz	带不走	zh-CN
dbzo	代表作	zh-CN
dcl	打错了	zh-CN
dcyr	大草原	zh-CN
ddhe	丹顶鹤	zh-CN
ddhl	堵得慌	zh-CN
ddhx	打电话	zh-CN
ddie	电动车	zh-CN
ddl	得到了	zh-CN
ddp	电灯泡	zh-CN
ddpc	电灯泡	zh-CN
ddq	对得起	zh-CN
ddqi	对得起	zh-CN
ddt	点点头	zh-CN
ddv	东道主	zh-CN
ddwf	东帝汶	zh-CN
deb	第二遍	zh-CN
debm	第二遍	zh-CN
dec	第二次	zh-CN
deci	第二次	zh-CN
deg	第二个	zh-CN
dege	第二个	zh-CN
dely	第二轮	zh-CN
dem	第二名	zh-CN
demk	第二名	zh-CN
deq	大而全	zh-CN
deqr	大而全	zh-CN
deta	德尔塔	zh-CN
detm	第二天	zh-CN
deye	第二页	zh-CN
deyj	第二眼	zh-CN
dfb	电饭煲	zh-CN
dfbc	电饭煲	zh-CN
dfd	大幅度	zh-CN
dfdu	大幅度	zh-CN
dfh	东方红	zh-CN
dfhs	东方红	zh-CN
dfm	单方面	zh-CN
dfmm	单方面	zh-CN
dfn	豆腐脑	zh-CN
dfnc	豆腐脑	zh-CN
dfu	电风扇	zh-CN
dfv	豆腐渣	zh-CN
dfva	豆腐渣	zh-CN
dfw	大范围	zh-CN
dfww	大范围	zh-CN
dfx	地方性	zh-CN
dfxk	地方性	zh-CN
dgb	打个包	zh-CN
dgf	大锅饭	zh-CN
dgfj	大锅饭	zh-CN
dgg	顶呱呱	zh-CN
dggx	顶呱呱	zh-CN
dgi	胆固醇	zh-CN
dgiy	胆固醇	zh-CN
dglv	大概率	zh-CN
dgm	大规模	zh-CN
dgmo	大规模	zh-CN
dgn	多功能	zh-CN
dgq	打官腔	zh-CN
dgql	打官腔	zh-CN
dgs	打官司	zh-CN
dhe	等会儿	zh-CN
dher	待会儿	zh-CN
dhg	读后感	zh-CN
dhgj	读后感	zh-CN
dhi	大合唱	zh-CN
dhlj	德黑兰	zh-CN
dhs	导火索	zh-CN
dhso	导火索	zh-CN
dibf	低成本	zh-CN
dih	倒春寒	zh-CN
dihj	倒春寒	zh-CN
dil	洞察力	zh-CN
ditm	底朝天	zh-CN
djh	大家好	zh-CN
djt	电吉他	zh-CN
dju	倒计时	zh-CN
djxm	对角线	zh-CN
dkl	抵抗力	zh-CN
dkle	多亏了	zh-CN
dkn	都可能	zh-CN
dlb	得了吧	zh-CN
dlba	得了吧	zh-CN
dlc	大老粗	zh-CN
dlcu	大老粗	zh-CN
dld	多伦多	zh-CN
dldo	多伦多	zh-CN
dlg	第六感	zh-CN
dlgj	第六感	zh-CN
dlh	度量衡	zh-CN
dlhg	度量衡	zh-CN
dlj	邓丽君	zh-CN
dljy	邓丽君	zh-CN
dll	带来了	zh-CN
dlle	带来了	zh-CN
dlm	对立面	zh-CN
dlmm	对立面	zh-CN
dlq	多了去	zh-CN
dlqu	多了去	zh-CN
dlr	代理人	zh-CN
dlrf	代理人	zh-CN
dlt	大冷天	zh-CN
dlti	独联体	zh-CN
dltm	大冷天	zh-CN
dlu	大理石	zh-CN
dlui	大理石	zh-CN
dlv	顶梁柱	zh-CN
dlvu	顶梁柱	zh-CN
dlx	独立性	zh-CN
dlxk	独立性	zh-CN
dlxt	地理学	zh-CN
dly	大老远	zh-CN
dlyr	大老远	zh-CN
dlz	独龙族	zh-CN
dlzu	独龙族	zh-CN
dmc	代名词	zh-CN
dmq	独木桥	zh-CN
dmqn	独木桥	zh-CN
dmt	多媒体	zh-CN
dmv	大拇指	zh-CN
dne	低能儿	zh-CN
dnh	多瑙河	zh-CN
dnhe	多瑙河	zh-CN
dny	东南亚	zh-CN
dpd	大排档	zh-CN
dpm	大屏幕	zh-CN
dpmu	大屏幕	zh-CN
dpw	肚皮舞	zh-CN
dpwu	肚皮舞	zh-CN
dpx	地平线	zh-CN
dpxm	地平线	zh-CN
dqc	大气层	zh-CN
dqcg	大气层	zh-CN
dqh	电气化	zh-CN
dqhx	电气化	zh-CN
dql	躲起来	zh-CN
dqld	躲起来	zh-CN
dqv	当权者	zh-CN
dqve	当权者	zh-CN
dqx	地区性	zh-CN
dqy	大气压	zh-CN
dqya	大气压	zh-CN
dqz	兜圈子	zh-CN
dqzi	兜圈子	zh-CN
dri	单人床	zh-CN
drtj	电热毯	zh-CN
drw	大人物	zh-CN
dsb	第三遍	zh-CN
dsf	第三方	zh-CN
dsg	第三个	zh-CN
dsge	第三个	zh-CN
dsly	第三轮	zh-CN
dsmk	第三名	zh-CN
dsv	第三者	zh-CN
dtb	跌停板	zh-CN
dth	洞庭湖	zh-CN
dthu	洞庭湖	zh-CN
dtl	到头来	zh-CN
dtq	大提琴	zh-CN
dtqb	大提琴	zh-CN
dtt	断头台	zh-CN
dttd	断头台	zh-CN
dtu	大体上	zh-CN
dtue	地头蛇	zh-CN
dtv	打头阵	zh-CN
dtvf	打头阵	zh-CN
dtx	独特性	zh-CN
dtxk	独特性	zh-CN
dty	等同于	zh-CN
dtyu	等同于	zh-CN
dub	大手笔	zh-CN
dubm	多少遍	zh-CN
duc	多少次	zh-CN
duge	多少个	zh-CN
duhz	到时候	zh-CN
duni	迪士尼	zh-CN
dunm	多少年	zh-CN
dupn	打水漂	zh-CN
dur	多少人	zh-CN
durf	当事人	zh-CN
duru	低收入	zh-CN
dutd	电视台	zh-CN
dvd	都知道	zh-CN
dvdc	都知道	zh-CN
dvf	大丈夫	zh-CN
dvg	对着干	zh-CN
dvgj	对着干	zh-CN
dvh	大众化	zh-CN
dvhd	地中海	zh-CN
dvhu	打招呼	zh-CN
dvq	等着瞧	zh-CN
dvqn	等着瞧	zh-CN
dvx	大中型	zh-CN
dvxp	大闸蟹	zh-CN
dwj	端午节	zh-CN
dwjp	端午节	zh-CN
dwk	吊胃口	zh-CN
dwkz	吊胃口	zh-CN
dwl	都忘了	zh-CN
dwle	都忘了	zh-CN
dww	大无畏	zh-CN
dwww	大无畏	zh-CN
dwy	动物园	zh-CN
dwyr	动物园	zh-CN
dxb	大小便	zh-CN
dxbm	大小便	zh-CN
dxd	单行道	zh-CN
dxdc	单行道	zh-CN
dxe	店小二	zh-CN
dxer	店小二	zh-CN
dxf	东西方	zh-CN
dxfh	东西方	zh-CN
dxg	胆小鬼	zh-CN
dxgv	胆小鬼	zh-CN
dxh	都喜欢	zh-CN
dxhc	低消耗	zh-CN
dxhr	都喜欢	zh-CN
dxi	大学城	zh-CN
dxig	大学城	zh-CN
dxj	电信局	zh-CN
dxju	电信局	zh-CN
dxl	掉下来	zh-CN
dxld	掉下来	zh-CN
dxm	大熊猫	zh-CN
dxmc	大熊猫	zh-CN
dxq	掉下去	zh-CN
dxs	单相思	zh-CN
dxsi	单相思	zh-CN
dxu	大学生	zh-CN
dxug	大学生	zh-CN
dxui	地下室	zh-CN
dxw	定心丸	zh-CN
dxwj	定心丸	zh-CN
dxx	大小写	zh-CN
dxxk	大猩猩	zh-CN
dxxp	大小写	zh-CN
dxy	大西洋	zh-CN
dxyh	大西洋	zh-CN
dxz	东乡族	zh-CN
dxzu	东乡族	zh-CN
dyb	第一遍	zh-CN
dybm	第一遍	zh-CN
dybu	第一步	zh-CN
dyc	第一次	zh-CN
dyci	第一次	zh-CN
dyg	第一个	zh-CN
dyge	第一个	zh-CN
dyi	打圆场	zh-CN
dyih	打圆场	zh-CN
dyji	打印机	zh-CN
dyl	第一轮	zh-CN
dyls	独眼龙	zh-CN
dyly	第一轮	zh-CN
dym	第一名	zh-CN
dymk	第一名	zh-CN
dyn	第一年	zh-CN
dynm	第一年	zh-CN
dyr	代言人	zh-CN
dyrf	代言人	zh-CN
dytd	钓鱼台	zh-CN
dytm	第一天	zh-CN
dyu	打油诗	zh-CN
dyv	大洋洲	zh-CN
dyx	等一下	zh-CN
dyy	得益于	zh-CN
dyye	第一页	zh-CN
dyyh	都一样	zh-CN
dyyj	第一眼	zh-CN
dyyr	电影院	zh-CN
dyzi	多音字	zh-CN
dzh	大杂烩	zh-CN
dzji	打字机	zh-CN
dzk	丁字裤	zh-CN
dzl	肚子里	zh-CN
dzpm	动作片	zh-CN
dzq	打砸抢	zh-CN
dzql	打砸抢	zh-CN
dzvh	打嘴仗	zh-CN
dzy	打字员	zh-CN
ebe	饿不饿	zh-CN
ebee	饿不饿	zh-CN
ebf	耳边风	zh-CN
ebfg	耳边风	zh-CN
ebh	而不会	zh-CN
ebhv	而不会	zh-CN
ebhz	耳鼻喉	zh-CN
ebl	饿扁了	zh-CN
eble	饿扁了	zh-CN
ebn	而不能	zh-CN
ebng	而不能	zh-CN
ebq	而不去	zh-CN
ebqu	而不去	zh-CN
ebs	饿不死	zh-CN
ebsi	饿不死	zh-CN
ebu	而不是	zh-CN
ebui	而不是	zh-CN
ebw	二百五	zh-CN
ebwu	二百五	zh-CN
eby	而不用	zh-CN
ebys	而不用	zh-CN
edj	二等奖	zh-CN
edjl	二等奖	zh-CN
ege	恩格尔	zh-CN
eger	恩格尔	zh-CN
egt	二锅头	zh-CN
egtz	二锅头	zh-CN
ehh	恶狠狠	zh-CN
ehhf	恶狠狠	zh-CN
ehy	二合一	zh-CN
ehyb	儿化音	zh-CN
ehyi	二合一	zh-CN
eiu	二传手	zh-CN
eiuz	二传手	zh-CN
ejd	二季度	zh-CN
ejdu	二季度	zh-CN
ejv	二进制	zh-CN
ejvi	二进制	zh-CN
els	俄罗斯	zh-CN
elsi	俄罗斯	zh-CN
elz	二流子	zh-CN
elzi	二流子	zh-CN
emu	峨眉山	zh-CN
emuj	峨眉山	zh-CN
enj	二年级	zh-CN
enji	二年级	zh-CN
epf	耳旁风	zh-CN
epfg	耳旁风	zh-CN
epg	阿房宫	zh-CN
epgs	阿房宫	zh-CN
esl	饿死了	zh-CN
esle	饿死了	zh-CN
esu	二三十	zh-CN
esui	二三十	zh-CN
etj	儿童节	zh-CN
etjp	儿童节	zh-CN
eub	二十八	zh-CN
euba	二十八	zh-CN
eue	二十二	zh-CN
euer	二十二	zh-CN
euj	二十九	zh-CN
eujq	二十九	zh-CN
eul	二十六	zh-CN
eulq	二十六	zh-CN
euq	二十七	zh-CN
euqi	二十七	zh-CN
eus	二十四	zh-CN
eusi	二十四	zh-CN
eusj	二十三	zh-CN
eusv	二十岁	zh-CN
euw	二十五	zh-CN
euwu	二十五	zh-CN
euy	二十一	zh-CN
euyi	二十一	zh-CN
evi	二指禅	zh-CN
evij	二指禅	zh-CN
ewm	二维码	zh-CN
ewma	二维码	zh-CN
eyf	二月份	zh-CN
eyff	二月份	zh-CN
ezj	恶作剧	zh-CN
ezju	恶作剧	zh-CN
fbf	烦不烦	zh-CN
fbfj	烦不烦	zh-CN
fbi	发不出	zh-CN
fbiu	发不出	zh-CN
fbk	放不开	zh-CN
fbkd	分不开	zh-CN
fbl	分辨率	zh-CN
fblv	分辨率	zh-CN
fbm	方便面	zh-CN
fbmm	方便面	zh-CN
fbq	分不清	zh-CN
fbqk	分不清	zh-CN
fbu	分别是	zh-CN
fbui	分别是	zh-CN
fbv	犯不着	zh-CN
fbvc	犯不着	zh-CN
fbx	放不下	zh-CN
fbxx	放不下	zh-CN
fby	翻白眼	zh-CN
fbyj	翻白眼	zh-CN
fcl	发错了	zh-CN
fcle	发错了	zh-CN
fdd	肥嘟嘟	zh-CN
fddh	反对党	zh-CN
fddu	肥嘟嘟	zh-CN
fdg	梵蒂冈	zh-CN
fdgh	梵蒂冈	zh-CN
fdi	房地产	zh-CN
fdij	房地产	zh-CN
fdj	发动机	zh-CN
fdji	发动机	zh-CN
fdjk	放大镜	zh-CN
fdjn	佛得角	zh-CN
fdm	防盗门	zh-CN
fdmf	防盗门	zh-CN
fdp	反对派	zh-CN
fdpd	反对派	zh-CN
fdx	放得下	zh-CN
fdxx	放得下	zh-CN
fdy	辅导员	zh-CN
fdyr	辅导员	zh-CN
ffv	分分钟	zh-CN
fgju	房管局	zh-CN
fgld	反过来	zh-CN
fhl	肺活量	zh-CN
fhq	防火墙	zh-CN
fhql	防火墙	zh-CN
fib	非常棒	zh-CN
fibh	非常棒	zh-CN
fid	非常多	zh-CN
fida	非常大	zh-CN
fido	非常多	zh-CN
fif	非处方	zh-CN
fifh	非处方	zh-CN
fig	非常高	zh-CN
figc	非常高	zh-CN
fih	非常好	zh-CN
fihc	非常好	zh-CN
fii	非常差	zh-CN
fiia	非常差	zh-CN
fij	放长假	zh-CN
fijx	放长假	zh-CN
fik	非常快	zh-CN
fike	妇产科	zh-CN
fikk	非常快	zh-CN
fil	非常冷	zh-CN
filg	非常冷	zh-CN
fim	非常慢	zh-CN
fimj	非常慢	zh-CN
fin	非常难	zh-CN
finj	非常难	zh-CN
fip	副产品	zh-CN
fiq	非常强	zh-CN
fiql	非常强	zh-CN
fir	非常热	zh-CN
fire	非常热	zh-CN
fiu	方程式	zh-CN
fiui	方程式	zh-CN
fiv	房产证	zh-CN
fivg	房产证	zh-CN
fix	放长线	zh-CN
fixm	放长线	zh-CN
fjx	分界线	zh-CN
fkd	防空洞	zh-CN
fkds	防空洞	zh-CN
fkp	放空炮	zh-CN
fkpc	放空炮	zh-CN
flb	菲律宾	zh-CN
flbb	菲律宾	zh-CN
flf	福利费	zh-CN
flh	风凉话	zh-CN
flhx	风凉话	zh-CN
fli	分理处	zh-CN
fliu	分理处	zh-CN
fll	法拉利	zh-CN
flli	法拉利	zh-CN
flp	飞利浦	zh-CN
flpu	飞利浦	zh-CN
flx	法兰西	zh-CN
flxi	法兰西	zh-CN
fly	福利院	zh-CN
flyr	福利院	zh-CN
flz	负离子	zh-CN
flzi	负离子	zh-CN
fml	发霉了	zh-CN
fmle	发霉了	zh-CN
fmp	非卖品	zh-CN
fmpb	非卖品	zh-CN
fmq	父母亲	zh-CN
fmqb	父母亲	zh-CN
fmw	分泌物	zh-CN
fmwu	分泌物	zh-CN
fmy	驸马爷	zh-CN
fmye	驸马爷	zh-CN
fnl	服你了	zh-CN
fnle	服你了	zh-CN
fpl	废品率	zh-CN
fplv	废品率	zh-CN
fqj	番茄酱	zh-CN
fqjl	番茄酱	zh-CN
fql	放弃了	zh-CN
fqle	放弃了	zh-CN
fqv	肺气肿	zh-CN
fqvs	肺气肿	zh-CN
fqw	废弃物	zh-CN
frd	副热带	zh-CN
frdd	副热带	zh-CN
frj	缝纫机	zh-CN
frji	缝纫机	zh-CN
fsl	烦死了	zh-CN
fsle	烦死了	zh-CN
fsr	烦死人	zh-CN
fsrf	烦死人	zh-CN
fsx	发散性	zh-CN
fsxk	发散性	zh-CN
ftz	繁体字	zh-CN
ftzi	繁体字	zh-CN
fulk	分水岭	zh-CN
fulq	番石榴	zh-CN
fvf	反政府	zh-CN
fvfu	反政府	zh-CN
fvl	非主流	zh-CN
fvlq	非主流	zh-CN
fvlv	负债率	zh-CN
fvm	辅助码	zh-CN
fvma	辅助码	zh-CN
fvv	发展中	zh-CN
fvvs	发展中	zh-CN
fvx	辅助性	zh-CN
fvxk	辅助性	zh-CN
fvy	分之一	zh-CN
fvyi	分之一	zh-CN
fwi	俯卧撑	zh-CN
fwig	俯卧撑	zh-CN
fwx	服务性	zh-CN
fxd	发祥地	zh-CN
fxdi	发祥地	zh-CN
fxg	方向感	zh-CN
fxgj	方向感	zh-CN
fxj	法学家	zh-CN
fxjx	法学家	zh-CN
fxl	发现了	zh-CN
fxle	发现了	zh-CN
fxp	方向盘	zh-CN
fxpj	方向盘	zh-CN
fxs	法西斯	zh-CN
fxsi	法西斯	zh-CN
fxy	飞行员	zh-CN
fxyr	飞行员	zh-CN
fyc	反义词	zh-CN
fyci	反义词	zh-CN
fyd	发源地	zh-CN
fydi	发源地	zh-CN
fyj	复印件	zh-CN
fyjm	复印件	zh-CN
fyl	反映了	zh-CN
fyle	反映了	zh-CN
fyq	发言权	zh-CN
fyqr	发言权	zh-CN
fyr	发言人	zh-CN
fyrf	发言人	zh-CN
fyx	防御性	zh-CN
fyxk	防御性	zh-CN
fzr	负责人	zh-CN
fzy	副作用	zh-CN
fzys	副作用	zh-CN
gaj	公安局	zh-CN
gaju	公安局	zh-CN
gat	港澳台	zh-CN
gatd	港澳台	zh-CN
gbb	干巴巴	zh-CN
gbba	干巴巴	zh-CN
gbd	怪不得	zh-CN
gbde	怪不得	zh-CN
gbdk	搞不定	zh-CN
gbds	搞不懂	zh-CN
gbg	够不够	zh-CN
gbgj	敢不敢	zh-CN
gbh	搞不好	zh-CN
gbhc	搞不好	zh-CN
gbi	高不成	zh-CN
gbig	高不成	zh-CN
gbj	赶不及	zh-CN
gbji	赶不及	zh-CN
gbl	管不了	zh-CN
gbln	管不了	zh-CN
gbm	各部门	zh-CN
gbn	更不能	zh-CN
gbng	更不能	zh-CN
gbq	过不去	zh-CN
gbqk	搞不清	zh-CN
gbqu	过不去	zh-CN
gbt	搞半天	zh-CN
gbtj	戈壁滩	zh-CN
gbu	跟不上	zh-CN
gbuh	赶不上	zh-CN
gbuo	更别说	zh-CN
gbv	管不着	zh-CN
gbvc	管不着	zh-CN
gbvu	管不住	zh-CN
gbvy	高标准	zh-CN
gbx	鬼把戏	zh-CN
gbxi	鬼把戏	zh-CN
gby	个把月	zh-CN
gbya	冈比亚	zh-CN
gbyb	过把瘾	zh-CN
gbz	光膀子	zh-CN
gbzi	光膀子	zh-CN
gcl	搞错了	zh-CN
gcu	高才生	zh-CN
gdb	高蛋白	zh-CN
gdbd	高蛋白	zh-CN
gdp	GDP	zh-CN
gdpi	刮地皮	zh-CN
gdq	过得去	zh-CN
gdqu	过得去	zh-CN
gdu	跟得上	zh-CN
gdug	广东省	zh-CN
gdyj	干瞪眼	zh-CN
gefu	高尔夫	zh-CN
gfh	规范化	zh-CN
gfhx	规范化	zh-CN
gfl	搞反了	zh-CN
gfq	高峰期	zh-CN
gfqi	高峰期	zh-CN
gfx	规范性	zh-CN
gfxk	规范性	zh-CN
gfxm	高风险	zh-CN
ggjn	呱呱叫	zh-CN
ggzi	高个子	zh-CN
ghbc	高回报	zh-CN
ghfu	鬼画符	zh-CN
ghg	共和国	zh-CN
ghkl	更何况	zh-CN
gid	共产党	zh-CN
gidh	共产党	zh-CN
gij	歌唱家	zh-CN
gijx	歌唱家	zh-CN
gil	观察力	zh-CN
giq	滚出去	zh-CN
giqu	滚出去	zh-CN
giu	工程师	zh-CN
giui	工程师	zh-CN
giw	广场舞	zh-CN
giwj	刚吃完	zh-CN
giwu	广场舞	zh-CN
gjce	供给侧	zh-CN
gjfa	公检法	zh-CN
gji	公交车	zh-CN
gjj	公积金	zh-CN
gjjm	高精尖	zh-CN
gjz	关键字	zh-CN
gkj	高科技	zh-CN
gkji	高科技	zh-CN
gku	刚开始	zh-CN
gkx	公开信	zh-CN
gldd	高利贷	zh-CN
gll	孤零零	zh-CN
gllk	孤零零	zh-CN
gllv	高利率	zh-CN
gln	过两年	zh-CN
glr	过来人	zh-CN
glrf	过来人	zh-CN
glt	过两天	zh-CN
gltm	过两天	zh-CN
glvi	橄榄枝	zh-CN
glxk	规律性	zh-CN
gly	管理员	zh-CN
glzu	仡佬族	zh-CN
gmd	国民党	zh-CN
gmdh	国民党	zh-CN
gme	哥们儿	zh-CN
gmer	哥们儿	zh-CN
gmg	鬼门关	zh-CN
gmgr	鬼门关	zh-CN
gml	根目录	zh-CN
gmq	冠名权	zh-CN
gmqr	冠名权	zh-CN
gmv	擀面杖	zh-CN
gmvh	擀面杖	zh-CN
gmx	革命性	zh-CN
gnd	高难度	zh-CN
gndu	高难度	zh-CN
gnq	更年期	zh-CN
gnqi	更年期	zh-CN
gnx	功能性	zh-CN
gnxk	功能性	zh-CN
gpg	狗皮膏	zh-CN
gpgc	狗皮膏	zh-CN
gpi	跟屁虫	zh-CN
gpis	跟屁虫	zh-CN
gqd	过去的	zh-CN
gqde	过去的	zh-CN
gqj	国庆节	zh-CN
gqjp	国庆节	zh-CN
gql	过去了	zh-CN
gqle	过去了	zh-CN
gqm	鬼敲门	zh-CN
gqmf	鬼敲门	zh-CN
gqt	共青团	zh-CN
gqtr	共青团	zh-CN
gqu	过去时	zh-CN
gqui	过去时	zh-CN
gqx	高清晰	zh-CN
gqxi	高清晰	zh-CN
gqxk	观其行	zh-CN
grz	过日子	zh-CN
gtb	改天吧	zh-CN
gtba	改天吧	zh-CN
gtd	共同点	zh-CN
gtdm	共同点	zh-CN
gtf	刮台风	zh-CN
gtfg	刮台风	zh-CN
gth	感叹号	zh-CN
gthc	感叹号	zh-CN
gthu	个体户	zh-CN
gti	共同处	zh-CN
gtiu	共同处	zh-CN
gtj	国土局	zh-CN
gtl	改天聊	zh-CN
gtln	改天聊	zh-CN
gtn	管他呢	zh-CN
gtne	管他呢	zh-CN
gts	古铜色	zh-CN
gtse	古铜色	zh-CN
gtt	光秃秃	zh-CN
gtti	共同体	zh-CN
gtz	狗腿子	zh-CN
gtzi	狗腿子	zh-CN
guhe	更适合	zh-CN
guru	高收入	zh-CN
guxk	观赏性	zh-CN
gvll	高质量	zh-CN
gvug	贵州省	zh-CN
gwb	公文包	zh-CN
gwbc	公文包	zh-CN
gwu	个位数	zh-CN
gwuu	个位数	zh-CN
gwy	公务员	zh-CN
gwyr	国务院	zh-CN
gxbk	冠心病	zh-CN
gxfw	高消费	zh-CN
gxh	个性化	zh-CN
gxl	更新了	zh-CN
gxlv	高效率	zh-CN
gxqq	滚雪球	zh-CN
gxu	管闲事	zh-CN
gxuo	刚想说	zh-CN
gxy	高血压	zh-CN
gxya	高血压	zh-CN
gxzu	工薪族	zh-CN
gyb	过一遍	zh-CN
gybk	雇佣兵	zh-CN
gyd	过一段	zh-CN
gydm	高压电	zh-CN
gydr	过一段	zh-CN
gyg	高压锅	zh-CN
gygo	高压锅	zh-CN
gyj	冠亚军	zh-CN
gyjy	冠亚军	zh-CN
gylm	供应链	zh-CN
gyp	工艺品	zh-CN
gypb	工艺品	zh-CN
gyq	公元前	zh-CN
gyqm	公元前	zh-CN
gyx	改一下	zh-CN
gyxk	公益性	zh-CN
gyxm	高压线	zh-CN
gyxx	逛一下	zh-CN
gzli	骨子里	zh-CN
gzlm	瓜子脸	zh-CN
gzu	工作室	zh-CN
gzvg	工作证	zh-CN
gzvh	高增长	zh-CN
hbb	汉堡包	zh-CN
hbbc	汉堡包	zh-CN
hbc	还不错	zh-CN
hbco	还不错	zh-CN
hbd	恨不得	zh-CN
hbdc	还不到	zh-CN
hbde	恨不得	zh-CN
hbdj	荷包蛋	zh-CN
hbf	好办法	zh-CN
hbfa	好办法	zh-CN
hbg	还不够	zh-CN
hbgz	还不够	zh-CN
hbh	会不会	zh-CN
hbhc	好不好	zh-CN
hbhv	会不会	zh-CN
hbj	环保局	zh-CN
hbju	环保局	zh-CN
hbk	还不快	zh-CN
hbkk	还不快	zh-CN
hbl	花不了	zh-CN
hbld	回不来	zh-CN
hbln	花不了	zh-CN
hblv	回报率	zh-CN
hbn	还不能	zh-CN
hbng	还不能	zh-CN
hbq	回不去	zh-CN
hbqu	回不去	zh-CN
hbr	还不如	zh-CN
hbt	好半天	zh-CN
hbtm	好半天	zh-CN
hbu	还不是	zh-CN
hbug	河北省	zh-CN
hbui	还不是	zh-CN
hbv	还不止	zh-CN
hbvi	还不止	zh-CN
hbw	花不完	zh-CN
hbwj	花不完	zh-CN
hbx	还不行	zh-CN
hbxk	还不行	zh-CN
hby	后半夜	zh-CN
hbye	后半夜	zh-CN
hdc	好多次	zh-CN
hdcd	喝倒彩	zh-CN
hdci	好多次	zh-CN
hddu	黄赌毒	zh-CN
hdh	划等号	zh-CN
hdhf	好得很	zh-CN
hdhs	鹤顶红	zh-CN
hdl	好多了	zh-CN
hdld	合得来	zh-CN
hdn	很多年	zh-CN
hdnm	好多年	zh-CN
hdqu	红灯区	zh-CN
hdr	很多人	zh-CN
hdx	好东西	zh-CN
hdxi	好东西	zh-CN
heb	哈尔滨	zh-CN
hebb	哈尔滨	zh-CN
hej	华尔街	zh-CN
hemg	荷尔蒙	zh-CN
hez	华尔兹	zh-CN
hfl	恢复了	zh-CN
hfle	恢复了	zh-CN
hgd	花骨朵	zh-CN
hgh	回个话	zh-CN
hghx	回个话	zh-CN
hgnl	灰姑娘	zh-CN
hgq	昏过去	zh-CN
hgqu	昏过去	zh-CN
hgr	回锅肉	zh-CN
hgt	回过头	zh-CN
hgtz	回过头	zh-CN
hgu	花果山	zh-CN
hgv	合格证	zh-CN
hgvg	合格证	zh-CN
hgxi	花鼓戏	zh-CN
hhb	还好吧	zh-CN
hhcd	黄花菜	zh-CN
hhfg	何海峰	zh-CN
hhh	哈哈哈	zh-CN
hhha	哈哈哈	zh-CN
hhhu	黑乎乎	zh-CN
hhu	好好说	zh-CN
hhy	后悔药	zh-CN
hhyc	后悔药	zh-CN
hhys	混合泳	zh-CN
hhz	好孩子	zh-CN
hhzi	好孩子	zh-CN
hid	好吃的	zh-CN
hih	护城河	zh-CN
hii	昏沉沉	zh-CN
hiif	昏沉沉	zh-CN
hiq	缓冲区	zh-CN
hiqu	豁出去	zh-CN
hiv	火车站	zh-CN
hivj	火车站	zh-CN
hjgv	活见鬼	zh-CN
hjle	好极了	zh-CN
hjt	好几天	zh-CN
hjtm	好几天	zh-CN
hkb	户口本	zh-CN
hkbf	户口本	zh-CN
hkbu	户口簿	zh-CN
hkj	航空局	zh-CN
hkju	航空局	zh-CN
hkn	很可能	zh-CN
hkng	很可能	zh-CN
hky	还可以	zh-CN
hlbo	胡萝卜	zh-CN
hldg	红绿灯	zh-CN
hlg	火龙果	zh-CN
hlgo	火龙果	zh-CN
hljk	狐狸精	zh-CN
hljl	黑龙江	zh-CN
hlk	海陆空	zh-CN
hll	灰溜溜	zh-CN
hllq	灰溜溜	zh-CN
hlm	红楼梦	zh-CN
hlmg	红楼梦	zh-CN
hlp	黄脸婆	zh-CN
hlpo	黄脸婆	zh-CN
hluv	花露水	zh-CN
hlw	好莱坞	zh-CN
hlwh	互联网	zh-CN
hmb	坏毛病	zh-CN
hmc	花名册	zh-CN
hmce	花名册	zh-CN
hmd	黑名单	zh-CN
hmdj	黑名单	zh-CN
hmg	哈密瓜	zh-CN
hmgx	哈密瓜	zh-CN
hmq	回马枪	zh-CN
hmql	回马枪	zh-CN
hms	红霉素	zh-CN
hmsu	红霉素	zh-CN
hmx	很明显	zh-CN
hmxm	很明显	zh-CN
hmy	鸿门宴	zh-CN
hmyj	鸿门宴	zh-CN
hnd	海南岛	zh-CN
hndc	海南岛	zh-CN
hnj	回娘家	zh-CN
hnjx	回娘家	zh-CN
hnl	很努力	zh-CN
hnli	很努力	zh-CN
hnt	混凝土	zh-CN
hntu	混凝土	zh-CN
hnu	海南省	zh-CN
hnug	河南省	zh-CN
hnw	海内外	zh-CN
hnwd	海内外	zh-CN
hnz	哈尼族	zh-CN
hnzu	哈尼族	zh-CN
hpg	和平鸽	zh-CN
hpge	和平鸽	zh-CN
hpj	黄浦江	zh-CN
hpjl	黄浦江	zh-CN
hpl	很漂亮	zh-CN
hpll	很漂亮	zh-CN
hpm	海平面	zh-CN
hpmm	海平面	zh-CN
hpp	红扑扑	zh-CN
hppu	红扑扑	zh-CN
hpy	好朋友	zh-CN
hpyz	好朋友	zh-CN
hqd	何其多	zh-CN
hqdo	何其多	zh-CN
hqg	很奇怪	zh-CN
hqgk	很奇怪	zh-CN
hqi	很清楚	zh-CN
hqiu	很清楚	zh-CN
hql	回去了	zh-CN
hqle	回去了	zh-CN
hqq	黑漆漆	zh-CN
hqqi	黑漆漆	zh-CN
hqqu	黑黢黢	zh-CN
hqu	换气扇	zh-CN
hqx	好奇心	zh-CN
hqxb	好奇心	zh-CN
hske	哈萨克	zh-CN
htc	回头草	zh-CN
htcc	回头草	zh-CN
hth	皇太后	zh-CN
hthz	皇太后	zh-CN
hti	火腿肠	zh-CN
htih	火腿肠	zh-CN
htj	回头见	zh-CN
htjm	回头见	zh-CN
htjx	回趟家	zh-CN
htk	回头客	zh-CN
htke	回头客	zh-CN
htl	回头率	zh-CN
htlu	滑铁卢	zh-CN
htlv	回头率	zh-CN
htt	红彤彤	zh-CN
htts	红彤彤	zh-CN
htu	火头上	zh-CN
htuh	火头上	zh-CN
htz	皇太子	zh-CN
htzi	皇太子	zh-CN
hudy	华盛顿	zh-CN
huj	后视镜	zh-CN
hul	黄鼠狼	zh-CN
hulc	和事佬	zh-CN
hulv	换手率	zh-CN
huqi	回收期	zh-CN
hur	很少人	zh-CN
huz	活受罪	zh-CN
huzv	活受罪	zh-CN
hvp	化妆品	zh-CN
hvpb	化妆品	zh-CN
hvzi	汗珠子	zh-CN
hwg	和为贵	zh-CN
hwj	好望角	zh-CN
hwjn	好望角	zh-CN
hwl	好无聊	zh-CN
hwln	好无聊	zh-CN
hwn	哈瓦那	zh-CN
hwna	哈瓦那	zh-CN
hwq	核武器	zh-CN
hwx	红外线	zh-CN
hwy	画外音	zh-CN
hwyb	画外音	zh-CN
hxb	还行吧	zh-CN
hxba	还行吧	zh-CN
hxh	很喜欢	zh-CN
hxi	候选窗	zh-CN
hxil	候选窗	zh-CN
hxl	候选栏	zh-CN
hxvf	回形针	zh-CN
hxzi	黑匣子	zh-CN
hyb	很一般	zh-CN
hybj	很一般	zh-CN
hyde	好样的	zh-CN
hyf	会议费	zh-CN
hyfw	会议费	zh-CN
hyg	换一个	zh-CN
hyh	缓一缓	zh-CN
hyl	回忆录	zh-CN
hylu	回忆录	zh-CN
hyq	黑眼圈	zh-CN
hyqr	黑眼圈	zh-CN
hys	好意思	zh-CN
hyv	后遗症	zh-CN
hyvg	后遗症	zh-CN
hyzi	旱鸭子	zh-CN
hzh	洪泽湖	zh-CN
hzhu	洪泽湖	zh-CN
ibd	差不多	zh-CN
ibdo	差不多	zh-CN
ibg	吃不惯	zh-CN
ibgk	丑八怪	zh-CN
ibgr	吃不惯	zh-CN
ibi	吃不吃	zh-CN
ibii	吃不吃	zh-CN
ibk	吃不开	zh-CN
ibkd	吃不开	zh-CN
ibl	吃饱了	zh-CN
ible	吃饱了	zh-CN
ibll	储备粮	zh-CN
ibu	出版社	zh-CN
ibue	出版社	zh-CN
ibuj	长白山	zh-CN
ibx	吃不下	zh-CN
ibxn	吃不消	zh-CN
ibxx	吃不下	zh-CN
icyc	吃错药	zh-CN
idd	沉甸甸	zh-CN
iddm	沉甸甸	zh-CN
idk	吃得开	zh-CN
idl	吃多了	zh-CN
idq	充电器	zh-CN
idqi	充电器	zh-CN
idqy	超短裙	zh-CN
idu	成都市	zh-CN
idx	吃得下	zh-CN
ifdn	唱反调	zh-CN
ifhe	超负荷	zh-CN
ifl	吃饭了	zh-CN
ifle	吃饭了	zh-CN
ifq	吃饭去	zh-CN
iftz	出风头	zh-CN
ifxk	长方形	zh-CN
iglv	成功率	zh-CN
igs	车管所	zh-CN
ihh	茶话会	zh-CN
iiq	传出去	zh-CN
iix	尝尝鲜	zh-CN
iixm	尝尝鲜	zh-CN
ijbc	传家宝	zh-CN
ijg	成就感	zh-CN
ijgj	成就感	zh-CN
ijl	成交量	zh-CN
ijlu	长颈鹿	zh-CN
ijt	长镜头	zh-CN
ijtz	长镜头	zh-CN
ijv	持久战	zh-CN
ikb	触控板	zh-CN
ikbj	触控板	zh-CN
ikq	喘口气	zh-CN
ikqi	喘口气	zh-CN
ikt	创可贴	zh-CN
iktp	创可贴	zh-CN
ilf	差旅费	zh-CN
ilfw	差旅费	zh-CN
ili	查了查	zh-CN
ilia	查了查	zh-CN
ilih	尝了尝	zh-CN
ill	赤裸裸	zh-CN
illo	赤裸裸	zh-CN
ilp	处理品	zh-CN
ilpb	处理品	zh-CN
ilq	处理器	zh-CN
ilqi	处理器	zh-CN
ilv	车轮战	zh-CN
ilvj	车轮战	zh-CN
imm	重命名	zh-CN
immk	重命名	zh-CN
imp	触摸屏	zh-CN
impk	触摸屏	zh-CN
imu	触摸式	zh-CN
imui	触摸式	zh-CN
imv	充满着	zh-CN
imve	充满着	zh-CN
imy	沉迷于	zh-CN
imyu	沉迷于	zh-CN
inl	超能力	zh-CN
inle	吃腻了	zh-CN
inli	超能力	zh-CN
inp	吹牛皮	zh-CN
inpi	吹牛皮	zh-CN
inr	成年人	zh-CN
inrf	成年人	zh-CN
inz	处女作	zh-CN
inzo	处女座	zh-CN
iql	出去了	zh-CN
iqle	出去了	zh-CN
iqll	充其量	zh-CN
iqt	出气筒	zh-CN
iqts	出气筒	zh-CN
iqu	重庆市	zh-CN
iqui	重庆市	zh-CN
irbk	传染病	zh-CN
itg	床头柜	zh-CN
itgv	床头柜	zh-CN
itn	出头鸟	zh-CN
itnn	出头鸟	zh-CN
itt	赤条条	zh-CN
ittn	赤条条	zh-CN
ity	差太远	zh-CN
ityr	差太远	zh-CN
iuhx	初始化	zh-CN
ivb	成正比	zh-CN
ivbi	成正比	zh-CN
ivjt	唱主角	zh-CN
ivq	沉住气	zh-CN
ivw	称之为	zh-CN
ivy	出主意	zh-CN
ivyi	出主意	zh-CN
iwf	吃完饭	zh-CN
iwfj	吃完饭	zh-CN
iwj	储物间	zh-CN
iwl	吃完了	zh-CN
iwle	吃完了	zh-CN
iwt	出问题	zh-CN
iwti	出问题	zh-CN
iwx	储物箱	zh-CN
iwxl	储物箱	zh-CN
ixf	吃闲饭	zh-CN
ixfj	吃闲饭	zh-CN
ixh	程序化	zh-CN
ixhx	程序化	zh-CN
ixl	出现了	zh-CN
ixle	出现了	zh-CN
ixq	吃下去	zh-CN
ixs	储蓄所	zh-CN
ixso	储蓄所	zh-CN
ixu	畅销书	zh-CN
ixui	超现实	zh-CN
ixuu	畅销书	zh-CN
ixv	初学者	zh-CN
ixve	初学者	zh-CN
ixx	持续性	zh-CN
ixxk	持续性	zh-CN
ixxp	穿小鞋	zh-CN
ixy	程序员	zh-CN
ixz	趁现在	zh-CN
ixzd	趁现在	zh-CN
ixzu	朝鲜族	zh-CN
iyb	创业板	zh-CN
iydm	差一点	zh-CN
iyih	尝一尝	zh-CN
iyl	差远了	zh-CN
iyle	扯远了	zh-CN
iys	超音速	zh-CN
iysu	超音速	zh-CN
iyx	查一下	zh-CN
iyz	常用字	zh-CN
iyzi	常用字	zh-CN
izie	出租车	zh-CN
izl	创造力	zh-CN
izxk	创造性	zh-CN
izyu	沉醉于	zh-CN
jbdc	见不到	zh-CN
jbde	见不得	zh-CN
jbf	加班费	zh-CN
jbfw	加班费	zh-CN
jbq	记不清	zh-CN
jbti	吉布提	zh-CN
jbu	基本上	zh-CN
jcc	急匆匆	zh-CN
jccj	金灿灿	zh-CN
jccs	急匆匆	zh-CN
jcl	记错了	zh-CN
jcle	记错了	zh-CN
jcy	仅次于	zh-CN
jcyu	仅次于	zh-CN
jdd	娇滴滴	zh-CN
jddi	娇滴滴	zh-CN
jdf	借贷方	zh-CN
jdh	机顶盒	zh-CN
jdhe	机顶盒	zh-CN
jdie	机动车	zh-CN
jdj	基督教	zh-CN
jdjn	基督教	zh-CN
jdl	几点了	zh-CN
jdle	几点了	zh-CN
jdq	经得起	zh-CN
jdqi	经得起	zh-CN
jdv	景德镇	zh-CN
jdx	决定性	zh-CN
jdy	就等于	zh-CN
jdyu	就等于	zh-CN
jeg	今儿个	zh-CN
jege	今儿个	zh-CN
jfj	解放军	zh-CN
jfl	解放了	zh-CN
jfle	解放了	zh-CN
jfp	警匪片	zh-CN
jfpm	警匪片	zh-CN
jfq	解放前	zh-CN
jfqm	解放前	zh-CN
jfu	紧肤水	zh-CN
jfuv	紧肤水	zh-CN
jfv	几分钟	zh-CN
jfvs	几分钟	zh-CN
jfx	见分晓	zh-CN
jfxn	见分晓	zh-CN
jgbh	金箍棒	zh-CN
jgg	九宫格	zh-CN
jgge	九宫格	zh-CN
jgj	金刚经	zh-CN
jgjk	金刚经	zh-CN
jgl	见鬼了	zh-CN
jgle	见惯了	zh-CN
jgn	结果呢	zh-CN
jgne	结果呢	zh-CN
jgq	几个钱	zh-CN
jgql	机关枪	zh-CN
jgr	几个人	zh-CN
jgrf	几个人	zh-CN
jgs	见光死	zh-CN
jgsi	见光死	zh-CN
jgu	井冈山	zh-CN
jgv	紧箍咒	zh-CN
jgvs	几个钟	zh-CN
jgw	甲骨文	zh-CN
jgwf	甲骨文	zh-CN
jgx	金龟婿	zh-CN
jgxk	结构性	zh-CN
jgy	几个月	zh-CN
jgyj	节骨眼	zh-CN
jgyt	几个月	zh-CN
jgz	几个字	zh-CN
jgzi	几个字	zh-CN
jhg	脚后跟	zh-CN
jhgf	脚后跟	zh-CN
jhi	交汇处	zh-CN
jhie	救护车	zh-CN
jhj	交换机	zh-CN
jhji	交换机	zh-CN
jhm	激活码	zh-CN
jhma	激活码	zh-CN
jht	交换台	zh-CN
jhu	几乎是	zh-CN
jhui	几乎是	zh-CN
jhuj	九华山	zh-CN
jhx	就好像	zh-CN
jhxl	就好像	zh-CN
jhy	嫁祸于	zh-CN
jhz	叫花子	zh-CN
jhzi	叫花子	zh-CN
jiie	计程车	zh-CN
jjb	精简版	zh-CN
jjc	经济舱	zh-CN
jjch	经济舱	zh-CN
jjf	加减法	zh-CN
jjfa	激将法	zh-CN
jjg	肩胛骨	zh-CN
jjgu	肩胛骨	zh-CN
jjh	几句话	zh-CN
jjhx	几句话	zh-CN
jji	竞技场	zh-CN
jjih	竞技场	zh-CN
jjk	借记卡	zh-CN
jjka	借记卡	zh-CN
jjl	解决了	zh-CN
jjle	解决了	zh-CN
jjm	解解闷	zh-CN
jjmf	解解闷	zh-CN
jjn	近几年	zh-CN
jjnm	近几年	zh-CN
jjr	节假日	zh-CN
jjrf	经纪人	zh-CN
jjri	节假日	zh-CN
jjs	晋级赛	zh-CN
jjt	近几天	zh-CN
jjtm	近几天	zh-CN
jju	旧金山	zh-CN
jjuj	旧金山	zh-CN
jjuz	狙击手	zh-CN
jjv	紧接着	zh-CN
jjve	佼佼者	zh-CN
jjw	降降温	zh-CN
jjwf	降降温	zh-CN
jjx	积极性	zh-CN
jjxk	积极性	zh-CN
jjxt	经济学	zh-CN
jkng	尽可能	zh-CN
jlb	俱乐部	zh-CN
jlbu	俱乐部	zh-CN
jlpm	纪录片	zh-CN
jlpo	吉隆坡	zh-CN
jlsj	降落伞	zh-CN
jmcc	健美操	zh-CN
jnp	纪念品	zh-CN
jnpb	纪念品	zh-CN
jnzu	基诺族	zh-CN
jpzu	景颇族	zh-CN
jqn	几千年	zh-CN
jqpm	剧情片	zh-CN
jqqn	静悄悄	zh-CN
jqr	机器人	zh-CN
jqx	进取心	zh-CN
jrh	尖锐化	zh-CN
jru	假如说	zh-CN
jruo	假如说	zh-CN
jrx	兼容性	zh-CN
jrxk	兼容性	zh-CN
jry	金融业	zh-CN
jrye	金融业	zh-CN
jsdi	集散地	zh-CN
jsj	计算机	zh-CN
jsji	计算机	zh-CN
jsl	急死了	zh-CN
jsle	急死了	zh-CN
jspm	惊悚片	zh-CN
jsq	计算器	zh-CN
jsqi	计算器	zh-CN
jsu	江苏省	zh-CN
jsug	江苏省	zh-CN
jtb	剪贴板	zh-CN
jtg	晶体管	zh-CN
jtgr	晶体管	zh-CN
jtj	交通局	zh-CN
jtlj	景泰蓝	zh-CN
jtn	九头鸟	zh-CN
jtnn	九头鸟	zh-CN
jtzi	简体字	zh-CN
jufh	健身房	zh-CN
jui	寄生虫	zh-CN
juis	寄生虫	zh-CN
jun	几十年	zh-CN
junm	几十年	zh-CN
jvd	就知道	zh-CN
jvdc	就知道	zh-CN
jvf	鸡爪疯	zh-CN
jvfg	鸡爪疯	zh-CN
jvg	九寨沟	zh-CN
jvgr	价值观	zh-CN
jvgu	金针菇	zh-CN
jvgz	九寨沟	zh-CN
jvj	假正经	zh-CN
jvjk	假正经	zh-CN
jvk	急诊科	zh-CN
jvke	急诊科	zh-CN
jvl	竞争力	zh-CN
jvle	记住了	zh-CN
jvm	就这么	zh-CN
jvme	就这么	zh-CN
jvr	截止日	zh-CN
jvri	截止日	zh-CN
jvu	简直是	zh-CN
jvui	简直是	zh-CN
jvv	居住证	zh-CN
jvw	急转弯	zh-CN
jvwu	建筑物	zh-CN
jvx	集装箱	zh-CN
jvxm	甲状腺	zh-CN
jvy	就这样	zh-CN
jvyj	肩周炎	zh-CN
jvyu	就职于	zh-CN
jwd	经纬度	zh-CN
jwh	居委会	zh-CN
jwhv	居委会	zh-CN
jwj	鸡尾酒	zh-CN
jwjq	鸡尾酒	zh-CN
jwl	就为了	zh-CN
jwle	就为了	zh-CN
jwn	几万年	zh-CN
jwnm	几万年	zh-CN
jwr	局外人	zh-CN
jwrf	局外人	zh-CN
jwu	家务事	zh-CN
jwui	家务事	zh-CN
jwv	健忘症	zh-CN
jwvg	健忘症	zh-CN
jwx	基围虾	zh-CN
jwxx	基围虾	zh-CN
jxld	接下来	zh-CN
jxp	教学片	zh-CN
jxpm	教学片	zh-CN
jxy	仅限于	zh-CN
jxyt	交响乐	zh-CN
jybu	进一步	zh-CN
jyci	近义词	zh-CN
jyf	九月份	zh-CN
jyju	教育局	zh-CN
jyli	记忆力	zh-CN
jys	交易所	zh-CN
jyso	交易所	zh-CN
jyti	绝缘体	zh-CN
jyw	局域网	zh-CN
jyx	记一下	zh-CN
jyz	脚丫子	zh-CN
jzb	酒糟鼻	zh-CN
jzbi	酒糟鼻	zh-CN
jzg	节奏感	zh-CN
jzgj	节奏感	zh-CN
jzgu	架子鼓	zh-CN
jzj	剧作家	zh-CN
jzjx	剧作家	zh-CN
jzl	君子兰	zh-CN
jzlj	君子兰	zh-CN
jzt	金字塔	zh-CN
jzta	金字塔	zh-CN
jzy	就在于	zh-CN
jzyu	就在于	zh-CN
kbd	看不懂	zh-CN
kbdc	看不到	zh-CN
kbds	看不懂	zh-CN
kbg	看不惯	zh-CN
kbgr	看不惯	zh-CN
kbi	看不出	zh-CN
kbj	看不见	zh-CN
kbjm	看不见	zh-CN
kbk	看不看	zh-CN
kbkd	看不开	zh-CN
kbkf	肯不肯	zh-CN
kbkj	看不看	zh-CN
kbp	恐怖片	zh-CN
kbpm	恐怖片	zh-CN
kbq	看不清	zh-CN
kbqi	看不起	zh-CN
kbqk	看不清	zh-CN
kbt	看不透	zh-CN
kbtz	看不透	zh-CN
kbu	看不上	zh-CN
kbui	可不是	zh-CN
kbv	靠不住	zh-CN
kbvu	抗不住	zh-CN
kbx	可比性	zh-CN
kbxk	可比性	zh-CN
kby	可不要	zh-CN
kbyc	可不要	zh-CN
kbz	哭鼻子	zh-CN
kbzi	哭鼻子	zh-CN
kcle	看错了	zh-CN
kdd	看得懂	zh-CN
kddh	空荡荡	zh-CN
kdg	看得惯	zh-CN
kdi	看得出	zh-CN
kdj	肯德基	zh-CN
kdjm	看得见	zh-CN
kdku	开裆裤	zh-CN
kdl	看到了	zh-CN
kdq	看得起	zh-CN
kdu	看电视	zh-CN
kdv	靠得住	zh-CN
kdxk	可读性	zh-CN
kdy	看电影	zh-CN
kfq	开发区	zh-CN
kfu	开发商	zh-CN
kfuh	开发商	zh-CN
kfx	开放性	zh-CN
kfxk	开放性	zh-CN
kfy	口服液	zh-CN
kfye	口服液	zh-CN
kfz	孔夫子	zh-CN
kfzi	孔夫子	zh-CN
kgb	克格勃	zh-CN
kgbo	克格勃	zh-CN
kgl	看过了	zh-CN
kgle	看过了	zh-CN
kgx	客观性	zh-CN
kgxk	客观性	zh-CN
khd	客户端	zh-CN
khdr	客户端	zh-CN
khha	苦哈哈	zh-CN
khp	科幻片	zh-CN
khpm	科幻片	zh-CN
khz	葵花籽	zh-CN
khzi	葵花籽	zh-CN
kib	开场白	zh-CN
kibd	开场白	zh-CN
kij	空城计	zh-CN
kiji	空城计	zh-CN
kil	看出来	zh-CN
kild	看出来	zh-CN
kile	看穿了	zh-CN
kix	开创性	zh-CN
kixk	开创性	zh-CN
kjj	快捷键	zh-CN
kjl	看见了	zh-CN
kjui	会计师	zh-CN
kkx	可靠性	zh-CN
kkxk	可靠性	zh-CN
kml	喀麦隆	zh-CN
kmls	喀麦隆	zh-CN
kmu	开幕式	zh-CN
kmui	开幕式	zh-CN
knb	可能吧	zh-CN
knba	可能吧	zh-CN
knd	跨年度	zh-CN
kndu	跨年度	zh-CN
knm	可能吗	zh-CN
knma	可能吗	zh-CN
knx	可能性	zh-CN
knxk	可能性	zh-CN
kny	肯尼亚	zh-CN
knya	肯尼亚	zh-CN
kpl	堪培拉	zh-CN
kpla	堪培拉	zh-CN
kqk	看情况	zh-CN
kqke	口腔科	zh-CN
kqkl	看情况	zh-CN
kql	看起来	zh-CN
kqld	看起来	zh-CN
kqu	矿泉水	zh-CN
kquv	矿泉水	zh-CN
krj	苦肉计	zh-CN
krji	苦肉计	zh-CN
krn	看热闹	zh-CN
krnc	看热闹	zh-CN
kswo	科索沃	zh-CN
ksx	可塑性	zh-CN
ksxk	可塑性	zh-CN
kte	卡塔尔	zh-CN
kter	卡塔尔	zh-CN
kth	客套话	zh-CN
kthx	客套话	zh-CN
kti	口头禅	zh-CN
ktij	口头禅	zh-CN
ktu	口头上	zh-CN
ktuh	口头上	zh-CN
kty	口头语	zh-CN
ktyu	口头语	zh-CN
kudc	空手道	zh-CN
kuh	口水话	zh-CN
kuhx	口水话	zh-CN
kui	瞌睡虫	zh-CN
kuis	瞌睡虫	zh-CN
kuj	跨世纪	zh-CN
kuq	看上去	zh-CN
kuqu	看上去	zh-CN
kuv	口水战	zh-CN
kvbj	看着办	zh-CN
kvlv	空置率	zh-CN
kvm	扩展名	zh-CN
kvmk	扩展名	zh-CN
kwb	勘误表	zh-CN
kwbn	勘误表	zh-CN
kwj	矿务局	zh-CN
kwju	矿务局	zh-CN
kwt	科威特	zh-CN
kwte	科威特	zh-CN
kwu	可谓是	zh-CN
kwui	可谓是	zh-CN
kwv	矿物质	zh-CN
kwvi	矿物质	zh-CN
kwx	开玩笑	zh-CN
kwxn	开玩笑	zh-CN
kxi	开小差	zh-CN
kxid	开小差	zh-CN
kxj	科学家	zh-CN
kxjx	科学家	zh-CN
kxl	可惜了	zh-CN
kxle	可惜了	zh-CN
kxs	苦行僧	zh-CN
kxsg	苦行僧	zh-CN
kxth	口香糖	zh-CN
kxu	亏心事	zh-CN
kxui	亏心事	zh-CN
kxx	可行性	zh-CN
kxxk	可行性	zh-CN
kxzc	开小灶	zh-CN
kyb	看一遍	zh-CN
kybm	看一遍	zh-CN
kyd	快一点	zh-CN
kydm	快一点	zh-CN
kyi	开夜车	zh-CN
kyie	开夜车	zh-CN
kyk	看一看	zh-CN
kykj	看一看	zh-CN
kyl	可以了	zh-CN
kym	可以吗	zh-CN
kyma	可以吗	zh-CN
kyui	跨越式	zh-CN
kyv	客运站	zh-CN
kyx	看一下	zh-CN
kyxk	抗药性	zh-CN
kyxp	快一些	zh-CN
kyxx	看一下	zh-CN
kyy	看一眼	zh-CN
kyz	看样子	zh-CN
kyzi	看样子	zh-CN
kzy	看走眼	zh-CN
kzyj	看走眼	zh-CN
lbb	冷冰冰	zh-CN
lbde	了不得	zh-CN
lber	老伴儿	zh-CN
lbh	老本行	zh-CN
lbhh	老本行	zh-CN
lbj	来不及	zh-CN
lbji	来不及	zh-CN
lbkd	离不开	zh-CN
lbld	来不来	zh-CN
lblg	冷不冷	zh-CN
lblw	累不累	zh-CN
lbn	老板娘	zh-CN
lbnf	黎巴嫩	zh-CN
lbnl	老板娘	zh-CN
lbp	罗布泊	zh-CN
lbq	了不起	zh-CN
lbqi	了不起	zh-CN
lbs	老不死	zh-CN
lbt	礼拜天	zh-CN
lbtm	老半天	zh-CN
lbv	留不住	zh-CN
lbvu	留不住	zh-CN
lbwu	两不误	zh-CN
lbx	老百姓	zh-CN
lbya	利比亚	zh-CN
lbzu	珞巴族	zh-CN
lcw	另存为	zh-CN
lcww	另存为	zh-CN
ldf	老地方	zh-CN
ldg	老大哥	zh-CN
ldj	来得及	zh-CN
ldji	来得及	zh-CN
ldjp	老大姐	zh-CN
ldju	劳动局	zh-CN
ldk	离得开	zh-CN
ldkd	离得开	zh-CN
ldn	老大难	zh-CN
ldnj	老大难	zh-CN
ldnl	老大娘	zh-CN
ldq	懒得去	zh-CN
ldr	两代人	zh-CN
ldx	流动性	zh-CN
ldxk	流动性	zh-CN
ldy	老掉牙	zh-CN
ldya	老掉牙	zh-CN
ldye	老大爷	zh-CN
lfm	两方面	zh-CN
lfmi	立方米	zh-CN
lfmm	两方面	zh-CN
lft	立方体	zh-CN
lfti	立方体	zh-CN
lfv	两分钟	zh-CN
lfvs	两分钟	zh-CN
lgb	两个半	zh-CN
lgd	老古董	zh-CN
lgdr	连锅端	zh-CN
lgf	驴肝肺	zh-CN
lgg	老公公	zh-CN
lgh	泸沽湖	zh-CN
lghu	泸沽湖	zh-CN
lgj	老规矩	zh-CN
lgk	理工科	zh-CN
lgke	理工科	zh-CN
lgr	两个人	zh-CN
lgrf	两个人	zh-CN
lgv	两个钟	zh-CN
lgvs	两个钟	zh-CN
lgxk	劣根性	zh-CN
lgy	两个月	zh-CN
lgyt	两个月	zh-CN
lgz	两个字	zh-CN
lgzi	两个字	zh-CN
lhb	厉害吧	zh-CN
lhba	厉害吧	zh-CN
lhgo	联合国	zh-CN
lhhe	乐呵呵	zh-CN
lhhs	乱哄哄	zh-CN
lhj	连环计	zh-CN
lhjk	老花镜	zh-CN
lhl	厉害了	zh-CN
lhli	老黄历	zh-CN
lhma	癞蛤蟆	zh-CN
lhn	老黄牛	zh-CN
lhna	氯化钠	zh-CN
lhnq	老黄牛	zh-CN
lhqm	零花钱	zh-CN
lht	老糊涂	zh-CN
lhtu	老糊涂	zh-CN
lhu	两回事	zh-CN
lhuh	老和尚	zh-CN
lhui	两回事	zh-CN
lhv	兰花指	zh-CN
lhvi	兰花指	zh-CN
lhx	灵活性	zh-CN
lhxk	灵活性	zh-CN
lhy	老花眼	zh-CN
lhzu	拉祜族	zh-CN
ljdm	临界点	zh-CN
ljhu	老江湖	zh-CN
lji	龙井茶	zh-CN
ljia	龙井茶	zh-CN
ljih	拉家常	zh-CN
ljjk	亮晶晶	zh-CN
ljjl	辣椒酱	zh-CN
ljq	立交桥	zh-CN
ljqn	立交桥	zh-CN
ljt	垃圾桶	zh-CN
ljts	垃圾桶	zh-CN
lju	累计数	zh-CN
ljvj	拉锯战	zh-CN
ljxk	逻辑性	zh-CN
ljxl	垃圾箱	zh-CN
lkq	冷空气	zh-CN
lkz	两口子	zh-CN
llh	老龄化	zh-CN
llhu	拦路虎	zh-CN
llk	老两口	zh-CN
lll	狼来了	zh-CN
llla	啦啦啦	zh-CN
llpw	拉郎配	zh-CN
llq	浏览器	zh-CN
llu	理论上	zh-CN
lluh	理论上	zh-CN
lmdu	灵敏度	zh-CN
lmma	老妈妈	zh-CN
lmu	两码事	zh-CN
lmui	两码事	zh-CN
lmv	龙门阵	zh-CN
lmvf	龙门阵	zh-CN
lmz	绿帽子	zh-CN
lnn	老奶奶	zh-CN
lnnd	老奶奶	zh-CN
lnug	辽宁省	zh-CN
lpg	癞皮狗	zh-CN
lpj	零配件	zh-CN
lpp	老婆婆	zh-CN
lppo	老婆婆	zh-CN
lpy	老朋友	zh-CN
lpyz	老朋友	zh-CN
lqbw	老前辈	zh-CN
lqn	六七年	zh-CN
lrj	老人家	zh-CN
lrl	利润率	zh-CN
lrlv	利润率	zh-CN
lsbc	卢森堡	zh-CN
lsbf	里斯本	zh-CN
lsc	两三次	zh-CN
lsci	两三次	zh-CN
lsdc	螺丝刀	zh-CN
lsdm	两三点	zh-CN
lsg	两三个	zh-CN
lsge	两三个	zh-CN
lsh	络腮胡	zh-CN
lshv	两三回	zh-CN
lsj	两三句	zh-CN
lsju	两三句	zh-CN
lsle	累死了	zh-CN
lsn	两三年	zh-CN
lsnm	两三年	zh-CN
lsr	累死人	zh-CN
lsrf	累死人	zh-CN
lss	凉嗖嗖	zh-CN
lssv	两三岁	zh-CN
lssz	凉嗖嗖	zh-CN
lst	两三天	zh-CN
lstm	两三天	zh-CN
lsto	莱索托	zh-CN
lsy	类似于	zh-CN
lsyu	类似于	zh-CN
lszu	傈僳族	zh-CN
ltd	鹿特丹	zh-CN
ltdj	鹿特丹	zh-CN
lte	老头儿	zh-CN
lter	老头儿	zh-CN
ltg	立体感	zh-CN
ltgj	立体感	zh-CN
ltj	落汤鸡	zh-CN
ltji	落汤鸡	zh-CN
ltl	两条路	zh-CN
ltlu	两条路	zh-CN
ltp	老太婆	zh-CN
ltpd	乐天派	zh-CN
ltpo	老太婆	zh-CN
ltq	愣头青	zh-CN
ltqb	乱弹琴	zh-CN
lttd	老太太	zh-CN
ltu	立体声	zh-CN
ltug	立体声	zh-CN
ltw	立陶宛	zh-CN
ltx	老同学	zh-CN
ltxq	离退休	zh-CN
ltxt	老同学	zh-CN
lty	老天爷	zh-CN
ltye	老天爷	zh-CN
ltz	烂摊子	zh-CN
ltzi	老头子	zh-CN
lugs	临时工	zh-CN
luji	洛杉矶	zh-CN
lur	老实人	zh-CN
luxk	临时性	zh-CN
luxt	历史学	zh-CN
lvv	连轴转	zh-CN
lvy	雷阵雨	zh-CN
lvyu	雷阵雨	zh-CN
lxh	柳下惠	zh-CN
lxhx	理想化	zh-CN
lxj	连续剧	zh-CN
lxjq	老学究	zh-CN
lxju	连续剧	zh-CN
lxl	留下来	zh-CN
lxq	拉下去	zh-CN
lxt	旅行团	zh-CN
lxtr	旅行团	zh-CN
lxu	两小时	zh-CN
lxug	老先生	zh-CN
lxui	两小时	zh-CN
lxx	连续性	zh-CN
lxxk	连续性	zh-CN
lxz	两下子	zh-CN
lxzi	两下子	zh-CN
lyb	另一半	zh-CN
lybw	老一辈	zh-CN
lydd	老一代	zh-CN
lyde	利雅得	zh-CN
lyg	另一个	zh-CN
lyge	另一个	zh-CN
lyh	莱茵河	zh-CN
lyhe	莱茵河	zh-CN
lyji	录音机	zh-CN
lyl	利用率	zh-CN
lylm	练一练	zh-CN
lym	另一面	zh-CN
lymm	另一面	zh-CN
lyp	录音棚	zh-CN
lyq	路由器	zh-CN
lyqm	零用钱	zh-CN
lyqy	连衣裙	zh-CN
lyu	露一手	zh-CN
lyuz	露一手	zh-CN
lyv	另一种	zh-CN
lyvs	另一种	zh-CN
lyw	另一位	zh-CN
lyy	来源于	zh-CN
lyye	老爷爷	zh-CN
lyyz	绿油油	zh-CN
lyz	老样子	zh-CN
lzh	老字号	zh-CN
lzhc	老字号	zh-CN
lzz	乱糟糟	zh-CN
lzzc	乱糟糟	zh-CN
lzzi	乐滋滋	zh-CN
lzzs	老祖宗	zh-CN
mbdp	忙不迭	zh-CN
mbhe	迈巴赫	zh-CN
mbi	面包车	zh-CN
mbie	末班车	zh-CN
mbln	免不了	zh-CN
mbmh	忙不忙	zh-CN
mbpd	慢半拍	zh-CN
mbpk	鸣不平	zh-CN
mbq	买不起	zh-CN
mbr	明白人	zh-CN
mbrf	明白人	zh-CN
mbt	摸不透	zh-CN
mbtz	摸不透	zh-CN
mbu	莫不是	zh-CN
mbv	明摆着	zh-CN
mbvc	摸不着	zh-CN
mbve	明摆着	zh-CN
mby	没必要	zh-CN
mddi	目的地	zh-CN
mdh	马大哈	zh-CN
mdha	马大哈	zh-CN
mdjq	没多久	zh-CN
mdl	马德里	zh-CN
mdlc	麦当劳	zh-CN
mdm	面对面	zh-CN
mdmm	面对面	zh-CN
mdx	目的性	zh-CN
mdxk	目的性	zh-CN
meg	明儿个	zh-CN
mege	明儿个	zh-CN
met	马耳他	zh-CN
meta	马耳他	zh-CN
mfhe	满负荷	zh-CN
mfl	麻烦了	zh-CN
mfle	麻烦了	zh-CN
mfv	每分钟	zh-CN
mfvs	每分钟	zh-CN
mfw	马蜂窝	zh-CN
mfwo	马蜂窝	zh-CN
mfx	没发现	zh-CN
mfxm	没发现	zh-CN
mfy	没反应	zh-CN
mfyk	没反应	zh-CN
mgd	没搞懂	zh-CN
mgf	没工夫	zh-CN
mgfu	没工夫	zh-CN
mgp	冒个泡	zh-CN
mgpc	冒个泡	zh-CN
mgr	每个人	zh-CN
mgrf	每个人	zh-CN
mgxi	没关系	zh-CN
mgy	每个月	zh-CN
mgyu	莫过于	zh-CN
mgz	每个字	zh-CN
mhdy	曼哈顿	zh-CN
mhe	眯会儿	zh-CN
mhh	明晃晃	zh-CN
mhhl	明晃晃	zh-CN
mhl	梅花鹿	zh-CN
mhp	马后炮	zh-CN
mhpc	马后炮	zh-CN
mhq	灭火器	zh-CN
mhqi	灭火器	zh-CN
mht	明后天	zh-CN
mhtc	猕猴桃	zh-CN
mhth	迷魂汤	zh-CN
mhtm	明后天	zh-CN
mhuo	没话说	zh-CN
mhvf	迷魂阵	zh-CN
mhy	模糊音	zh-CN
mhyb	模糊音	zh-CN
mix	没出息	zh-CN
mixi	没出息	zh-CN
mjh	每句话	zh-CN
mjl	孟加拉	zh-CN
mjla	孟加拉	zh-CN
mjt	没几天	zh-CN
mkf	麦克风	zh-CN
mkfg	麦克风	zh-CN
mkn	没可能	zh-CN
mkng	没可能	zh-CN
mld	没料到	zh-CN
mldc	没料到	zh-CN
mlg	买了个	zh-CN
mlge	摩洛哥	zh-CN
mlh	茉莉花	zh-CN
mlhx	茉莉花	zh-CN
mli	美联储	zh-CN
mlih	名利场	zh-CN
mlj	美利坚	zh-CN
mljm	美利坚	zh-CN
mll	毛利率	zh-CN
mllv	毛利率	zh-CN
mlm	摸了摸	zh-CN
mlmo	摸了摸	zh-CN
mlq	买路钱	zh-CN
mls	马拉松	zh-CN
mlss	马拉松	zh-CN
mlt	麻辣烫	zh-CN
mlu	马铃薯	zh-CN
mlv	面临着	zh-CN
mlve	面临着	zh-CN
mlw	马拉维	zh-CN
mlww	马拉维	zh-CN
mly	没理由	zh-CN
mlya	马来亚	zh-CN
mlyz	没理由	zh-CN
mlz	仫佬族	zh-CN
mlzu	仫佬族	zh-CN
mmb	没明白	zh-CN
mmbd	没明白	zh-CN
mmi	毛毛虫	zh-CN
mmis	毛毛虫	zh-CN
mmld	慢慢来	zh-CN
mmmd	买买买	zh-CN
mmmz	某某某	zh-CN
mmu	明明是	zh-CN
mmv	每秒钟	zh-CN
mmvs	每秒钟	zh-CN
mmw	命名为	zh-CN
mmy	毛毛雨	zh-CN
mnge	摩纳哥	zh-CN
mnh	慕尼黑	zh-CN
mnhw	慕尼黑	zh-CN
mnl	马尼拉	zh-CN
mnla	马尼拉	zh-CN
mny	木乃伊	zh-CN
mnyi	木乃伊	zh-CN
mph	冒牌货	zh-CN
mpt	孟婆汤	zh-CN
mpth	孟婆汤	zh-CN
mqd	马其顿	zh-CN
mqdy	马其顿	zh-CN
mqg	没去过	zh-CN
mqgo	没去过	zh-CN
mql	没钱了	zh-CN
mqle	没钱了	zh-CN
mqx	明确性	zh-CN
mqxk	明确性	zh-CN
mqz	煤气灶	zh-CN
mqzc	煤气灶	zh-CN
mqzu	马前卒	zh-CN
mrj	美人计	zh-CN
mrji	美人计	zh-CN
mrl	没人理	zh-CN
mrli	没人理	zh-CN
mrr	毛茸茸	zh-CN
mrrs	毛茸茸	zh-CN
mrx	没人性	zh-CN
mrxk	没人性	zh-CN
msk	马赛克	zh-CN
mske	莫斯科	zh-CN
msl	忙死了	zh-CN
mslb	穆斯林	zh-CN
msw	没所谓	zh-CN
msww	没所谓	zh-CN
mtd	没听懂	zh-CN
mtf	满天飞	zh-CN
mtfw	满天飞	zh-CN
mtg	没听过	zh-CN
mtgo	没听过	zh-CN
mth	满堂红	zh-CN
mths	满堂红	zh-CN
mti	摩托车	zh-CN
mtie	摩托车	zh-CN
mtj	没听见	zh-CN
mtjm	没听见	zh-CN
mtl	摩天轮	zh-CN
mtlm	马蹄莲	zh-CN
mtlo	曼陀罗	zh-CN
mtly	摩天轮	zh-CN
mtq	没听清	zh-CN
mtqi	蒙太奇	zh-CN
mtt	慢吞吞	zh-CN
mtty	慢吞吞	zh-CN
mtu	没听说	zh-CN
mtuo	没听说	zh-CN
mtx	满天星	zh-CN
mtxk	满天星	zh-CN
mty	猫头鹰	zh-CN
mtyk	猫头鹰	zh-CN
mue	没事儿	zh-CN
mug	没事干	zh-CN
mur	陌生人	zh-CN
murf	陌生人	zh-CN
mvb	门诊部	zh-CN
mvd	明知道	zh-CN
mvdc	没找到	zh-CN
mve	没准儿	zh-CN
mver	没准儿	zh-CN
mvh	民主化	zh-CN
mvhx	民主化	zh-CN
mvj	民政局	zh-CN
mvju	民政局	zh-CN
mvl	命中率	zh-CN
mvlv	命中率	zh-CN
mvm	没这么	zh-CN
mvme	没这么	zh-CN
mvmk	墓志铭	zh-CN
mvv	没找着	zh-CN
mvvc	没找着	zh-CN
mvw	没指望	zh-CN
mvwh	没指望	zh-CN
mvy	没注意	zh-CN
mvyi	没注意	zh-CN
mwhj	门外汉	zh-CN
mwt	没问题	zh-CN
mxd	没想到	zh-CN
mxdc	没想到	zh-CN
mxg	墨西哥	zh-CN
mxge	墨西哥	zh-CN
mxp	明信片	zh-CN
mxpm	明信片	zh-CN
mxq	没兴趣	zh-CN
mxqk	没心情	zh-CN
mxqu	没兴趣	zh-CN
mxr	某些人	zh-CN
mxrf	某些人	zh-CN
mxu	每小时	zh-CN
mxui	每小时	zh-CN
mxv	明细账	zh-CN
mxvh	明细账	zh-CN
mxy	莫须有	zh-CN
mxyz	莫须有	zh-CN
mxz	慢性子	zh-CN
mxzi	慢性子	zh-CN
myb	每一步	zh-CN
mybu	每一步	zh-CN
myc	每一次	zh-CN
myci	每一次	zh-CN
myd	慢一点	zh-CN
mydm	慢一点	zh-CN
mydr	每一段	zh-CN
myf	每一份	zh-CN
myff	每一份	zh-CN
myg	每一个	zh-CN
myge	每一个	zh-CN
mygs	磨洋工	zh-CN
myi	梦一场	zh-CN
myia	母夜叉	zh-CN
myj	没意见	zh-CN
myjm	没意见	zh-CN
myk	每一刻	zh-CN
myke	每一刻	zh-CN
myl	没有了	zh-CN
myle	没有了	zh-CN
myli	免疫力	zh-CN
mylu	沐浴露	zh-CN
mym	摸一摸	zh-CN
mymo	摸一摸	zh-CN
myn	每一年	zh-CN
mynm	每一年	zh-CN
myp	慢一拍	zh-CN
mypd	慢一拍	zh-CN
myqr	牧羊犬	zh-CN
myr	没有人	zh-CN
myrf	明眼人	zh-CN
mys	没意思	zh-CN
mysi	没意思	zh-CN
myt	每一天	zh-CN
mytm	每一天	zh-CN
myu	名义上	zh-CN
myuh	名义上	zh-CN
myv	每一种	zh-CN
myvs	每一种	zh-CN
myw	每一位	zh-CN
myww	每一位	zh-CN
myx	每一项	zh-CN
myxl	每一项	zh-CN
myy	慢悠悠	zh-CN
myyz	慢悠悠	zh-CN
myz	牡羊座	zh-CN
myzo	牡羊座	zh-CN
mzd	毛泽东	zh-CN
mzds	毛泽东	zh-CN
mzg	满足感	zh-CN
mzgj	满足感	zh-CN
mzl	满足了	zh-CN
mzle	满足了	zh-CN
mzm	没怎么	zh-CN
mzme	没怎么	zh-CN
mzz	美滋滋	zh-CN
nbd	弄不懂	zh-CN
nbe	尼泊尔	zh-CN
nber	诺贝尔	zh-CN
nbg	拗不过	zh-CN
nbgo	拗不过	zh-CN
nbh	弄不好	zh-CN
nbhj	捏把汗	zh-CN
nbi	难不成	zh-CN
nbig	难不成	zh-CN
nbj	那不就	zh-CN
nbjq	那不就	zh-CN
nbn	能不能	zh-CN
nbng	能不能	zh-CN
nbq	弄不清	zh-CN
nbqq	南半球	zh-CN
nbu	那不是	zh-CN
nbui	那不是	zh-CN
nbv	耐不住	zh-CN
nbvu	耐不住	zh-CN
nbvy	拿不准	zh-CN
nbz	牛鼻子	zh-CN
nbzi	牛鼻子	zh-CN
ncl	弄错了	zh-CN
ncle	弄错了	zh-CN
ncs	女厕所	zh-CN
ncso	男厕所	zh-CN
ndb	脑电波	zh-CN
ndbo	脑电波	zh-CN
ndl	拿到了	zh-CN
ndrj	那当然	zh-CN
ndu	那倒是	zh-CN
nduo	难道说	zh-CN
ndvg	尿毒症	zh-CN
ndvu	耐得住	zh-CN
ndx	能动性	zh-CN
nfm	哪方面	zh-CN
nfmm	哪方面	zh-CN
ngr	那个人	zh-CN
ngz	那个字	zh-CN
ngzi	那个字	zh-CN
nhdg	霓虹灯	zh-CN
nhe	那会儿	zh-CN
nher	那会儿	zh-CN
nhh	闹哄哄	zh-CN
nhhs	闹哄哄	zh-CN
nhl	拿回来	zh-CN
nhld	拿回来	zh-CN
nhq	奈何桥	zh-CN
nhqn	奈何桥	zh-CN
nhu	那回事	zh-CN
nhz	女孩子	zh-CN
nhzi	男孩子	zh-CN
nil	拿出来	zh-CN
nild	拿出来	zh-CN
njd	能见度	zh-CN
njg	哪几个	zh-CN
njge	哪几个	zh-CN
njh	那句话	zh-CN
njj	牛角尖	zh-CN
njjm	牛角尖	zh-CN
njl	凝聚力	zh-CN
njli	凝聚力	zh-CN
njtm	那几天	zh-CN
njv	南极洲	zh-CN
njvz	南极洲	zh-CN
njy	诺基亚	zh-CN
nll	年利率	zh-CN
nllv	年利率	zh-CN
nlnp	捏了捏	zh-CN
nlv	奴隶制	zh-CN
nmd	那么多	zh-CN
nmdo	那么多	zh-CN
nmg	内蒙古	zh-CN
nmgu	内蒙古	zh-CN
nmv	南美洲	zh-CN
nmvz	南美洲	zh-CN
nmx	匿名信	zh-CN
nmz	脑门子	zh-CN
nmzi	脑门子	zh-CN
nnq	娘娘腔	zh-CN
nnz	努努嘴	zh-CN
npl	拿破仑	zh-CN
nply	拿破仑	zh-CN
npq	牛脾气	zh-CN
npqi	牛脾气	zh-CN
npu	哪怕是	zh-CN
npui	哪怕是	zh-CN
npvi	牛皮纸	zh-CN
npx	牛皮癣	zh-CN
npxr	牛皮癣	zh-CN
npy	女朋友	zh-CN
npyz	男朋友	zh-CN
nqh	年轻化	zh-CN
nqhx	年轻化	zh-CN
nql	哪去了	zh-CN
nqle	哪去了	zh-CN
nqr	年轻人	zh-CN
nre	尼日尔	zh-CN
nrer	尼日尔	zh-CN
nrm	牛肉面	zh-CN
nrmm	牛肉面	zh-CN
nrw	女人味	zh-CN
nulq	泥石流	zh-CN
nur	纳税人	zh-CN
nurf	纳税人	zh-CN
nus	鸟兽散	zh-CN
nusj	鸟兽散	zh-CN
nuv	逆时针	zh-CN
nuvf	逆时针	zh-CN
nvd	哪知道	zh-CN
nvdc	哪知道	zh-CN
nvdh	脑震荡	zh-CN
nvjl	年终奖	zh-CN
nvy	乃至于	zh-CN
nvyu	乃至于	zh-CN
nwq	难为情	zh-CN
nwqk	难为情	zh-CN
nxb	脑细胞	zh-CN
nxbc	脑细胞	zh-CN
nxg	那些个	zh-CN
nxge	那些个	zh-CN
nxh	女性化	zh-CN
nxhx	男性化	zh-CN
nxl	纽西兰	zh-CN
nxlj	纽西兰	zh-CN
nxr	那些人	zh-CN
nxrf	哪些人	zh-CN
nxz	那小子	zh-CN
nxzi	那小子	zh-CN
nxzu	纳西族	zh-CN
nyd	哪一点	zh-CN
nyg	哪一个	zh-CN
nyge	哪一个	zh-CN
nyj	农业局	zh-CN
nyju	农业局	zh-CN
nyr	年月日	zh-CN
nyri	年月日	zh-CN
nyv	哪一种	zh-CN
nyvs	哪一种	zh-CN
nyw	哪一位	zh-CN
nyww	哪一位	zh-CN
nyx	弄一下	zh-CN
nyxt	脑溢血	zh-CN
nyy	暖洋洋	zh-CN
nzh	男子汉	zh-CN
nzhj	男子汉	zh-CN
nzk	牛仔裤	zh-CN
nzku	牛仔裤	zh-CN
nzl	脑子里	zh-CN
nzli	脑子里	zh-CN
nzw	农作物	zh-CN
nzwu	农作物	zh-CN
ogt	欧共体	zh-CN
ogti	欧共体	zh-CN
opk	欧佩克	zh-CN
opke	欧佩克	zh-CN
orx	偶然性	zh-CN
orxk	偶然性	zh-CN
pbd	跑不掉	zh-CN
pbg	皮包骨	zh-CN
pbgu	皮包骨	zh-CN
pbp	怕不怕	zh-CN
pbpa	怕不怕	zh-CN
pbu	配不上	zh-CN
pbui	赔不是	zh-CN
pbx	普遍性	zh-CN
pdb	跑单帮	zh-CN
pdla	潘多拉	zh-CN
pdli	判断力	zh-CN
pfb	皮肤病	zh-CN
pfbk	皮肤病	zh-CN
pfi	剖腹产	zh-CN
pfke	皮肤科	zh-CN
pfm	平方米	zh-CN
pfmi	平方米	zh-CN
pfz	票贩子	zh-CN
pgyk	蒲公英	zh-CN
phb	排行榜	zh-CN
phbh	排行榜	zh-CN
phdm	平衡点	zh-CN
phh	胖乎乎	zh-CN
phhu	胖乎乎	zh-CN
phm	平衡木	zh-CN
phmu	平衡木	zh-CN
phx	破坏性	zh-CN
phxk	破坏性	zh-CN
piq	跑出去	zh-CN
piso	派出所	zh-CN
pix	平常心	zh-CN
pixb	平常心	zh-CN
pjl	破纪录	zh-CN
pjlu	破纪录	zh-CN
pjuu	判决书	zh-CN
pkxm	贫困线	zh-CN
plh	漂亮话	zh-CN
plho	破烂货	zh-CN
plhx	漂亮话	zh-CN
plp	拍了拍	zh-CN
plpd	拍了拍	zh-CN
plt	跑龙套	zh-CN
pltc	跑龙套	zh-CN
plu	泼冷水	zh-CN
pluv	泼冷水	zh-CN
pmk	贫民窟	zh-CN
pmku	贫民窟	zh-CN
pmp	拍马屁	zh-CN
pmq	贫民区	zh-CN
pmt	平面图	zh-CN
pmtu	平面图	zh-CN
pmzu	普米族	zh-CN
ppp	啪啪啪	zh-CN
pppa	啪啪啪	zh-CN
ppqq	乒乓球	zh-CN
ppr	飘飘然	zh-CN
pprj	飘飘然	zh-CN
ppt	PPT	zh-CN
ppth	泡泡糖	zh-CN
ppz	撇撇嘴	zh-CN
pql	爬起来	zh-CN
pqld	爬起来	zh-CN
pqle	抛弃了	zh-CN
pqu	喷气式	zh-CN
pqui	喷气式	zh-CN
prl	平日里	zh-CN
prli	平日里	zh-CN
pru	譬如说	zh-CN
pruo	譬如说	zh-CN
psl	蒲松龄	zh-CN
pslk	蒲松龄	zh-CN
ptg	葡萄干	zh-CN
ptgj	葡萄干	zh-CN
pth	普通话	zh-CN
pthl	破天荒	zh-CN
pthx	普通话	zh-CN
ptl	泡汤了	zh-CN
ptle	泡汤了	zh-CN
ptr	普通人	zh-CN
ptrf	普通人	zh-CN
ptt	葡萄糖	zh-CN
ptth	葡萄糖	zh-CN
ptu	普陀山	zh-CN
ptuj	普陀山	zh-CN
ptx	排他性	zh-CN
ptxk	排他性	zh-CN
pty	葡萄牙	zh-CN
ptya	葡萄牙	zh-CN
pul	盘山路	zh-CN
pux	普适性	zh-CN
puxk	普适性	zh-CN
pvh	破折号	zh-CN
pvhc	破折号	zh-CN
pvhx	攀枝花	zh-CN
pvp	怕只怕	zh-CN
pvpa	怕只怕	zh-CN
pvy	偏重于	zh-CN
pvyu	偏重于	zh-CN
pwx	抛物线	zh-CN
pxx	平行线	zh-CN
pxxm	平行线	zh-CN
pyh	鄱阳湖	zh-CN
pyhu	鄱阳湖	zh-CN
pyx	皮影戏	zh-CN
qa	亲爱的	zh-CN
qad	亲爱的	zh-CN
qade	亲爱的	zh-CN
qbg	气不过	zh-CN
qbgu	敲边鼓	zh-CN
qbjq	前不久	zh-CN
qbju	情报局	zh-CN
qbjx	起步价	zh-CN
qbl	去不了	zh-CN
qbq	瞧不起	zh-CN
qbqu	去不去	zh-CN
qbsv	七八岁	zh-CN
qbt	丘比特	zh-CN
qbte	丘比特	zh-CN
qbu	岂不是	zh-CN
qbuo	且不说	zh-CN
qbv	却不知	zh-CN
qbvi	却不知	zh-CN
qbwj	千百万	zh-CN
qbz	翘辫子	zh-CN
qbzz	齐步走	zh-CN
qdf	清道夫	zh-CN
qdfu	清道夫	zh-CN
qdh	千岛湖	zh-CN
qdhu	千岛湖	zh-CN
qdi	气垫船	zh-CN
qdir	气垫船	zh-CN
qdl	取得了	zh-CN
qdle	取得了	zh-CN
qdq	瞧得起	zh-CN
qdqi	瞧得起	zh-CN
qdv	期待着	zh-CN
qdve	期待着	zh-CN
qdx	确定性	zh-CN
qdxk	确定性	zh-CN
qfb	全封闭	zh-CN
qfbi	全封闭	zh-CN
qfh	千分号	zh-CN
qfhc	千分号	zh-CN
qfq	潜伏期	zh-CN
qfqi	潜伏期	zh-CN
qfv	千分之	zh-CN
qfvi	千分之	zh-CN
qfw	全方位	zh-CN
qfww	全方位	zh-CN
qfx	启发性	zh-CN
qfxk	启发性	zh-CN
qgd	穷光蛋	zh-CN
qgdj	穷光蛋	zh-CN
qgj	缺根筋	zh-CN
qgjb	缺根筋	zh-CN
qgl	奇怪了	zh-CN
qgle	奇怪了	zh-CN
qgq	曲棍球	zh-CN
qgqq	曲棍球	zh-CN
qgx	全国性	zh-CN
qgxk	全国性	zh-CN
qgy	气管炎	zh-CN
qgyj	青光眼	zh-CN
qgz	潜规则	zh-CN
qgze	潜规则	zh-CN
qhd	秦皇岛	zh-CN
qhdc	秦皇岛	zh-CN
qhh	气呼呼	zh-CN
qhhu	气呼呼	zh-CN
qhl	亲和力	zh-CN
qhli	亲和力	zh-CN
qht	秋海棠	zh-CN
qhth	秋海棠	zh-CN
qhu	青海省	zh-CN
qhug	青海省	zh-CN
qhw	氰化物	zh-CN
qhwu	氰化物	zh-CN
qidz	青春痘	zh-CN
qile	起床了	zh-CN
qiqi	青春期	zh-CN
qiuj	青城山	zh-CN
qjd	旗舰店	zh-CN
qjdk	千斤顶	zh-CN
qjf	全家福	zh-CN
qjfu	全家福	zh-CN
qjg	前几个	zh-CN
qjgs	清洁工	zh-CN
qjj	清洁剂	zh-CN
qjji	清洁剂	zh-CN
qjl	请见谅	zh-CN
qjll	请见谅	zh-CN
qjm	前几名	zh-CN
qjmk	前几名	zh-CN
qjp	全键盘	zh-CN
qjpj	全键盘	zh-CN
qjr	前几日	zh-CN
qjri	前几日	zh-CN
qjt	前几天	zh-CN
qjtm	前几天	zh-CN
qjy	取决于	zh-CN
qjyu	取决于	zh-CN
qkxx	情况下	zh-CN
qlg	禽流感	zh-CN
qlgk	奇了怪	zh-CN
qlgu	潜力股	zh-CN
qlma	千里马	zh-CN
qlx	前列腺	zh-CN
qmjp	清明节	zh-CN
qmsu	青霉素	zh-CN
qnl	去哪了	zh-CN
qph	俏皮话	zh-CN
qphx	俏皮话	zh-CN
qpp	轻飘飘	zh-CN
qppn	轻飘飘	zh-CN
qpv	强迫症	zh-CN
qpxk	欺骗性	zh-CN
qqhx	全球化	zh-CN
qsu	起诉书	zh-CN
qsuu	起诉书	zh-CN
qtcc	墙头草	zh-CN
qti	钱塘潮	zh-CN
qtq	青铜器	zh-CN
qtqi	青铜器	zh-CN
quhl	秦始皇	zh-CN
qun	青少年	zh-CN
qvd	起征点	zh-CN
qvdm	起征点	zh-CN
qvf	区政府	zh-CN
qvfu	区政府	zh-CN
qvg	敲竹杠	zh-CN
qvgh	敲竹杠	zh-CN
qvj	起重机	zh-CN
qvji	起重机	zh-CN
qvn	青壮年	zh-CN
qvnm	青壮年	zh-CN
qvs	清真寺	zh-CN
qvsi	清真寺	zh-CN
qvx	强制性	zh-CN
qvxk	强制性	zh-CN
qvy	求知欲	zh-CN
qvyu	求知欲	zh-CN
qvz	前阵子	zh-CN
qvzi	前阵子	zh-CN
qwm	区位码	zh-CN
qwma	区位码	zh-CN
qwv	期望值	zh-CN
qwvi	期望值	zh-CN
qxj	气象局	zh-CN
qxl	取消了	zh-CN
qxle	取消了	zh-CN
qxn	前些年	zh-CN
qxnm	前些年	zh-CN
qxt	气象台	zh-CN
qxtd	气象台	zh-CN
qxy	倾向于	zh-CN
qxyj	缺心眼	zh-CN
qxyu	趋向于	zh-CN
qyb	晴雨表	zh-CN
qybn	晴雨表	zh-CN
qyc	去一次	zh-CN
qyci	去一次	zh-CN
qyd	前一段	zh-CN
qydr	前一段	zh-CN
qyf	七月份	zh-CN
qyff	七月份	zh-CN
qygo	奇异果	zh-CN
qyh	区域化	zh-CN
qyj	企业家	zh-CN
qyl	强有力	zh-CN
qyll	请原谅	zh-CN
qyq	瞧一瞧	zh-CN
qyqn	瞧一瞧	zh-CN
qys	清一色	zh-CN
qyse	清一色	zh-CN
qyu	潜意识	zh-CN
qyui	潜意识	zh-CN
qyx	区域性	zh-CN
qyy	起源于	zh-CN
qzb	签字笔	zh-CN
qzbi	签字笔	zh-CN
qzd	全自动	zh-CN
qzds	全自动	zh-CN
qzy	起作用	zh-CN
qzys	起作用	zh-CN
rbd	容不得	zh-CN
rbde	容不得	zh-CN
rbi	认不出	zh-CN
rbiu	认不出	zh-CN
rbl	饶不了	zh-CN
rbln	饶不了	zh-CN
rbq	惹不起	zh-CN
rbqi	惹不起	zh-CN
rbr	热不热	zh-CN
rbre	热不热	zh-CN
rbv	忍不住	zh-CN
rbvu	忍不住	zh-CN
rbx	容不下	zh-CN
rbxx	容不下	zh-CN
rdd	肉嘟嘟	zh-CN
rdh	惹的祸	zh-CN
rdho	惹的祸	zh-CN
rdy	热带鱼	zh-CN
rdyu	热带鱼	zh-CN
rem	日耳曼	zh-CN
remj	日耳曼	zh-CN
rfz	人贩子	zh-CN
rgq	绕个圈	zh-CN
rgqr	绕个圈	zh-CN
rgy	日光浴	zh-CN
rgyu	日光浴	zh-CN
rhhu	热乎乎	zh-CN
rhj	热乎劲	zh-CN
rhjb	热乎劲	zh-CN
rhr	任何人	zh-CN
rib	日程表	zh-CN
ribn	日程表	zh-CN
rif	入场费	zh-CN
rifw	入场费	zh-CN
riq	入场券	zh-CN
riqr	入场券	zh-CN
rjp	软键盘	zh-CN
rjpj	软键盘	zh-CN
rkl	绕口令	zh-CN
rklk	绕口令	zh-CN
rlf	人来疯	zh-CN
rlfg	人来疯	zh-CN
rlfo	如来佛	zh-CN
rll	人流量	zh-CN
rlll	人流量	zh-CN
rlr	揉了揉	zh-CN
rlrz	揉了揉	zh-CN
rlx	人类学	zh-CN
rlxt	人类学	zh-CN
rmb	人民币	zh-CN
rmbi	人民币	zh-CN
rmm	软绵绵	zh-CN
rmmm	软绵绵	zh-CN
rnl	忍耐力	zh-CN
rnli	忍耐力	zh-CN
rnw	日内瓦	zh-CN
rnwa	日内瓦	zh-CN
rqq	热气球	zh-CN
rqqq	热气球	zh-CN
rqv	人情债	zh-CN
rqw	人情味	zh-CN
rqww	人情味	zh-CN
rqz	绕圈子	zh-CN
rqzi	绕圈子	zh-CN
rru	热热身	zh-CN
rruf	热热身	zh-CN
rrx	柔韧性	zh-CN
rrxk	柔韧性	zh-CN
rsjy	乳酸菌	zh-CN
rsl	热死了	zh-CN
rsle	热死了	zh-CN
rst	染色体	zh-CN
rsti	染色体	zh-CN
rtm	人头马	zh-CN
rtma	人头马	zh-CN
rtt	热腾腾	zh-CN
rttg	热腾腾	zh-CN
rtu	人头税	zh-CN
rtuv	人头税	zh-CN
rug	人生观	zh-CN
ruq	热水器	zh-CN
rvci	肉中刺	zh-CN
rvlu	软着陆	zh-CN
rvr	绕指柔	zh-CN
rvrz	绕指柔	zh-CN
rvy	热衷于	zh-CN
rwl	任务栏	zh-CN
rwlj	任务栏	zh-CN
rwz	绕弯子	zh-CN
rwzi	绕弯子	zh-CN
rxd	人行道	zh-CN
rxdc	人行道	zh-CN
rxh	人性化	zh-CN
rxhx	人性化	zh-CN
ryp	日用品	zh-CN
rypb	日用品	zh-CN
ryq	任意球	zh-CN
ryqq	任意球	zh-CN
ryr	忍一忍	zh-CN
ryrf	忍一忍	zh-CN
ryt	日月潭	zh-CN
rytj	日月潭	zh-CN
ryw	容易忘	zh-CN
rywh	容易忘	zh-CN
rzn	孺子牛	zh-CN
rznq	孺子牛	zh-CN
sbd	三班倒	zh-CN
sbda	斯巴达	zh-CN
sbdc	三班倒	zh-CN
sbh	三把火	zh-CN
sbho	三把火	zh-CN
sbj	所不及	zh-CN
sbji	所不及	zh-CN
sbl	随便了	zh-CN
sbn	随便你	zh-CN
sbni	随便你	zh-CN
sbq	三部曲	zh-CN
sbqu	三部曲	zh-CN
sbs	算不算	zh-CN
sbsr	算不算	zh-CN
sbu	算不上	zh-CN
sbuh	算不上	zh-CN
sbx	四不像	zh-CN
sbxl	四不像	zh-CN
sbz	腮帮子	zh-CN
sbzi	腮帮子	zh-CN
sdj	三等奖	zh-CN
sdjl	三等奖	zh-CN
sdl	死定了	zh-CN
sdle	死定了	zh-CN
sdlq	随大流	zh-CN
sdr	三代人	zh-CN
sdt	死对头	zh-CN
sdtz	死对头	zh-CN
sdu	所得税	zh-CN
sduv	所得税	zh-CN
sdx	私底下	zh-CN
sdxx	私底下	zh-CN
sdy	四大洋	zh-CN
sfj	司法局	zh-CN
sfju	司法局	zh-CN
sfm	三方面	zh-CN
sfq	私房钱	zh-CN
sfqm	私房钱	zh-CN
sft	三伏天	zh-CN
sftm	三伏天	zh-CN
sfv	三分钟	zh-CN
sfvs	三分钟	zh-CN
sgl	苏格兰	zh-CN
sglj	苏格兰	zh-CN
sgr	三个人	zh-CN
sgv	三个钟	zh-CN
sgvi	三国志	zh-CN
sgy	三个月	zh-CN
sgyt	四个月	zh-CN
sgz	三个字	zh-CN
sgzi	四个字	zh-CN
shj	松花江	zh-CN
shjl	松花江	zh-CN
shl	撒哈拉	zh-CN
shla	撒哈拉	zh-CN
shs	四环素	zh-CN
shsu	四环素	zh-CN
sht	死胡同	zh-CN
shts	死胡同	zh-CN
shuo	俗话说	zh-CN
siug	四川省	zh-CN
sjc	私家菜	zh-CN
sjcd	私家菜	zh-CN
sjd	三季度	zh-CN
sjdu	四季度	zh-CN
sjh	三句话	zh-CN
sjhx	三句话	zh-CN
sji	私家车	zh-CN
sjq	丧家犬	zh-CN
sjqr	丧家犬	zh-CN
sjx	三角形	zh-CN
sks	萨克斯	zh-CN
sksi	萨克斯	zh-CN
skt	思考题	zh-CN
skti	思考题	zh-CN
slb	算了吧	zh-CN
slba	算了吧	zh-CN
slg	三连冠	zh-CN
slgr	三连冠	zh-CN
sli	三轮车	zh-CN
slie	三轮车	zh-CN
slk	斯洛克	zh-CN
slke	斯洛克	zh-CN
sll	酸溜溜	zh-CN
sllq	酸溜溜	zh-CN
slm	所罗门	zh-CN
slmf	所罗门	zh-CN
sln	苏里南	zh-CN
slnj	苏里南	zh-CN
sls	算了算	zh-CN
slsr	算了算	zh-CN
sly	司令员	zh-CN
slyr	司令员	zh-CN
slz	撒拉族	zh-CN
slzu	撒拉族	zh-CN
sml	索马里	zh-CN
smli	索马里	zh-CN
smm	色眯眯	zh-CN
smmi	色眯眯	zh-CN
smv	三明治	zh-CN
smvi	三明治	zh-CN
smy	扫描仪	zh-CN
smyi	扫描仪	zh-CN
snj	三年级	zh-CN
snjb	死脑筋	zh-CN
snji	四年级	zh-CN
snk	斯诺克	zh-CN
snke	斯诺克	zh-CN
spl	撕破脸	zh-CN
splm	撕破脸	zh-CN
sqk	三七开	zh-CN
sqkd	三七开	zh-CN
sql	算起来	zh-CN
sqld	算起来	zh-CN
sqq	死翘翘	zh-CN
sqqn	死翘翘	zh-CN
sqy	三缺一	zh-CN
sqyi	三缺一	zh-CN
srx	三人行	zh-CN
ssj	耸耸肩	zh-CN
ssn	三四年	zh-CN
sss	三四岁	zh-CN
sssv	三四岁	zh-CN
sst	三四天	zh-CN
ssui	三四十	zh-CN
stl	三条路	zh-CN
stlu	三条路	zh-CN
sue	塞舌尔	zh-CN
suer	塞舌尔	zh-CN
suh	私生活	zh-CN
suho	私生活	zh-CN
sumf	送上门	zh-CN
sun	三十年	zh-CN
sunv	私生女	zh-CN
sut	随身听	zh-CN
sutk	随身听	zh-CN
suzi	私生子	zh-CN
svy	馊主意	zh-CN
swk	孙悟空	zh-CN
swks	孙悟空	zh-CN
swl	死亡率	zh-CN
swlv	死亡率	zh-CN
sws	四五岁	zh-CN
swsv	四五岁	zh-CN
swu	四五十	zh-CN
swui	四五十	zh-CN
sxj	三星级	zh-CN
sxji	四星级	zh-CN
sxjx	思想家	zh-CN
sxl	私下里	zh-CN
sxli	私下里	zh-CN
sxu	三小时	zh-CN
sxui	三小时	zh-CN
sxw	色香味	zh-CN
sxww	色香味	zh-CN
sxx	思想性	zh-CN
sxxk	思想性	zh-CN
sxy	死心眼	zh-CN
sxyj	死心眼	zh-CN
syff	四月份	zh-CN
syfg	塞牙缝	zh-CN
syh	私有化	zh-CN
syhx	私有化	zh-CN
syn	所以呢	zh-CN
syne	所以呢	zh-CN
syqr	所有权	zh-CN
syrj	所以然	zh-CN
syu	所以说	zh-CN
syuo	所以说	zh-CN
syxk	随意性	zh-CN
syy	扫一眼	zh-CN
szdi	所在地	zh-CN
szjk	三字经	zh-CN
szy	嗓子眼	zh-CN
szyj	嗓子眼	zh-CN
tbc	挺不错	zh-CN
tbco	挺不错	zh-CN
tbd	听不懂	zh-CN
tbds	听不懂	zh-CN
tbg	通不过	zh-CN
tbgo	通不过	zh-CN
tbj	听不见	zh-CN
tbjm	听不见	zh-CN
tbl	太棒了	zh-CN
tble	太棒了	zh-CN
tblu	土八路	zh-CN
tbq	听不清	zh-CN
tbt	听不听	zh-CN
tbtg	疼不疼	zh-CN
tbtk	听不听	zh-CN
tbts	痛不痛	zh-CN
tbu	谈不上	zh-CN
tbuh	谈不上	zh-CN
tcl	听错了	zh-CN
tdl	太多了	zh-CN
tdle	太多了	zh-CN
tdll	挑大梁	zh-CN
tdq	提得起	zh-CN
tdu	谈得上	zh-CN
teq	土耳其	zh-CN
teqi	土耳其	zh-CN
tfj	太费劲	zh-CN
tfjb	太费劲	zh-CN
tfw	铁饭碗	zh-CN
tfwj	铁饭碗	zh-CN
tfx	突发性	zh-CN
tfxk	突发性	zh-CN
tgf	太过分	zh-CN
tgji	铁公鸡	zh-CN
tgl	太贵了	zh-CN
tgle	太贵了	zh-CN
tgx	提个醒	zh-CN
tgxk	提个醒	zh-CN
tgy	铁观音	zh-CN
tgyb	铁观音	zh-CN
tgye	涂改液	zh-CN
thb	天花板	zh-CN
thbj	天花板	zh-CN
thjb	钛合金	zh-CN
thl	太好了	zh-CN
thle	太好了	zh-CN
thtv	拖后腿	zh-CN
thyy	桃花运	zh-CN
til	提出来	zh-CN
tizo	天秤座	zh-CN
tjj	统计局	zh-CN
tjq	太极拳	zh-CN
tjqr	太极拳	zh-CN
tjs	田径赛	zh-CN
tjsd	田径赛	zh-CN
tjzu	土家族	zh-CN
tkl	太快了	zh-CN
tkq	叹口气	zh-CN
tla	谈恋爱	zh-CN
tlai	谈恋爱	zh-CN
tlf	吐鲁番	zh-CN
tlfj	吐鲁番	zh-CN
tlh	挺厉害	zh-CN
tlhd	挺厉害	zh-CN
tlj	拖拉机	zh-CN
tlji	拖拉机	zh-CN
tlju	铁路局	zh-CN
tll	太累了	zh-CN
tlle	太累了	zh-CN
tlr	同龄人	zh-CN
tlrf	同龄人	zh-CN
tls	托拉斯	zh-CN
tlsi	托拉斯	zh-CN
tlt	舔了舔	zh-CN
tltj	谈了谈	zh-CN
tltm	舔了舔	zh-CN
tltv	推了推	zh-CN
tlx	铁了心	zh-CN
tlxb	铁了心	zh-CN
tlz	捅娄子	zh-CN
tlzi	捅娄子	zh-CN
tmb	挑毛病	zh-CN
tmde	他妈的	zh-CN
tml	太慢了	zh-CN
tmle	太慢了	zh-CN
tmv	投名状	zh-CN
tnbk	糖尿病	zh-CN
tns	突尼斯	zh-CN
tnsi	突尼斯	zh-CN
tpf	通配符	zh-CN
tpfu	通配符	zh-CN
tpjm	太平间	zh-CN
tpk	突破口	zh-CN
tpkz	突破口	zh-CN
tpq	踢皮球	zh-CN
tpx	突破性	zh-CN
tpxk	突破性	zh-CN
tpy	太平洋	zh-CN
tpyh	太平洋	zh-CN
tqd	跆拳道	zh-CN
tqdc	跆拳道	zh-CN
tqi	听清楚	zh-CN
tqiu	听清楚	zh-CN
tqj	探亲假	zh-CN
tqjx	探亲假	zh-CN
tql	听起来	zh-CN
tqld	听起来	zh-CN
tqll	提前量	zh-CN
tqx	同情心	zh-CN
tqxb	同情心	zh-CN
tqy	听其言	zh-CN
tqyj	听其言	zh-CN
trj	唐人街	zh-CN
trm	甜如蜜	zh-CN
trmi	甜如蜜	zh-CN
trq	天然气	zh-CN
trqi	天然气	zh-CN
try	挺容易	zh-CN
tryj	讨人厌	zh-CN
tsg	替死鬼	zh-CN
ttd	妥妥的	zh-CN
ttde	妥妥的	zh-CN
ttg	退堂鼓	zh-CN
ttgu	退堂鼓	zh-CN
tti	土特产	zh-CN
ttij	土特产	zh-CN
ttj	凸透镜	zh-CN
ttji	推土机	zh-CN
ttjk	凸透镜	zh-CN
ttl	淘汰了	zh-CN
ttle	淘汰了	zh-CN
ttq	通通气	zh-CN
ttqi	通通气	zh-CN
ttu	提提神	zh-CN
ttuf	提提神	zh-CN
ttv	团团转	zh-CN
ttvr	团团转	zh-CN
ttw	踢踏舞	zh-CN
ttwu	踢踏舞	zh-CN
tug	图书馆	zh-CN
tugo	听说过	zh-CN
tugr	图书馆	zh-CN
tux	特殊性	zh-CN
tuyi	太师椅	zh-CN
tvj	天主教	zh-CN
tvl	偷着乐	zh-CN
tvlj	通知栏	zh-CN
tvlv	通胀率	zh-CN
tvm	同志们	zh-CN
tvu	通知书	zh-CN
tvv	统治者	zh-CN
twh	题外话	zh-CN
twhx	题外话	zh-CN
twj	体温计	zh-CN
twji	体温计	zh-CN
twl	太晚了	zh-CN
twle	太晚了	zh-CN
twlu	图瓦卢	zh-CN
twp	调味品	zh-CN
twpb	调味品	zh-CN
tws	同位素	zh-CN
twsu	同位素	zh-CN
twt	天文台	zh-CN
twtd	天文台	zh-CN
twx	天文学	zh-CN
twxt	天文学	zh-CN
txd	剃须刀	zh-CN
txdc	剃须刀	zh-CN
txi	体现出	zh-CN
txj	退休金	zh-CN
txjb	退休金	zh-CN
txl	通讯录	zh-CN
txle	体现了	zh-CN
txlm	同性恋	zh-CN
txlu	通讯录	zh-CN
txm	同学们	zh-CN
txma	条形码	zh-CN
txmf	同学们	zh-CN
txu	通讯社	zh-CN
txue	通讯社	zh-CN
txv	通行证	zh-CN
txvg	通行证	zh-CN
txw	铜臭味	zh-CN
txww	铜臭味	zh-CN
txx	挑衅性	zh-CN
txxk	挑衅性	zh-CN
txy	同心圆	zh-CN
txzo	天蝎座	zh-CN
tyb	退一步	zh-CN
tyc	头一次	zh-CN
tyci	同义词	zh-CN
tyg	同一个	zh-CN
tyge	同一个	zh-CN
tygr	体育馆	zh-CN
tyh	头一回	zh-CN
tyhv	头一回	zh-CN
tyi	体育场	zh-CN
tyih	体育场	zh-CN
tyl	同意了	zh-CN
tyn	太阳能	zh-CN
tyng	太阳能	zh-CN
tyx	通用性	zh-CN
tyxi	太阳系	zh-CN
tyxk	椭圆形	zh-CN
tyxt	太阳穴	zh-CN
tyy	投影仪	zh-CN
tyyi	投影仪	zh-CN
tyz	同音字	zh-CN
tyzi	同音字	zh-CN
tzv	投资者	zh-CN
tzy	替罪羊	zh-CN
ubd	说不定	zh-CN
ubdc	收不到	zh-CN
ubde	舍不得	zh-CN
ubdk	说不定	zh-CN
ubf	少部分	zh-CN
ubff	少部分	zh-CN
ubi	说不出	zh-CN
ubiu	说不出	zh-CN
ubj	社保局	zh-CN
ubk	社保卡	zh-CN
ubka	社保卡	zh-CN
ubl	受不了	zh-CN
uble	上班了	zh-CN
ubln	受不了	zh-CN
ubn	上半年	zh-CN
ubnm	上半年	zh-CN
ubq	说不清	zh-CN
ubqk	说不清	zh-CN
ubqu	上不去	zh-CN
ubs	十八岁	zh-CN
ubsv	十八岁	zh-CN
ubt	双胞胎	zh-CN
ubtd	双胞胎	zh-CN
ubu	是不是	zh-CN
ubua	傻不傻	zh-CN
ubui	时不时	zh-CN
ubv	睡不着	zh-CN
ubvc	睡不着	zh-CN
ubvy	说不准	zh-CN
ubw	说不完	zh-CN
ubwj	说不完	zh-CN
ubx	睡不醒	zh-CN
ubxk	睡不醒	zh-CN
uby	上半夜	zh-CN
ubye	上半夜	zh-CN
ubz	上辈子	zh-CN
ubzi	使绊子	zh-CN
ucj	收藏夹	zh-CN
uclv	生存率	zh-CN
ucn	守财奴	zh-CN
ucp	收藏品	zh-CN
ucpb	收藏品	zh-CN
uddh	手动挡	zh-CN
uddi	说到底	zh-CN
uddv	说得对	zh-CN
udf	水电费	zh-CN
udfu	士大夫	zh-CN
udfw	水电费	zh-CN
udh	说得好	zh-CN
udj	圣诞节	zh-CN
udjp	圣诞节	zh-CN
udju	水电局	zh-CN
udl	收到了	zh-CN
udle	上当了	zh-CN
udln	受得了	zh-CN
udn	蜀道难	zh-CN
udnj	蜀道难	zh-CN
udr	十多人	zh-CN
udrf	十多人	zh-CN
udt	手电筒	zh-CN
udti	识大体	zh-CN
udts	手电筒	zh-CN
udu	山东省	zh-CN
udug	山东省	zh-CN
udvc	睡得着	zh-CN
udvj	闪电战	zh-CN
udxk	煽动性	zh-CN
udz	书呆子	zh-CN
ueff	十二分	zh-CN
ues	十二岁	zh-CN
uesv	十二岁	zh-CN
uey	十二月	zh-CN
ueyt	十二月	zh-CN
ufe	顺风耳	zh-CN
ufj	煞风景	zh-CN
ufv	身份证	zh-CN
ufvg	身份证	zh-CN
ugdg	闪光灯	zh-CN
ugt	摔跟头	zh-CN
ugtz	摔跟头	zh-CN
uhq	耍花腔	zh-CN
uhu	上海市	zh-CN
uhv	水浒传	zh-CN
uhvr	水浒传	zh-CN
ujbh	沙家浜	zh-CN
ujbk	神经病	zh-CN
ujg	十几个	zh-CN
ujgr	世界观	zh-CN
ujgy	双节棍	zh-CN
ujj	审计局	zh-CN
ujke	神经科	zh-CN
ujku	数据库	zh-CN
ujmo	世纪末	zh-CN
ujsv	十九岁	zh-CN
uju	实际上	zh-CN
ujvi	十进制	zh-CN
ujx	上进心	zh-CN
ukb	时刻表	zh-CN
ukbn	时刻表	zh-CN
ukl	顺口溜	zh-CN
uklq	顺口溜	zh-CN
uky	社科院	zh-CN
ukyr	社科院	zh-CN
uldj	手榴弹	zh-CN
ulg	失落感	zh-CN
ulgj	失落感	zh-CN
ulh	省略号	zh-CN
ulj	睡懒觉	zh-CN
ull	水灵灵	zh-CN
ullk	水灵灵	zh-CN
ullu	湿漉漉	zh-CN
ulm	耍流氓	zh-CN
ulmh	耍流氓	zh-CN
uls	说了算	zh-CN
ulsi	少林寺	zh-CN
ulsv	十六岁	zh-CN
ult	水龙头	zh-CN
ultz	水龙头	zh-CN
ulu	试了试	zh-CN
ulx	生理学	zh-CN
ulxt	生理学	zh-CN
umg	神秘感	zh-CN
umgj	神秘感	zh-CN
umh	书名号	zh-CN
umhc	书名号	zh-CN
umj	双面胶	zh-CN
umjn	双面胶	zh-CN
uml	生命力	zh-CN
umli	生命力	zh-CN
umq	生闷气	zh-CN
umqi	生闷气	zh-CN
umt	水蜜桃	zh-CN
umtc	水蜜桃	zh-CN
umu	说明书	zh-CN
umuu	说明书	zh-CN
umv	实名制	zh-CN
umvi	实名制	zh-CN
umx	生命线	zh-CN
umxm	生命线	zh-CN
umy	守门员	zh-CN
umyr	守门员	zh-CN
umz	数目字	zh-CN
umzi	数目字	zh-CN
ung	少年宫	zh-CN
ungs	少年宫	zh-CN
unj	伤脑筋	zh-CN
unjb	伤脑筋	zh-CN
unjx	神农架	zh-CN
upm	水平面	zh-CN
upmm	水平面	zh-CN
upq	适配器	zh-CN
upqi	适配器	zh-CN
upx	水平线	zh-CN
upxm	水平线	zh-CN
upz	生僻字	zh-CN
upzi	屎盆子	zh-CN
upzo	水瓶座	zh-CN
uqb	受气包	zh-CN
uqbc	受气包	zh-CN
uql	失去了	zh-CN
uqle	失去了	zh-CN
uqn	数千年	zh-CN
uqnm	数千年	zh-CN
uqs	十七岁	zh-CN
uqsv	十七岁	zh-CN
uqx	双曲线	zh-CN
uqxm	双曲线	zh-CN
urf	输入法	zh-CN
urfa	输入法	zh-CN
urh	说人话	zh-CN
uri	双人床	zh-CN
uril	双人床	zh-CN
urj	双刃剑	zh-CN
urjm	双刃剑	zh-CN
urs	收容所	zh-CN
urso	收容所	zh-CN
usd	十三点	zh-CN
usdm	十三点	zh-CN
uss	十三岁	zh-CN
ussv	十四岁	zh-CN
usv	生死战	zh-CN
utl	伤透了	zh-CN
utle	伤透了	zh-CN
utx	试探性	zh-CN
utxk	试探性	zh-CN
uty	晒太阳	zh-CN
utyh	晒太阳	zh-CN
uujm	杀手锏	zh-CN
uulv	收视率	zh-CN
uup	少数派	zh-CN
uuq	上上签	zh-CN
uuvf	顺时针	zh-CN
uuzo	射手座	zh-CN
uvd	谁知道	zh-CN
uvf	市政府	zh-CN
uvq	生殖器	zh-CN
uvt	手指头	zh-CN
uvtz	手指头	zh-CN
uvu	深圳市	zh-CN
uvui	深圳市	zh-CN
uvx	实质性	zh-CN
uwc	商务舱	zh-CN
uwch	商务舱	zh-CN
uwh	上午好	zh-CN
uwj	税务局	zh-CN
uwju	税务局	zh-CN
uwl	耍无赖	zh-CN
uwld	耍无赖	zh-CN
uwlm	食物链	zh-CN
uwm	视网膜	zh-CN
uwmo	视网膜	zh-CN
uwq	生物圈	zh-CN
uwqr	生物圈	zh-CN
uws	事务所	zh-CN
uwso	事务所	zh-CN
uwsv	十五岁	zh-CN
uwt	啥问题	zh-CN
uwti	啥问题	zh-CN
uwu	十位数	zh-CN
uwue	杀无赦	zh-CN
uwuu	十位数	zh-CN
uwv	生物钟	zh-CN
uww	爽歪歪	zh-CN
uwwd	爽歪歪	zh-CN
uwwh	水汪汪	zh-CN
uxb	上下班	zh-CN
uxba	双下巴	zh-CN
uxd	少先队	zh-CN
uxdv	少先队	zh-CN
uxf	手续费	zh-CN
uxfw	手续费	zh-CN
uxh	说瞎话	zh-CN
uxhx	说瞎话	zh-CN
uxj	摄像机	zh-CN
uxjx	数学家	zh-CN
uxl	实现了	zh-CN
uxpu	上下铺	zh-CN
uxq	实习期	zh-CN
uxqi	实习期	zh-CN
uxt	摄像头	zh-CN
uxug	陕西省	zh-CN
uxv	受限制	zh-CN
uxvi	受限制	zh-CN
uxw	上下文	zh-CN
uxwf	上下文	zh-CN
uxxk	时效性	zh-CN
uxy	受限于	zh-CN
uxyu	受限于	zh-CN
uyc	上一次	zh-CN
uyf	十月份	zh-CN
uyff	十月份	zh-CN
uyg	上一个	zh-CN
uyge	上一个	zh-CN
uyh	双引号	zh-CN
uyhc	双引号	zh-CN
uyji	收音机	zh-CN
uyjp	商业街	zh-CN
uyl	收益率	zh-CN
uylv	失业率	zh-CN
uypi	双眼皮	zh-CN
uyq	试用期	zh-CN
uyr	涮羊肉	zh-CN
uys	啥意思	zh-CN
uysi	啥意思	zh-CN
uysv	十一岁	zh-CN
uyt	收银台	zh-CN
uytd	收银台	zh-CN
uytu	示意图	zh-CN
uyu	试一试	zh-CN
uyug	说一声	zh-CN
uyuo	说一说	zh-CN
uyv	是一种	zh-CN
uyvs	是一种	zh-CN
uyw	是因为	zh-CN
uyww	是因为	zh-CN
uyx	试一下	zh-CN
uyxk	商业性	zh-CN
uyxx	试一下	zh-CN
uyy	适用于	zh-CN
uyyr	收银员	zh-CN
uyyt	十一月	zh-CN
uyzo	双鱼座	zh-CN
uzy	受阻于	zh-CN
uzzo	双子座	zh-CN
vbb	皱巴巴	zh-CN
vbba	皱巴巴	zh-CN
vbd	找不到	zh-CN
vbdc	找不到	zh-CN
vbg	只不过	zh-CN
vbgo	只不过	zh-CN
vbh	准备好	zh-CN
vbhc	准备好	zh-CN
vbj	猪八戒	zh-CN
vbjp	猪八戒	zh-CN
vble	准备了	zh-CN
vbu	这不是	zh-CN
vbui	这不是	zh-CN
vbv	找不着	zh-CN
vbvc	找不着	zh-CN
vbvy	准不准	zh-CN
vby	止步于	zh-CN
vbz	这辈子	zh-CN
vbzi	这辈子	zh-CN
vcma	注册码	zh-CN
vdh	这段话	zh-CN
vdhx	这段话	zh-CN
vdj	战斗机	zh-CN
vdl	知道了	zh-CN
vdle	找到了	zh-CN
vdli	战斗力	zh-CN
vdm	知道吗	zh-CN
vdma	知道吗	zh-CN
vdn	正当年	zh-CN
vdnm	正当年	zh-CN
vdu	这倒是	zh-CN
vdui	这倒是	zh-CN
vdxk	针对性	zh-CN
vdy	撞大运	zh-CN
vggz	直勾勾	zh-CN
vgll	诸葛亮	zh-CN
vgr	这个人	zh-CN
vgzi	这个字	zh-CN
vhu	这回事	zh-CN
vilv	支持率	zh-CN
vjg	芝加哥	zh-CN
vjge	芝加哥	zh-CN
vjh	这句话	zh-CN
vjhx	这句话	zh-CN
vjmm	炸酱面	zh-CN
vjn	这几年	zh-CN
vjnm	这几年	zh-CN
vjt	这几天	zh-CN
vjtm	这几天	zh-CN
vjyb	转基因	zh-CN
vkl	逐客令	zh-CN
vklk	逐客令	zh-CN
vku	这可是	zh-CN
vkui	这可是	zh-CN
vkv	准考证	zh-CN
vkvg	准考证	zh-CN
vkw	重口味	zh-CN
vkww	重口味	zh-CN
vkx	只可惜	zh-CN
vkxi	只可惜	zh-CN
vky	中科院	zh-CN
vkyr	中科院	zh-CN
vlh	纸老虎	zh-CN
vlhu	纸老虎	zh-CN
vll	着凉了	zh-CN
vln	中老年	zh-CN
vlpb	战利品	zh-CN
vlt	这两天	zh-CN
vltm	这两天	zh-CN
vlu	蒸馏水	zh-CN
vly	致力于	zh-CN
vmb	这么笨	zh-CN
vmbf	这么笨	zh-CN
vmc	捉迷藏	zh-CN
vmch	捉迷藏	zh-CN
vmd	这么多	zh-CN
vmda	这么大	zh-CN
vmdi	殖民地	zh-CN
vmdm	专卖店	zh-CN
vmdo	这么多	zh-CN
vmdu	知名度	zh-CN
vmg	这么贵	zh-CN
vmgr	芝麻官	zh-CN
vmgv	这么贵	zh-CN
vmh	这么好	zh-CN
vmhc	这么好	zh-CN
vmi	这么长	zh-CN
vmia	这么差	zh-CN
vmiz	这么丑	zh-CN
vmj	这么久	zh-CN
vmjb	真没劲	zh-CN
vmjq	这么久	zh-CN
vmk	这么快	zh-CN
vml	这么懒	zh-CN
vmm	这么慢	zh-CN
vmmg	这么猛	zh-CN
vmmj	这么慢	zh-CN
vmn	这么难	zh-CN
vmnj	这么难	zh-CN
vmnl	丈母娘	zh-CN
vmp	这么胖	zh-CN
vmph	这么胖	zh-CN
vmq	这么巧	zh-CN
vmqn	这么巧	zh-CN
vmr	掌门人	zh-CN
vmrf	掌门人	zh-CN
vmt	皱眉头	zh-CN
vmtz	皱眉头	zh-CN
vmu	这么说	zh-CN
vmuc	这么少	zh-CN
vmul	这么爽	zh-CN
vmuo	这么说	zh-CN
vmv	中美洲	zh-CN
vmvz	中美洲	zh-CN
vmw	这么晚	zh-CN
vmwj	这么晚	zh-CN
vmx	这么想	zh-CN
vmxl	这么想	zh-CN
vmxn	这么小	zh-CN
vmy	这么远	zh-CN
vmyr	这么远	zh-CN
vmz	这么早	zh-CN
vmzc	这么早	zh-CN
vne	执牛耳	zh-CN
vner	执牛耳	zh-CN
vnh	中南海	zh-CN
vnhd	中南海	zh-CN
vnj	滞纳金	zh-CN
vnjb	滞纳金	zh-CN
vnt	智囊团	zh-CN
vntr	智囊团	zh-CN
vnu	只能说	zh-CN
vnui	之能事	zh-CN
vnuo	只能说	zh-CN
vnv	指南针	zh-CN
vnvf	指南针	zh-CN
vpr	制片人	zh-CN
vprf	制片人	zh-CN
vpy	占便宜	zh-CN
vpyi	占便宜	zh-CN
vqg	支气管	zh-CN
vqj	中秋节	zh-CN
vqjp	中秋节	zh-CN
vqju	中情局	zh-CN
vql	站起来	zh-CN
vqlv	准确率	zh-CN
vqr	知其然	zh-CN
vqrj	知其然	zh-CN
vqx	准确性	zh-CN
vqxk	周期性	zh-CN
vqy	知其一	zh-CN
vqyi	知其一	zh-CN
vrw	主人翁	zh-CN
vsy	之所以	zh-CN
vtb	涨停板	zh-CN
vtbj	涨停板	zh-CN
vtbn	招投标	zh-CN
vtg	转托管	zh-CN
vtgr	转托管	zh-CN
vti	直通车	zh-CN
vtie	直通车	zh-CN
vtl	状态栏	zh-CN
vtlj	状态栏	zh-CN
vtlu	这条路	zh-CN
vtr	猪头肉	zh-CN
vtrz	猪头肉	zh-CN
vtt	直挺挺	zh-CN
vttk	直挺挺	zh-CN
vtx	重头戏	zh-CN
vtxi	重头戏	zh-CN
vub	正式版	zh-CN
vux	真实性	zh-CN
vvb	正准备	zh-CN
vvbw	正准备	zh-CN
vvd	转折点	zh-CN
vvdm	转折点	zh-CN
vvhx	政治化	zh-CN
vvp	战争片	zh-CN
vvpm	战争片	zh-CN
vvu	这种事	zh-CN
vvui	这种事	zh-CN
vwb	中文版	zh-CN
vwbj	中文版	zh-CN
vwd	爪哇岛	zh-CN
vwdc	爪哇岛	zh-CN
vwm	中文名	zh-CN
vwmk	中文名	zh-CN
vwr	债务人	zh-CN
vwrf	植物人	zh-CN
vxfj	正相反	zh-CN
vxg	照相馆	zh-CN
vxgo	轴心国	zh-CN
vxgr	照相馆	zh-CN
vxgu	主心骨	zh-CN
vxh	真心话	zh-CN
vxhx	这些话	zh-CN
vxj	照相机	zh-CN
vxji	照相机	zh-CN
vxjx	哲学家	zh-CN
vxl	执行力	zh-CN
vxlv	主旋律	zh-CN
vxn	这些年	zh-CN
vxnm	这些年	zh-CN
vxq	中心区	zh-CN
vxr	这些人	zh-CN
vxt	这些天	zh-CN
vxtm	这些天	zh-CN
vxu	中学生	zh-CN
vxug	中学生	zh-CN
vxui	直辖市	zh-CN
vxy	只限于	zh-CN
vxyu	只限于	zh-CN
vxz	直性子	zh-CN
vyb	职业病	zh-CN
vybk	职业病	zh-CN
vyc	这一次	zh-CN
vyci	这一次	zh-CN
vye	扎伊尔	zh-CN
vyer	扎伊尔	zh-CN
vyf	障眼法	zh-CN
vyfa	障眼法	zh-CN
vyg	找一个	zh-CN
vyh	这一回	zh-CN
vyhu	专业户	zh-CN
vyj	转眼间	zh-CN
vyjm	转眼间	zh-CN
vyk	这一块	zh-CN
vyl	注意力	zh-CN
vyli	注意力	zh-CN
vym	至于吗	zh-CN
vyma	至于吗	zh-CN
vyq	转一圈	zh-CN
vyqk	竹叶青	zh-CN
vyqr	转一圈	zh-CN
vys	这也算	zh-CN
vysr	这也算	zh-CN
vyt	这一天	zh-CN
vytc	这一套	zh-CN
vyu	主要是	zh-CN
vyv	志愿者	zh-CN
vyw	中英文	zh-CN
vywf	中英文	zh-CN
vyww	正因为	zh-CN
vyx	重要性	zh-CN
vyz	这样子	zh-CN
vyzi	这样子	zh-CN
vzh	栀子花	zh-CN
vzhx	栀子花	zh-CN
wani	我爱你	zh-CN
wbb	喂不饱	zh-CN
wbbc	喂不饱	zh-CN
wbc	窝边草	zh-CN
wbcc	窝边草	zh-CN
wbd	王八蛋	zh-CN
wbdj	王八蛋	zh-CN
wbh	五笔画	zh-CN
wbhx	五笔画	zh-CN
wbi	完不成	zh-CN
wbig	完不成	zh-CN
wbl	忘不了	zh-CN
wbln	忘不了	zh-CN
wblu	微波炉	zh-CN
wbq	玩不起	zh-CN
wbqi	玩不起	zh-CN
wbu	无不是	zh-CN
wbui	无不是	zh-CN
wbv	玩不转	zh-CN
wbvr	玩不转	zh-CN
wbvu	握不住	zh-CN
wbw	玩不玩	zh-CN
wdd	无底洞	zh-CN
wdds	无底洞	zh-CN
wdl	完蛋了	zh-CN
wdv	五大洲	zh-CN
wdvz	五大洲	zh-CN
wdx	稳定性	zh-CN
wema	沃尔玛	zh-CN
wfv	五分钟	zh-CN
wgd	乌干达	zh-CN
wgda	乌干达	zh-CN
wgj	乌骨鸡	zh-CN
wgji	乌骨鸡	zh-CN
wgke	五官科	zh-CN
wgl	玩够了	zh-CN
wgle	玩够了	zh-CN
wgn	亡国奴	zh-CN
wgnu	亡国奴	zh-CN
wgr	外国人	zh-CN
wgrf	外国人	zh-CN
wgz	五个字	zh-CN
wgzi	五个字	zh-CN
whf	未婚夫	zh-CN
whq	未婚妻	zh-CN
whqi	未婚妻	zh-CN
whr	五花肉	zh-CN
whrz	五花肉	zh-CN
wht	万花筒	zh-CN
wid	胃肠道	zh-CN
widc	胃肠道	zh-CN
wim	无重码	zh-CN
wima	无重码	zh-CN
win	未成年	zh-CN
winm	未成年	zh-CN
wiv	无产者	zh-CN
wive	无产者	zh-CN
wjj	文件夹	zh-CN
wjm	文件名	zh-CN
wjz	伪君子	zh-CN
wkl	乌克兰	zh-CN
wklj	乌克兰	zh-CN
wky	胃溃疡	zh-CN
wkyh	胃溃疡	zh-CN
wkyu	无愧于	zh-CN
wlb	忘了吧	zh-CN
wlba	忘了吧	zh-CN
wld	五六点	zh-CN
wldz	窝里斗	zh-CN
wlf	窝里反	zh-CN
wlfj	窝里反	zh-CN
wlg	乌拉圭	zh-CN
wlgv	乌拉圭	zh-CN
wlh	网络化	zh-CN
wlhx	网络化	zh-CN
wli	乌龙茶	zh-CN
wlia	乌龙茶	zh-CN
wlk	往来款	zh-CN
wlkr	往来款	zh-CN
wlm	无理码	zh-CN
wlma	无理码	zh-CN
wls	五六岁	zh-CN
wlsv	五六岁	zh-CN
wlt	玩两天	zh-CN
wltz	无厘头	zh-CN
wlu	五六十	zh-CN
wlui	五六十	zh-CN
wlw	问了问	zh-CN
wlwf	问了问	zh-CN
wlx	物理学	zh-CN
wlxt	物理学	zh-CN
wly	五粮液	zh-CN
wlye	五粮液	zh-CN
wmt	亡命徒	zh-CN
wmtu	亡命徒	zh-CN
wmu	无名氏	zh-CN
wmui	无名氏	zh-CN
wmv	无名指	zh-CN
wnf	窝囊废	zh-CN
wnfw	窝囊废	zh-CN
wnj	五年级	zh-CN
wnji	五年级	zh-CN
wnjm	万能键	zh-CN
wnjn	忘年交	zh-CN
wnl	万年历	zh-CN
wnli	万年历	zh-CN
wnq	窝囊气	zh-CN
wnqi	窝囊气	zh-CN
wns	威尼斯	zh-CN
wnsi	威尼斯	zh-CN
wnu	毋宁说	zh-CN
wnuo	毋宁说	zh-CN
wqj	挖墙脚	zh-CN
wqjn	挖墙脚	zh-CN
wry	污染源	zh-CN
wryr	污染源	zh-CN
wsm	为什么	zh-CN
wsn	外孙女	zh-CN
wsnv	外孙女	zh-CN
wsw	无所谓	zh-CN
wtb	乌托邦	zh-CN
wtbh	乌托邦	zh-CN
wth	渥太华	zh-CN
wthx	渥太华	zh-CN
wtj	无条件	zh-CN
wtjm	无条件	zh-CN
wtm	维他命	zh-CN
wtmk	维他命	zh-CN
wtr	委托人	zh-CN
wtrf	委托人	zh-CN
wtu	问题是	zh-CN
wtui	问题是	zh-CN
wtuj	五台山	zh-CN
wuhc	晚上好	zh-CN
wumc	乌纱帽	zh-CN
wume	为什么	zh-CN
wusu	维生素	zh-CN
wva	无障碍	zh-CN
wvai	无障碍	zh-CN
wvf	无政府	zh-CN
wvfu	无政府	zh-CN
wvg	尾椎骨	zh-CN
wvgu	尾椎骨	zh-CN
wvh	无纸化	zh-CN
wvhx	无纸化	zh-CN
wvj	无止境	zh-CN
wvjk	无止境	zh-CN
wvv	文绉绉	zh-CN
wvvz	文绉绉	zh-CN
wvx	完整性	zh-CN
wvxk	完整性	zh-CN
wvy	无助于	zh-CN
wwer	维吾尔	zh-CN
wwl	玩完了	zh-CN
wxd	无线电	zh-CN
wxdm	无线电	zh-CN
wxi	胃下垂	zh-CN
wxiv	胃下垂	zh-CN
wxj	五星级	zh-CN
wxji	五星级	zh-CN
wxjx	文学家	zh-CN
wxp	五线谱	zh-CN
wxpu	五线谱	zh-CN
wxq	危险期	zh-CN
wxqi	危险期	zh-CN
wxr	外星人	zh-CN
wxrf	外星人	zh-CN
wxv	无休止	zh-CN
wxvi	无休止	zh-CN
wxw	无线网	zh-CN
wxwh	无线网	zh-CN
wxx	危险性	zh-CN
wxxk	危险性	zh-CN
wyb	晚一步	zh-CN
wyd	晚一点	zh-CN
wydm	晚一点	zh-CN
wye	玩意儿	zh-CN
wyer	玩意儿	zh-CN
wyf	五月份	zh-CN
wyff	五月份	zh-CN
wyg	无用功	zh-CN
wygs	无用功	zh-CN
wyj	无意间	zh-CN
wyjk	望远镜	zh-CN
wyl	无压力	zh-CN
wyli	无压力	zh-CN
wyn	维也纳	zh-CN
wyna	维也纳	zh-CN
wyu	武夷山	zh-CN
wyui	无疑是	zh-CN
wyuj	武夷山	zh-CN
wyv	无意中	zh-CN
wyvs	无意中	zh-CN
wyw	文言文	zh-CN
wywf	文言文	zh-CN
wyx	问一下	zh-CN
wyxi	玩游戏	zh-CN
wyy	无异于	zh-CN
wyyu	无异于	zh-CN
wyz	乌鸦嘴	zh-CN
wyzv	乌鸦嘴	zh-CN
wzf	外祖父	zh-CN
wzfu	外祖父	zh-CN
wzl	屋子里	zh-CN
wzli	屋子里	zh-CN
wzm	外祖母	zh-CN
wzmu	外祖母	zh-CN
wzq	五子棋	zh-CN
wzqi	五子棋	zh-CN
wzxi	晚自习	zh-CN
xbbo	香饽饽	zh-CN
xbf	西北风	zh-CN
xbg	信不过	zh-CN
xbgo	信不过	zh-CN
xbi	想不出	zh-CN
xbk	想不开	zh-CN
xbkd	想不开	zh-CN
xble	下班了	zh-CN
xbn	下半年	zh-CN
xbq	想不起	zh-CN
xbsj	小瘪三	zh-CN
xbt	想不通	zh-CN
xbv	闲不住	zh-CN
xbya	西班牙	zh-CN
xbye	下半夜	zh-CN
xbz	下辈子	zh-CN
xcb	下次吧	zh-CN
xcba	下次吧	zh-CN
xcj	下次见	zh-CN
xcjm	下次见	zh-CN
xcm	小聪明	zh-CN
xcmk	小聪明	zh-CN
xcx	瞎操心	zh-CN
xcxb	瞎操心	zh-CN
xdd	响当当	zh-CN
xdda	羞答答	zh-CN
xddh	响当当	zh-CN
xdg	信得过	zh-CN
xdgo	信得过	zh-CN
xdh	闲得慌	zh-CN
xdhx	现代化	zh-CN
xdi	想当初	zh-CN
xdj	洗涤剂	zh-CN
xdk	想得开	zh-CN
xdkd	想得开	zh-CN
xdl	想到了	zh-CN
xdle	想到了	zh-CN
xdli	新德里	zh-CN
xdlu	新大陆	zh-CN
xdm	想得美	zh-CN
xdmw	想得美	zh-CN
xdn	想当年	zh-CN
xdnm	想当年	zh-CN
xdr	想当然	zh-CN
xdrf	许多人	zh-CN
xdrj	想当然	zh-CN
xdt	行得通	zh-CN
xdts	行得通	zh-CN
xdw	现代文	zh-CN
xdwf	现代文	zh-CN
xdx	相对性	zh-CN
xdxk	相对性	zh-CN
xdy	相当于	zh-CN
xdyu	相当于	zh-CN
xdz	小动作	zh-CN
xdzo	小动作	zh-CN
xed	希尔顿	zh-CN
xedy	希尔顿	zh-CN
xej	小而精	zh-CN
xejk	小而精	zh-CN
xek	小儿科	zh-CN
xeke	小儿科	zh-CN
xeu	形而上	zh-CN
xeuh	形而上	zh-CN
xex	形而下	zh-CN
xexx	形而下	zh-CN
xfd	小幅度	zh-CN
xfdu	小幅度	zh-CN
xfe	媳妇儿	zh-CN
xfer	媳妇儿	zh-CN
xfi	消防车	zh-CN
xfie	消防车	zh-CN
xfj	兴奋剂	zh-CN
xfji	兴奋剂	zh-CN
xfp	消费品	zh-CN
xfpb	消费品	zh-CN
xfu	洗发水	zh-CN
xfuv	消费税	zh-CN
xfv	消费者	zh-CN
xfve	消费者	zh-CN
xfx	新发现	zh-CN
xfxm	新发现	zh-CN
xfy	消防员	zh-CN
xfyr	消防员	zh-CN
xgb	修改版	zh-CN
xgbj	修改版	zh-CN
xgc	小高层	zh-CN
xgcg	小高层	zh-CN
xgd	香港岛	zh-CN
xgdc	香港岛	zh-CN
xgf	闲工夫	zh-CN
xgfu	下工夫	zh-CN
xgg	修改稿	zh-CN
xggc	修改稿	zh-CN
xgi	性高潮	zh-CN
xgic	性高潮	zh-CN
xgj	膝关节	zh-CN
xgjp	膝关节	zh-CN
xgl	习惯了	zh-CN
xgle	习惯了	zh-CN
xgn	小姑娘	zh-CN
xgnl	小姑娘	zh-CN
xgu	习惯上	zh-CN
xgx	习惯性	zh-CN
xgxk	习惯性	zh-CN
xgy	下个月	zh-CN
xgyt	下个月	zh-CN
xgz	洗个澡	zh-CN
xgzc	洗个澡	zh-CN
xhb	小伙伴	zh-CN
xhd	信号灯	zh-CN
xhdg	信号灯	zh-CN
xhh	笑呵呵	zh-CN
xhhe	笑呵呵	zh-CN
xhu	西红柿	zh-CN
xhv	向后转	zh-CN
xhvr	向后转	zh-CN
xhw	小黑屋	zh-CN
xhx	下划线	zh-CN
xhxm	下划线	zh-CN
xhy	歇后语	zh-CN
xhz	小孩子	zh-CN
xhzi	小伙子	zh-CN
xide	现成的	zh-CN
xide	现成的	zh-CN
xiis	兴冲冲	zh-CN
xipm	宣传片	zh-CN
xiq	吸尘器	zh-CN
xjb	性价比	zh-CN
xjd	现阶段	zh-CN
xjdr	现阶段	zh-CN
xjh	戏剧化	zh-CN
xjho	小家伙	zh-CN
xjhx	戏剧化	zh-CN
xji	小轿车	zh-CN
xjie	小轿车	zh-CN
xjiv	洗剪吹	zh-CN
xjj	小九九	zh-CN
xjjk	洗洁精	zh-CN
xjjq	小九九	zh-CN
xjl	下结论	zh-CN
xjln	下脚料	zh-CN
xjp	新加坡	zh-CN
xjpm	喜剧片	zh-CN
xjpo	新加坡	zh-CN
xjq	陷进去	zh-CN
xjqu	陷进去	zh-CN
xjt	心绞痛	zh-CN
xjts	心绞痛	zh-CN
xjx	戏剧性	zh-CN
xjxk	先进性	zh-CN
xjy	相较于	zh-CN
xjyu	相较于	zh-CN
xldj	性冷淡	zh-CN
xlkz	小两口	zh-CN
xmh	瞎忙活	zh-CN
xmhu	笑面虎	zh-CN
xmmi	笑眯眯	zh-CN
xpca	橡皮擦	zh-CN
xphd	小屁孩	zh-CN
xpl	下坡路	zh-CN
xpn	橡皮泥	zh-CN
xpni	橡皮泥	zh-CN
xppf	香喷喷	zh-CN
xpyz	小朋友	zh-CN
xqce	需求侧	zh-CN
xqer	星期二	zh-CN
xqi	想清楚	zh-CN
xqie	小汽车	zh-CN
xqkj	向前看	zh-CN
xql	想起来	zh-CN
xqld	想起来	zh-CN
xqle	想起了	zh-CN
xqlq	星期六	zh-CN
xqri	星期日	zh-CN
xqsi	星期四	zh-CN
xqsj	星期三	zh-CN
xqt	星期天	zh-CN
xqtm	星期天	zh-CN
xqwu	星期五	zh-CN
xqyi	星期一	zh-CN
xrkv	向日葵	zh-CN
xrvh	仙人掌	zh-CN
xrxb	虚荣心	zh-CN
xsf	泄私愤	zh-CN
xsff	泄私愤	zh-CN
xsjy	新四军	zh-CN
xsl	下三滥	zh-CN
xslj	下三滥	zh-CN
xsp	小算盘	zh-CN
xspj	小算盘	zh-CN
xsr	吓死人	zh-CN
xsrf	吓死人	zh-CN
xtj	下台阶	zh-CN
xtl	想通了	zh-CN
xtq	小提琴	zh-CN
xudm	小数点	zh-CN
xuhv	学生会	zh-CN
xuhz	小时候	zh-CN
xujm	洗手间	zh-CN
xule	消失了	zh-CN
xupk	显示屏	zh-CN
xuq	显示器	zh-CN
xuqi	显示器	zh-CN
xuvg	学生证	zh-CN
xvb	修正版	zh-CN
xvbj	修正版	zh-CN
xvd	想知道	zh-CN
xve	下周二	zh-CN
xver	下周二	zh-CN
xvf	县政府	zh-CN
xvfu	乡政府	zh-CN
xvh	瞎指挥	zh-CN
xvhv	瞎指挥	zh-CN
xvj	新专辑	zh-CN
xvji	新专辑	zh-CN
xvl	下周六	zh-CN
xvlq	下周六	zh-CN
xvq	行政区	zh-CN
xvr	下周日	zh-CN
xvri	下周日	zh-CN
xvs	下周三	zh-CN
xvsi	下周四	zh-CN
xvt	瞎折腾	zh-CN
xvw	下周五	zh-CN
xvx	象征性	zh-CN
xvxk	象征性	zh-CN
xvy	下周一	zh-CN
xvyi	下周一	zh-CN
xwi	下午茶	zh-CN
xwia	下午茶	zh-CN
xwj	显微镜	zh-CN
xwjk	显微镜	zh-CN
xwl	想歪了	zh-CN
xwle	想歪了	zh-CN
xwx	新文学	zh-CN
xwxt	新文学	zh-CN
xwy	夏威夷	zh-CN
xwyi	夏威夷	zh-CN
xxdm	小心点	zh-CN
xxg	新鲜感	zh-CN
xxl	想象力	zh-CN
xxlj	新西兰	zh-CN
xxn	谢谢你	zh-CN
xxni	谢谢你	zh-CN
xxug	小学生	zh-CN
xxvs	想象中	zh-CN
xxww	性行为	zh-CN
xxx	笑嘻嘻	zh-CN
xybu	下一步	zh-CN
xyci	下一次	zh-CN
xyff	洗衣粉	zh-CN
xyg	下一个	zh-CN
xyge	下一个	zh-CN
xyj	洗衣机	zh-CN
xyka	信用卡	zh-CN
xyl	吸引力	zh-CN
xyn	下一年	zh-CN
xypd	学院派	zh-CN
xyr	吸引人	zh-CN
xyta	象牙塔	zh-CN
xytm	下雨天	zh-CN
xytn	吓一跳	zh-CN
xytu	西雅图	zh-CN
xyu	下意识	zh-CN
xyx	想一想	zh-CN
xzb	心脏病	zh-CN
xzbk	心脏病	zh-CN
xzj	写字间	zh-CN
xzjm	写字间	zh-CN
xzl	写字楼	zh-CN
xzlz	写字楼	zh-CN
xzm	瞎琢磨	zh-CN
xzmo	瞎琢磨	zh-CN
xzq	协奏曲	zh-CN
xzqu	协奏曲	zh-CN
xzr	闲杂人	zh-CN
xzt	写字台	zh-CN
xztd	写字台	zh-CN
xzx	选择性	zh-CN
xzxk	选择性	zh-CN
xzy	写作业	zh-CN
xzye	写作业	zh-CN
ybkv	哑巴亏	zh-CN
ybba	眼巴巴	zh-CN
ybbj	一般般	zh-CN
ybbm	一遍遍	zh-CN
ybbu	一步步	zh-CN
ybco	也不错	zh-CN
ybf	一部分	zh-CN
ybff	一部分	zh-CN
ybh	也不会	zh-CN
ybig	言必称	zh-CN
ybr	要不然	zh-CN
ybs	也不算	zh-CN
ybsr	也不算	zh-CN
ybuh	用不上	zh-CN
ybuz	一把手	zh-CN
ybvc	用不着	zh-CN
ybyc	要不要	zh-CN
ybz	一辈子	zh-CN
ycci	一次次	zh-CN
ycl	原材料	zh-CN
ycln	原材料	zh-CN
yczi	油菜籽	zh-CN
yda	印第安	zh-CN
ydan	印第安	zh-CN
ydb	一大把	zh-CN
ydba	一大把	zh-CN
ydbh	一大帮	zh-CN
ydd	一点点	zh-CN
yddv	一大堆	zh-CN
yde	一点儿	zh-CN
yder	一点儿	zh-CN
ydf	一顿饭	zh-CN
ydg	一等功	zh-CN
ydgs	一等功	zh-CN
ydh	运动会	zh-CN
ydhv	一定会	zh-CN
ydhx	一段话	zh-CN
ydi	一大串	zh-CN
ydir	一大串	zh-CN
ydj	一等奖	zh-CN
ydjl	一等奖	zh-CN
ydjp	一大截	zh-CN
ydju	邮电局	zh-CN
ydk	一大口	zh-CN
ydkz	一大口	zh-CN
ydl	意大利	zh-CN
ydli	意大利	zh-CN
ydlo	一大摞	zh-CN
ydm	源代码	zh-CN
ydma	源代码	zh-CN
ydn	雅典娜	zh-CN
ydna	雅典娜	zh-CN
ydp	一大片	zh-CN
ydpi	一大批	zh-CN
ydpm	一大片	zh-CN
ydq	一大群	zh-CN
ydqp	一刀切	zh-CN
ydqy	一大群	zh-CN
ydr	有的人	zh-CN
ydrf	一代人	zh-CN
yds	胰岛素	zh-CN
ydsu	胰岛素	zh-CN
ydt	冤大头	zh-CN
ydtz	冤大头	zh-CN
ydu	有点事	zh-CN
ydui	有点事	zh-CN
yduo	应当说	zh-CN
ydv	用得着	zh-CN
ydw	亚丁湾	zh-CN
ydwj	亚丁湾	zh-CN
ydx	运动鞋	zh-CN
ydxk	压倒性	zh-CN
ydxp	运动鞋	zh-CN
ydy	印度洋	zh-CN
ydyc	一定要	zh-CN
ydyr	运动员	zh-CN
ydz	一大早	zh-CN
ydzi	一肚子	zh-CN
yeyr	幼儿园	zh-CN
yez	幺蛾子	zh-CN
yfh	一分货	zh-CN
yfho	一分货	zh-CN
yfhx	一幅画	zh-CN
yfk	预付款	zh-CN
yfkr	预付款	zh-CN
yfl	引发了	zh-CN
yfle	引发了	zh-CN
yfm	一方面	zh-CN
yfmm	一方面	zh-CN
yfq	一分钱	zh-CN
yfqm	一分钱	zh-CN
yfv	一分钟	zh-CN
yfvs	一分钟	zh-CN
yfx	一封信	zh-CN
yfxb	一封信	zh-CN
yfy	依附于	zh-CN
yfyu	依附于	zh-CN
ygb	一个班	zh-CN
ygc	一个词	zh-CN
ygci	一个词	zh-CN
ygd	应该的	zh-CN
ygdc	阳关道	zh-CN
ygdr	一锅端	zh-CN
yge	压根儿	zh-CN
ygf	一公分	zh-CN
ygff	一公分	zh-CN
ygg	一个个	zh-CN
ygge	一个个	zh-CN
yggu	圆鼓鼓	zh-CN
ygh	一锅烩	zh-CN
yghv	一锅烩	zh-CN
ygj	一个劲	zh-CN
ygjb	一根筋	zh-CN
ygjq	压根就	zh-CN
ygl	英格兰	zh-CN
ygm	一个梦	zh-CN
ygp	荧光屏	zh-CN
ygpk	荧光屏	zh-CN
ygr	一个人	zh-CN
ygrf	一个人	zh-CN
ygu	应该是	zh-CN
ygui	应该是	zh-CN
yguo	应该说	zh-CN
ygv	一个钟	zh-CN
ygvs	一个钟	zh-CN
ygvz	一锅粥	zh-CN
ygy	一个月	zh-CN
ygyt	一个月	zh-CN
ygz	一个字	zh-CN
ygzi	一个字	zh-CN
ygzu	裕固族	zh-CN
yher	一会儿	zh-CN
yht	雨花台	zh-CN
yhu	一回事	zh-CN
yhv	与会者	zh-CN
yiks	一场空	zh-CN
yina	一刹那	zh-CN
yjda	雅加达	zh-CN
yjrf	一家人	zh-CN
ykdc	一看到	zh-CN
ykng	有可能	zh-CN
ykq	一口气	zh-CN
ykqm	一块钱	zh-CN
ykv	眼看着	zh-CN
ykvs	一刻钟	zh-CN
ylb	一览表	zh-CN
ylbn	一览表	zh-CN
ylc	一两次	zh-CN
ylci	一两次	zh-CN
yld	一两点	zh-CN
yldm	一两点	zh-CN
ylf	医疗费	zh-CN
ylfw	医疗费	zh-CN
ylg	一两个	zh-CN
ylge	一两个	zh-CN
ylgr	易拉罐	zh-CN
ylh	一两回	zh-CN
ylho	一路货	zh-CN
ylhv	一两回	zh-CN
yli	一连串	zh-CN
ylih	游乐场	zh-CN
ylir	一连串	zh-CN
ylj	一两句	zh-CN
yljy	御林军	zh-CN
ylk	伊拉克	zh-CN
ylke	伊拉克	zh-CN
yll	又来了	zh-CN
ylle	又来了	zh-CN
ylm	跃龙门	zh-CN
ylmf	跃龙门	zh-CN
yln	一两年	zh-CN
ylnm	一两年	zh-CN
yls	一两岁	zh-CN
ylsu	叶绿素	zh-CN
ylt	一两天	zh-CN
yltm	一两天	zh-CN
ylu	原来是	zh-CN
ylui	原来是	zh-CN
ylv	意料中	zh-CN
ylw	阎罗王	zh-CN
ylx	依赖性	zh-CN
ylxk	娱乐性	zh-CN
yly	越来越	zh-CN
ylyu	有利于	zh-CN
ylyz	有理由	zh-CN
ylz	一揽子	zh-CN
ylzi	一揽子	zh-CN
ymb	有毛病	zh-CN
ymbk	有毛病	zh-CN
ymd	一面倒	zh-CN
ymdc	一面倒	zh-CN
ymdj	烟幕弹	zh-CN
yme	爷们儿	zh-CN
ymer	爷们儿	zh-CN
ymg	玉门关	zh-CN
ymgr	玉门关	zh-CN
ymh	一抹黑	zh-CN
ymhw	一抹黑	zh-CN
ymj	牙买加	zh-CN
ymjm	也没见	zh-CN
yml	压马路	zh-CN
ymlu	压马路	zh-CN
ymm	一幕幕	zh-CN
ymmu	一幕幕	zh-CN
ymq	羽毛球	zh-CN
ymqm	一毛钱	zh-CN
ymqq	羽毛球	zh-CN
ymu	一码事	zh-CN
ymv	一秒钟	zh-CN
ymvs	一秒钟	zh-CN
ymx	亚马逊	zh-CN
ymxy	亚马逊	zh-CN
ymy	有没有	zh-CN
ymyr	圆明园	zh-CN
ymyz	有没有	zh-CN
ymz	夜猫子	zh-CN
ymzi	夜猫子	zh-CN
ynj	一年级	zh-CN
ynji	一年级	zh-CN
ynu	云南省	zh-CN
ynug	云南省	zh-CN
ypl	有魄力	zh-CN
ypli	有魄力	zh-CN
ypp	一片片	zh-CN
yppm	一片片	zh-CN
ypy	硬碰硬	zh-CN
ypyk	硬碰硬	zh-CN
yqd	优缺点	zh-CN
yqdm	优缺点	zh-CN
yqf	右前方	zh-CN
yqfh	右前方	zh-CN
yqh	邀请函	zh-CN
yqhj	邀请函	zh-CN
yqj	元器件	zh-CN
yqjm	元器件	zh-CN
yql	用起来	zh-CN
yqld	用起来	zh-CN
yqn	一千年	zh-CN
yqr	有钱人	zh-CN
yqrf	有钱人	zh-CN
yqu	尤其是	zh-CN
yqui	尤其是	zh-CN
yquo	与其说	zh-CN
yquu	摇钱树	zh-CN
yqv	有气质	zh-CN
yqvi	有气质	zh-CN
yqy	有求于	zh-CN
yrj	愚人节	zh-CN
yrjp	愚人节	zh-CN
ysl	以色列	zh-CN
yslp	以色列	zh-CN
ysq	压岁钱	zh-CN
ysu	也算是	zh-CN
yte	英特尔	zh-CN
ytl	一条路	zh-CN
ytls	一条龙	zh-CN
ytlu	一条路	zh-CN
yttn	一条条	zh-CN
ytwh	因特网	zh-CN
ytzc	一团糟	zh-CN
yuge	一首歌	zh-CN
yuhz	有时候	zh-CN
yuis	应声虫	zh-CN
yuj	右上角	zh-CN
yvb	圆珠笔	zh-CN
yvbi	圆珠笔	zh-CN
yvd	眼中钉	zh-CN
yvdk	眼中钉	zh-CN
yvdm	悠着点	zh-CN
yvf	一阵风	zh-CN
yvfg	一阵风	zh-CN
yvh	一枝花	zh-CN
yvhx	一枝花	zh-CN
yvi	一指禅	zh-CN
yvij	一指禅	zh-CN
yvj	邮政局	zh-CN
yvju	邮政局	zh-CN
yvl	意志力	zh-CN
yvli	意志力	zh-CN
yvlv	圆周率	zh-CN
yvm	验证码	zh-CN
yvma	验证码	zh-CN
yvr	意中人	zh-CN
yvt	一整天	zh-CN
yvtm	一整天	zh-CN
yvu	一只手	zh-CN
yvv	眼睁睁	zh-CN
yvvf	一阵阵	zh-CN
yvx	一致性	zh-CN
yvxk	严重性	zh-CN
yvy	有助于	zh-CN
yvyj	一转眼	zh-CN
yvz	一阵子	zh-CN
yvzi	一阵子	zh-CN
ywb	英文版	zh-CN
ywf	一窝蜂	zh-CN
ywk	依我看	zh-CN
ywkj	依我看	zh-CN
ywm	英文名	zh-CN
ywmk	英文名	zh-CN
ywn	一万年	zh-CN
ywnm	一万年	zh-CN
ywq	圆舞曲	zh-CN
ywqm	冤枉钱	zh-CN
ywt	有问题	zh-CN
ywti	有问题	zh-CN
ywu	一晚上	zh-CN
ywuh	一晚上	zh-CN
ywv	意味着	zh-CN
ywve	意味着	zh-CN
yww	洋娃娃	zh-CN
ywwa	洋娃娃	zh-CN
ywwf	鱼尾纹	zh-CN
ywy	业务员	zh-CN
ywyr	业务员	zh-CN
yxb	也许吧	zh-CN
yxba	也许吧	zh-CN
yxc	鱼腥草	zh-CN
yxco	一小撮	zh-CN
yxd	一想到	zh-CN
yxdc	一想到	zh-CN
yxf	右下方	zh-CN
yxh	有些话	zh-CN
yxj	右下角	zh-CN
yxji	游戏机	zh-CN
yxjn	右下角	zh-CN
yxjp	元宵节	zh-CN
yxl	一系列	zh-CN
yxli	影响力	zh-CN
yxlp	一系列	zh-CN
yxm	音形码	zh-CN
yxma	音形码	zh-CN
yxq	有效期	zh-CN
yxr	有些人	zh-CN
yxs	预选赛	zh-CN
yxsd	预选赛	zh-CN
yxt	一席谈	zh-CN
yxtj	一席谈	zh-CN
yxu	一小时	zh-CN
yxui	一小时	zh-CN
yxv	印象中	zh-CN
yxvs	印象中	zh-CN
yxw	一下午	zh-CN
yxwu	一下午	zh-CN
yxx	有效性	zh-CN
yxxk	有效性	zh-CN
yxy	亚细亚	zh-CN
yxyi	一向以	zh-CN
yxz	一下子	zh-CN
yxzi	一下子	zh-CN
yyci	有一次	zh-CN
yydm	有一点	zh-CN
yyf	一月份	zh-CN
yyg	优越感	zh-CN
yygj	优越感	zh-CN
yyh	音乐会	zh-CN
yyj	有意见	zh-CN
yyjx	预言家	zh-CN
yyqk	一夜情	zh-CN
yyr	有缘人	zh-CN
yyrf	有缘人	zh-CN
yyt	有一天	zh-CN
yytc	有一套	zh-CN
yytm	有一天	zh-CN
yyvs	有一种	zh-CN
yyx	优越性	zh-CN
yzdj	原子弹	zh-CN
yzn	原子能	zh-CN
yzng	原子能	zh-CN
zbd	做不到	zh-CN
zbdc	做不到	zh-CN
zbi	做不出	zh-CN
zbiu	做不出	zh-CN
zbj	资本家	zh-CN
zbjx	资本家	zh-CN
zbl	做不了	zh-CN
zbln	做不了	zh-CN
zbn	总不能	zh-CN
zbng	总不能	zh-CN
zbr	再不然	zh-CN
zbrj	再不然	zh-CN
zbv	坐不住	zh-CN
zbvu	坐不住	zh-CN
zby	赞比亚	zh-CN
zbya	赞比亚	zh-CN
zbz	在不在	zh-CN
zbzd	在不在	zh-CN
zddh	自动挡	zh-CN
zdf	最低分	zh-CN
zdff	最低分	zh-CN
zdh	自动化	zh-CN
zdl	做到了	zh-CN
zdle	做到了	zh-CN
zdy	自定义	zh-CN
zeg	昨儿个	zh-CN
zege	昨儿个	zh-CN
zfj	字符集	zh-CN
zfji	字符集	zh-CN
zge	自个儿	zh-CN
zger	自个儿	zh-CN
zgf	最高峰	zh-CN
zgff	最高分	zh-CN
zgi	走过场	zh-CN
zgih	走过场	zh-CN
zgl	足够了	zh-CN
zgle	足够了	zh-CN
zgt	栽跟头	zh-CN
zgtz	栽跟头	zh-CN
zgz	自顾自	zh-CN
zhd	最好的	zh-CN
zhde	最坏的	zh-CN
zhg	自豪感	zh-CN
zhj	组合键	zh-CN
zhjm	组合键	zh-CN
zhmf	走后门	zh-CN
zhu	咋回事	zh-CN
zhui	最好是	zh-CN
ziq	走出去	zh-CN
zjd	总觉得	zh-CN
zjde	总觉得	zh-CN
zjl	总经理	zh-CN
zjx	总结性	zh-CN
zjyz	自驾游	zh-CN
zld	自留地	zh-CN
zldi	自留地	zh-CN
zli	脏乱差	zh-CN
zlia	脏乱差	zh-CN
zll	紫罗兰	zh-CN
zllj	紫罗兰	zh-CN
zlu	自来水	zh-CN
zluv	自来水	zh-CN
zly	坐落于	zh-CN
zlz	坐落在	zh-CN
zmb	怎么办	zh-CN
zmbj	怎么办	zh-CN
zmd	怎么读	zh-CN
zmdg	走马灯	zh-CN
zmg	怎么搞	zh-CN
zmh	怎么会	zh-CN
zmhv	怎么会	zh-CN
zmj	怎么就	zh-CN
zmjq	怎么就	zh-CN
zmk	怎么看	zh-CN
zmkj	怎么看	zh-CN
zml	怎么了	zh-CN
zmle	怎么了	zh-CN
zmlv	祖母绿	zh-CN
zmn	怎么能	zh-CN
zmng	怎么能	zh-CN
zmu	怎么说	zh-CN
zmuo	怎么说	zh-CN
zmv	怎么着	zh-CN
zmy	怎么样	zh-CN
zmyh	怎么样	zh-CN
zmys	怎么用	zh-CN
znu	怎能说	zh-CN
znuo	怎能说	zh-CN
znx	灾难性	zh-CN
znxk	灾难性	zh-CN
zpz	左撇子	zh-CN
zpzi	左撇子	zh-CN
zqf	左前方	zh-CN
zqfh	左前方	zh-CN
zrg	责任感	zh-CN
zrgj	责任感	zh-CN
zrw	自认为	zh-CN
zrww	自认为	zh-CN
zrx	责任心	zh-CN
zry	最容易	zh-CN
zth	座谈会	zh-CN
zthv	座谈会	zh-CN
ztl	糟蹋了	zh-CN
ztle	糟蹋了	zh-CN
ztu	总体上	zh-CN
ztuh	总体上	zh-CN
zub	座上宾	zh-CN
zubb	座上宾	zh-CN
zuhc	早上好	zh-CN
zuj	左上角	zh-CN
zux	暂时性	zh-CN
zuxk	暂时性	zh-CN
zvd	早知道	zh-CN
zvq	自治区	zh-CN
zvqn	走着瞧	zh-CN
zvqu	自治区	zh-CN
zvu	杂志社	zh-CN
zvue	杂志社	zh-CN
zwl	走弯路	zh-CN
zwlu	走弯路	zh-CN
zwu	走为上	zh-CN
zwuh	走为上	zh-CN
zwv	做文章	zh-CN
zwvh	做文章	zh-CN
zwx	紫外线	zh-CN
zwxm	紫外线	zh-CN
zxh	最喜欢	zh-CN
zxhr	最喜欢	zh-CN
zxi	自行车	zh-CN
zxie	自行车	zh-CN
zxj	左下角	zh-CN
zxjn	左下角	zh-CN
zxq	走下去	zh-CN
zxu	在校生	zh-CN
zxug	在校生	zh-CN
zxx	自信心	zh-CN
zxxb	自信心	zh-CN
zxxi	脏兮兮	zh-CN
zxxy	醉醺醺	zh-CN
zyc	再一次	zh-CN
zyci	再一次	zh-CN
zyd	自由度	zh-CN
zydu	自由度	zh-CN
zyh	自由化	zh-CN
zyhx	自由化	zh-CN
zyq	在一起	zh-CN
zyqi	在一起	zh-CN
zyu	左右手	zh-CN
zyug	吱一声	zh-CN
zyw	自以为	zh-CN
zyys	自由泳	zh-CN
zzfu	曾祖父	zh-CN
zzmu	曾祖母	zh-CN
zzx	自尊心	zh-CN
zzxi	早自习	zh-CN
bdm	帮倒忙	zh-CN
bfv	百分之	zh-CN
bkq	不客气	zh-CN
bmg	闭门羹	zh-CN
bmx	保密性	zh-CN
ddu	大多数	zh-CN
dhj	打火机	zh-CN
djd	打交道	zh-CN
djy	都江堰	zh-CN
duj	电视剧	zh-CN
dyh	单引号	zh-CN
fux	放射性	zh-CN
gjy	关节炎	zh-CN
guz	高山族	zh-CN
gxq	感兴趣	zh-CN
gzu	刽子手	zh-CN
hbug	湖北省	zh-CN
hgx	回归线	zh-CN
hjz	花架子	zh-CN
ifd	出发点	zh-CN
jbn	几百年	zh-CN
jbv	记不住	zh-CN
jij	警察局	zh-CN
jnd	加拿大	zh-CN
jns	吉尼斯	zh-CN
jnya	几内亚	zh-CN
jpv	柬埔寨	zh-CN
jtx	警惕性	zh-CN
jub	记事本	zh-CN
jxx	局限性	zh-CN
lib	里程碑	zh-CN
ljf	龙卷风	zh-CN
ljh	两句话	zh-CN
lnr	老年人	zh-CN
lwg	老顽固	zh-CN
lwt	老顽童	zh-CN
lyy	懒洋洋	zh-CN
qkx	情况下	zh-CN
qpx	起跑线	zh-CN
qrj	情人节	zh-CN
ufl	说服力	zh-CN
uly	势利眼	zh-CN
uud	摄氏度	zh-CN
uvf	省政府	zh-CN
uvy	受制于	zh-CN
uxug	山西省	zh-CN
vfx	正方形	zh-CN
vir	主持人	zh-CN
wuj	卫生间	zh-CN
wwh	无外乎	zh-CN
xbx	行不行	zh-CN
xlx	想了想	zh-CN
xly	叙利亚	zh-CN
xmw	下马威	zh-CN
xmy	小蛮腰	zh-CN
xtx	先天性	zh-CN
xux	学术性	zh-CN
xxy	小心眼	zh-CN
xyj	西游记	zh-CN
xyli	匈牙利	zh-CN
ycx	一次性	zh-CN
yjh	一句话	zh-CN
yjx	郁金香	zh-CN
yux	艺术性	zh-CN