# Gboard Dictionary version:1
# 单字、二简词、小字、偏旁、部件、四字及以上词
a	啊	zh-CN
aae	阿	zh-CN
aaek	阿	zh-CN
aaj	锕	zh-CN
aajk	锕	zh-CN
aak	吖	zh-CN
aakk	啊	zh-CN
aakw	嗄	zh-CN
aaky	吖	zh-CN
aao	腌	zh-CN
aaod	腌	zh-CN
aho	肮	zh-CN
ahoe	昂	zh-CN
ahoj	肮	zh-CN
ahp	卬	zh-CN
ahpe	卬	zh-CN
ahy	盎	zh-CN
ahym	盎	zh-CN
aib	癌	zh-CN
aibe	癌	zh-CN
aibj	皑	zh-CN
aic	艾	zh-CN
aicv	蔼	zh-CN
aicx	艾	zh-CN
aie	隘	zh-CN
aiem	隘	zh-CN
aiey	叆	zh-CN
aif	挨	zh-CN
aij	锿	zh-CN
aijy	锿	zh-CN
aik	唉	zh-CN
aikm	嗌	zh-CN
aikx	哎	zh-CN
aiky	嗳	zh-CN
ain	嫒	zh-CN
ainy	嫒	zh-CN
aio	暧	zh-CN
aioy	暧	zh-CN
aip	爱	zh-CN
aipy	爱	zh-CN
ais	欸	zh-CN
aisr	欸	zh-CN
ait	埃	zh-CN
aitu	埃	zh-CN
aiu	矮	zh-CN
aiuc	碍	zh-CN
aiun	矮	zh-CN
aiuw	毐	zh-CN
aiux	砹	zh-CN
aiw	哀	zh-CN
aiwy	瑷	zh-CN
aiy	霭	zh-CN
aiyv	霭	zh-CN
ana	𩽾	zh-CN
anb	案	zh-CN
anbn	安	zh-CN
and	鹌	zh-CN
andn	鹌	zh-CN
ane	岸	zh-CN
aneg	岸	zh-CN
anf	按	zh-CN
anfn	按	zh-CN
ang	庵	zh-CN
angd	庵	zh-CN
angn	鞍	zh-CN
anh	黯	zh-CN
anho	黯	zh-CN
anj	铵	zh-CN
ank	唵	zh-CN
ankd	唵	zh-CN
anm	桉	zh-CN
anmn	桉	zh-CN
ano	暗	zh-CN
anon	胺	zh-CN
anoo	暗	zh-CN
anq	氨	zh-CN
anqg	犴	zh-CN
anqn	氨	zh-CN
anr	俺	zh-CN
anrd	俺	zh-CN
anrm	盦	zh-CN
ant	埯	zh-CN
antn	垵	zh-CN
any	谙	zh-CN
anyo	谙	zh-CN
aoa	奡	zh-CN
aoal	奡	zh-CN
aob	翱	zh-CN
aobx	翱	zh-CN
aod	澳	zh-CN
aodd	澳	zh-CN
aoe	隩	zh-CN
aoed	隩	zh-CN
aof	熬	zh-CN
aofa	鳌	zh-CN
aofe	聱	zh-CN
aofh	熬	zh-CN
aofi	螯	zh-CN
aofj	鏊	zh-CN
aofl	拗	zh-CN
aofm	骜	zh-CN
aofq	獒	zh-CN
aofw	敖	zh-CN
aog	鏖	zh-CN
aogj	鏖	zh-CN
aogw	廒	zh-CN
aok	嗷	zh-CN
aokw	嗷	zh-CN
aol	凹	zh-CN
aola	凹	zh-CN
aon	媪	zh-CN
aonm	媪	zh-CN
aop	袄	zh-CN
aopd	奥	zh-CN
aopy	袄	zh-CN
aor	傲	zh-CN
aorw	傲	zh-CN
aot	坳	zh-CN
aotl	坳	zh-CN
aow	璈	zh-CN
aoww	璈	zh-CN
aox	懊	zh-CN
aoxd	懊	zh-CN
aoy	岙	zh-CN
aoz	遨	zh-CN
aozw	遨	zh-CN
b	不	zh-CN
baa	鲅	zh-CN
baab	鲃	zh-CN
baad	鲅	zh-CN
bab	爸	zh-CN
babb	疤	zh-CN
bac	芭	zh-CN
bacb	芭	zh-CN
bacd	菝	zh-CN
bad	灞	zh-CN
bado	灞	zh-CN
bae	岜	zh-CN
baeb	岜	zh-CN
baf	拔	zh-CN
bafb	扒	zh-CN
bafd	捌	zh-CN
bag	靶	zh-CN
bagb	靶	zh-CN
bagd	魃	zh-CN
baib	蚆	zh-CN
baj	钯	zh-CN
bajb	钯	zh-CN
bak	吧	zh-CN
bakb	叭	zh-CN
bal	耙	zh-CN
bam	粑	zh-CN
bamb	朳	zh-CN
ban	妭	zh-CN
band	妭	zh-CN
bao	胈	zh-CN
baod	胈	zh-CN
bap	八	zh-CN
bapn	八	zh-CN
bas	罢	zh-CN
basl	巴	zh-CN
bass	罢	zh-CN
bat	坝	zh-CN
batr	坝	zh-CN
bav	巴	zh-CN
bavb	笆	zh-CN
bavv	巴	zh-CN
bay	霸	zh-CN
bayb	羓	zh-CN
bayo	霸	zh-CN
baz	跋	zh-CN
bazd	跋	zh-CN
bba	鬓	zh-CN
bbab	鬓	zh-CN
bbb	宾	zh-CN
bbbb	宾	zh-CN
bbbe	邠	zh-CN
bbd	殡	zh-CN
bbdb	殡	zh-CN
bbdr	濒	zh-CN
bbe	豳	zh-CN
bbeu	豳	zh-CN
bbf	摈	zh-CN
bbfb	摈	zh-CN
bbg	髌	zh-CN
bbgb	髌	zh-CN
bbj	镔	zh-CN
bbm	彬	zh-CN
bbmb	槟	zh-CN
bbmp	彬	zh-CN
bbo	膑	zh-CN
bbob	膑	zh-CN
bbr	傧	zh-CN
bbrb	傧	zh-CN
bbs	缤	zh-CN
bbsb	缤	zh-CN
bbw	斌	zh-CN
bbwd	玢	zh-CN
bbwv	斌	zh-CN
bca	鲍	zh-CN
bcas	鲍	zh-CN
bcb	包	zh-CN
bcbd	刨	zh-CN
bcbs	包	zh-CN
bcby	宝	zh-CN
bcc	薄	zh-CN
bccc	薄	zh-CN
bccm	葆	zh-CN
bccs	苞	zh-CN
bcd	瀑	zh-CN
bce	剥	zh-CN
bcf	抱	zh-CN
bcfs	抱	zh-CN
bch	爆	zh-CN
bchs	炮	zh-CN
bcms	枹	zh-CN
bco	暴	zh-CN
bcos	胞	zh-CN
bcou	曝	zh-CN
bcp	褓	zh-CN
bcr	保	zh-CN
bcrh	煲	zh-CN
bcrm	保	zh-CN
bcrt	堡	zh-CN
bcu	饱	zh-CN
bcus	饱	zh-CN
bcv	豹	zh-CN
bce	剥	zh-CN
bced	剥	zh-CN
bcw	褒	zh-CN
bcwy	褒	zh-CN
bcy	雹	zh-CN
bcys	雹	zh-CN
bcz	趵	zh-CN
bczs	孢	zh-CN
bda	百	zh-CN
bdab	百	zh-CN
bdf	摆	zh-CN
bdfs	摆	zh-CN
bdfu	捭	zh-CN
bdh	稗	zh-CN
bdk	败	zh-CN
bdkr	呗	zh-CN
bdkw	败	zh-CN
bdm	柏	zh-CN
bdmb	柏	zh-CN
bdpo	白	zh-CN
bdr	佰	zh-CN
bdrb	伯	zh-CN
bdu	拜	zh-CN
bduf	拜	zh-CN
bduu	掰	zh-CN
bfa	本	zh-CN
bfaa	本	zh-CN
bfb	坌	zh-CN
bfbt	坌	zh-CN
bfc	苯	zh-CN
bfcb	苯	zh-CN
bfd	奔	zh-CN
bfdc	奔	zh-CN
bfj	锛	zh-CN
bfjc	锛	zh-CN
bfm	栟	zh-CN
bfn	犇	zh-CN
bfrc	倴	zh-CN
bfs	畚	zh-CN
bftd	坋	zh-CN
bfu	贲	zh-CN
bfur	贲	zh-CN
bfv	笨	zh-CN
bgb	甭	zh-CN
bgby	甭	zh-CN
bge	崩	zh-CN
bgeo	崩	zh-CN
bgi	蚌	zh-CN
bgif	蚌	zh-CN
bgj	镚	zh-CN
bgjo	镚	zh-CN
bgk	嘣	zh-CN
bgko	嘣	zh-CN
bgp	祊	zh-CN
bgpf	祊	zh-CN
bgs	绷	zh-CN
bgso	绷	zh-CN
bgu	泵	zh-CN
bguu	泵	zh-CN
bguw	甏	zh-CN
bgw	琫	zh-CN
bgwl	琫	zh-CN
bgz	迸	zh-CN
bgzk	迸	zh-CN
bgzo	蹦	zh-CN
bhc	蒡	zh-CN
bhcf	蒡	zh-CN
bhd	浜	zh-CN
bhdb	浜	zh-CN
bhf	邦	zh-CN
bhfe	邦	zh-CN
bhff	搒	zh-CN
bhfj	帮	zh-CN
bhi	蚌	zh-CN
bhj	镑	zh-CN
bhjf	镑	zh-CN
bhk	𠳐	zh-CN
bhm	棒	zh-CN
bhme	梆	zh-CN
bhmf	榜	zh-CN
bhmk	棓	zh-CN
bho	膀	zh-CN
bhof	膀	zh-CN
bhr	傍	zh-CN
bhs	绑	zh-CN
bhse	绑	zh-CN
bht	塝	zh-CN
bhtf	塝	zh-CN
bhu	磅	zh-CN
bhuf	磅	zh-CN
bhw	玤	zh-CN
bhwf	玤	zh-CN
bhy	谤	zh-CN
bhyf	谤	zh-CN
bia	鲾	zh-CN
biat	鲾	zh-CN
bib	毙	zh-CN
bibb	毖	zh-CN
bibe	邲	zh-CN
bibl	痹	zh-CN
bibt	坒	zh-CN
bibu	毕	zh-CN
bic	蔽	zh-CN
bicb	蓖	zh-CN
bicu	薜	zh-CN
bicw	蔽	zh-CN
bicz	荸	zh-CN
bid	必	zh-CN
bidb	泌	zh-CN
bidc	弊	zh-CN
bidl	濞	zh-CN
bidm	滗	zh-CN
bidw	敝	zh-CN
bie	陛	zh-CN
biet	陛	zh-CN
big	庇	zh-CN
bigg	弼	zh-CN
bigu	髀	zh-CN
bih	秕	zh-CN
bihb	秘	zh-CN
bii	彼	zh-CN
biiy	彼	zh-CN
bij	铋	zh-CN
bik	哔	zh-CN
bikb	吡	zh-CN
bike	鄙	zh-CN
bikr	赑	zh-CN
biku	哔	zh-CN
bim	闭	zh-CN
bin	婢	zh-CN
binb	妣	zh-CN
binu	婢	zh-CN
bip	币	zh-CN
bipj	币	zh-CN
bipu	裨	zh-CN
bipv	匕	zh-CN
biq	狴	zh-CN
biqt	狴	zh-CN
bir	俾	zh-CN
birb	佖	zh-CN
bit	畀	zh-CN
bitl	畀	zh-CN
biu	壁	zh-CN
biun	嬖	zh-CN
biuo	臂	zh-CN
biur	贲	zh-CN
biut	壁	zh-CN
biv	笔	zh-CN
bivb	篦	zh-CN
bivl	箅	zh-CN
bivm	笔	zh-CN
bivu	筚	zh-CN
biw	碧	zh-CN
biwb	珌	zh-CN
biwy	觱	zh-CN
bix	愎	zh-CN
bixy	觱	zh-CN
biy	诐	zh-CN
biz	避	zh-CN
bizl	鼻	zh-CN
bizt	逼	zh-CN
bjb	颁	zh-CN
bjbr	颁	zh-CN
bjbw	癍	zh-CN
bjby	瘢	zh-CN
bjd	半	zh-CN
bjdy	湴	zh-CN
bje	阪	zh-CN
bjf	搬	zh-CN
bjfb	拌	zh-CN
bjfd	扮	zh-CN
bjfy	扳	zh-CN
bjgb	靽	zh-CN
bjjy	钣	zh-CN
bjl	瓣	zh-CN
bjld	办	zh-CN
bjm	板	zh-CN
bjmb	柈	zh-CN
bjoy	昄	zh-CN
bjp	版	zh-CN
bjpy	版	zh-CN
bjr	伴	zh-CN
bjrb	伴	zh-CN
bjs	绊	zh-CN
bjsb	绊	zh-CN
bjt	坂	zh-CN
bjv	般	zh-CN
bjw	班	zh-CN
bjww	斑	zh-CN
bka	丙	zh-CN
bkb	病	zh-CN
bkbb	病	zh-CN
bkbe	邴	zh-CN
bkd	冰	zh-CN
bkf	摒	zh-CN
bkfk	摒	zh-CN
bkh	炳	zh-CN
bkhb	炳	zh-CN
bki	蛃	zh-CN
bkib	蛃	zh-CN
bkm	柄	zh-CN
bko	昺	zh-CN
bkob	昺	zh-CN
bkp	秉	zh-CN
bkpn	秉	zh-CN
bkq	兵	zh-CN
bkqb	兵	zh-CN
bku	饼	zh-CN
bkuk	屏	zh-CN
bkw	禀	zh-CN
bkwx	禀	zh-CN
bma	鳊	zh-CN
bmac	鳊	zh-CN
bmc	苄	zh-CN
bmcb	苄	zh-CN
bmcc	萹	zh-CN
bmd	汴	zh-CN
bmdb	汴	zh-CN
bmdx	卞	zh-CN
bmf	抃	zh-CN
bmfb	抃	zh-CN
bmg	鞭	zh-CN
bmh	扁	zh-CN
bmic	蝙	zh-CN
bmk	贬	zh-CN
bmkc	匾	zh-CN
bmkf	贬	zh-CN
bml	辩	zh-CN
bmlu	辫	zh-CN
bmo	昪	zh-CN
bmoc	昪	zh-CN
bmp	褊	zh-CN
bmr	便	zh-CN
bmrg	便	zh-CN
bms	编	zh-CN
bmsc	弁	zh-CN
bmu	砭	zh-CN
bmuc	碥	zh-CN
bmw	变	zh-CN
bmwy	变	zh-CN
bmx	忭	zh-CN
bmz	遍	zh-CN
bmzl	边	zh-CN
bna	鳔	zh-CN
bnax	鳔	zh-CN
bnb	瘭	zh-CN
bnbx	瘭	zh-CN
bnc	蔈	zh-CN
bnch	藨	zh-CN
bncx	蔈	zh-CN
bndh	瀌	zh-CN
bnfx	摽	zh-CN
bnfy	表	zh-CN
bnh	彪	zh-CN
bnhp	彪	zh-CN
bnhx	熛	zh-CN
bnj	镖	zh-CN
bnjh	镳	zh-CN
bnjs	飑	zh-CN
bnm	标	zh-CN
bnmu	杓	zh-CN
bnmx	骠	zh-CN
bnn	婊	zh-CN
bno	膘	zh-CN
bnox	膘	zh-CN
bnoy	脿	zh-CN
bnp	裱	zh-CN
bnpy	裱	zh-CN
bnq	飙	zh-CN
bnqx	飙	zh-CN
bnr	俵	zh-CN
bnrh	儦	zh-CN
bnry	俵	zh-CN
boa	鲌	zh-CN
boab	鲌	zh-CN
boar	僰	zh-CN
bob	帛	zh-CN
bobj	帛	zh-CN
boc	薄	zh-CN
bocc	薄	zh-CN
boct	蕃	zh-CN
bocy	菠	zh-CN
bod	波	zh-CN
bodb	泊	zh-CN
bodl	渤	zh-CN
body	波	zh-CN
boe	剥	zh-CN
boet	嶓	zh-CN
bof	播	zh-CN
bofc	搏	zh-CN
bofd	拨	zh-CN
boft	播	zh-CN
boh	馞	zh-CN
bohz	馞	zh-CN
boj	铂	zh-CN
bojb	钵	zh-CN
bojc	镈	zh-CN
bojd	钹	zh-CN
bojy	𬭛	zh-CN
bok	啵	zh-CN
boky	啵	zh-CN
bokz	哱	zh-CN
bol	卜	zh-CN
bold	卜	zh-CN
bom	柏	zh-CN
bomb	柏	zh-CN
bomx	驳	zh-CN
bomz	桲	zh-CN
boo	膊	zh-CN
booc	膊	zh-CN
booz	脖	zh-CN
bopd	袯	zh-CN
bor	伯	zh-CN
borb	伯	zh-CN
bou	博	zh-CN
boub	砵	zh-CN
bouc	礴	zh-CN
boul	勃	zh-CN
boum	檗	zh-CN
boun	鹁	zh-CN
bouu	擘	zh-CN
bouz	饽	zh-CN
boe	剥	zh-CN
bov	箔	zh-CN
bovb	舶	zh-CN
bovc	簿	zh-CN
boed	剥	zh-CN
bovy	簸	zh-CN
bow	玻	zh-CN
bowq	亳	zh-CN
bowy	玻	zh-CN
boz	跛	zh-CN
bozk	踣	zh-CN
bozy	跛	zh-CN
bpb	瘪	zh-CN
bpbb	瘪	zh-CN
bpd	憋	zh-CN
bpda	鳖	zh-CN
bpdr	蹩	zh-CN
bpdx	憋	zh-CN
bpk	别	zh-CN
bpkd	别	zh-CN
bua	不	zh-CN
buad	不	zh-CN
buc	蔀	zh-CN
buf	捕	zh-CN
bufn	𬷕	zh-CN
buj	钚	zh-CN
buk	哺	zh-CN
bukb	卟	zh-CN
bul	卜	zh-CN
buo	晡	zh-CN
buof	晡	zh-CN
bup	补	zh-CN
bur	堡	zh-CN
burt	堡	zh-CN
but	埠	zh-CN
butf	埔	zh-CN
buu	布	zh-CN
buv	步	zh-CN
buvc	簿	zh-CN
buvp	步	zh-CN
bux	怖	zh-CN
buxj	怖	zh-CN
buyn	醭	zh-CN
buz	逋	zh-CN
buzf	逋	zh-CN
bwc	蓓	zh-CN
bwck	蓓	zh-CN
bwe	陂	zh-CN
bwey	陂	zh-CN
bwf	悲	zh-CN
bwfi	辈	zh-CN
bwfx	悲	zh-CN
bwgu	庳	zh-CN
bwgy	鞴	zh-CN
bwh	焙	zh-CN
bwhk	焙	zh-CN
bwj	钡	zh-CN
bwjr	钡	zh-CN
bwk	呗	zh-CN
bwkr	贝	zh-CN
bwl	北	zh-CN
bwlb	北	zh-CN
bwlo	背	zh-CN
bwm	杯	zh-CN
bwmb	杯	zh-CN
bwmu	椑	zh-CN
bwmy	糒	zh-CN
bwp	卑	zh-CN
bwpn	鹎	zh-CN
bwpu	卑	zh-CN
bwpy	被	zh-CN
bwq	狈	zh-CN
bwr	倍	zh-CN
bwrk	倍	zh-CN
bwu	碑	zh-CN
bwuj	鐾	zh-CN
bwuk	碚	zh-CN
bwuo	臂	zh-CN
bww	备	zh-CN
bwwt	备	zh-CN
bwwx	惫	zh-CN
bwx	悖	zh-CN
c	才	zh-CN
caf	擦	zh-CN
cafx	擦	zh-CN
cak	嚓	zh-CN
cakx	嚓	zh-CN
cca	曹	zh-CN
ccao	曹	zh-CN
cccu	草	zh-CN
ccd	漕	zh-CN
ccf	操	zh-CN
ccfm	操	zh-CN
cci	螬	zh-CN
ccio	螬	zh-CN
cck	嘈	zh-CN
ccko	嘈	zh-CN
ccm	槽	zh-CN
ccmo	槽	zh-CN
ccmz	糙	zh-CN
ccu	𥕢	zh-CN
ccuo	𥕢	zh-CN
ccv	艚	zh-CN
ccvo	艚	zh-CN
cda	才	zh-CN
cdap	才	zh-CN
cdc	蔡	zh-CN
cdcm	菜	zh-CN
cdcx	蔡	zh-CN
cdk	财	zh-CN
cdkc	财	zh-CN
cdm	材	zh-CN
cdo	睬	zh-CN
cdom	睬	zh-CN
cdp	采	zh-CN
cdpm	采	zh-CN
cdpp	彩	zh-CN
cdq	猜	zh-CN
cdqo	猜	zh-CN
cdu	裁	zh-CN
cduy	裁	zh-CN
cdz	踩	zh-CN
cdzm	踩	zh-CN
ced	测	zh-CN
cedd	测	zh-CN
cei	厕	zh-CN
ceid	厕	zh-CN
cem	栅	zh-CN
cemc	栅	zh-CN
cep	册	zh-CN
cepa	册	zh-CN
cer	侧	zh-CN
cerd	侧	zh-CN
cev	策	zh-CN
cevn	策	zh-CN
cex	恻	zh-CN
cexd	恻	zh-CN
cfd	涔	zh-CN
cfdv	涔	zh-CN
cfe	岑	zh-CN
cfev	岑	zh-CN
cfs	参	zh-CN
cfsp	参	zh-CN
cgb	曾	zh-CN
cgbo	曾	zh-CN
cge	嶒	zh-CN
cgeo	嶒	zh-CN
cgk	噌	zh-CN
cgko	噌	zh-CN
cgu	层	zh-CN
cgus	层	zh-CN
cgz	蹭	zh-CN
cgzo	蹭	zh-CN
chc	苍	zh-CN
chci	藏	zh-CN
chd	沧	zh-CN
chdv	沧	zh-CN
chr	仓	zh-CN
chrn	鸧	zh-CN
chrv	伧	zh-CN
chv	舱	zh-CN
chvv	舱	zh-CN
cia	刺	zh-CN
ciad	刺	zh-CN
cib	慈	zh-CN
cibb	疵	zh-CN
cibn	鹚	zh-CN
cibx	慈	zh-CN
cic	茨	zh-CN
cicb	茈	zh-CN
cicd	莿	zh-CN
cicr	茨	zh-CN
cid	瓷	zh-CN
cidb	泚	zh-CN
cidr	次	zh-CN
cidw	瓷	zh-CN
cik	赐	zh-CN
cikb	呲	zh-CN
cikw	赐	zh-CN
cim	糍	zh-CN
cimy	糍	zh-CN
cip	祠	zh-CN
ciq	辞	zh-CN
cir	伺	zh-CN
cirk	伺	zh-CN
cirr	佽	zh-CN
ciu	磁	zh-CN
ciuy	磁	zh-CN
civ	此	zh-CN
civa	𫚖	zh-CN
civb	此	zh-CN
civf	雌	zh-CN
ciwb	玼	zh-CN
ciy	词	zh-CN
ciyg	差	zh-CN
ciz	跐	zh-CN
cizb	跐	zh-CN
cjd	残	zh-CN
cjf	掺	zh-CN
cjfp	掺	zh-CN
cjh	灿	zh-CN
cjhp	黪	zh-CN
cjl	餐	zh-CN
cjll	餐	zh-CN
cjlm	粲	zh-CN
cjm	骖	zh-CN
cjmp	骖	zh-CN
cjsp	参	zh-CN
cjt	蚕	zh-CN
cjti	蚕	zh-CN
cju	孱	zh-CN
cjuz	孱	zh-CN
cjw	璨	zh-CN
cjwm	璨	zh-CN
cjx	惨	zh-CN
cjxj	惭	zh-CN
cob	痤	zh-CN
cobg	瘥	zh-CN
cobt	痤	zh-CN
coc	莝	zh-CN
coct	莝	zh-CN
coe	嵯	zh-CN
coeg	嵯	zh-CN
cof	搓	zh-CN
cofo	措	zh-CN
coft	挫	zh-CN
cofy	撮	zh-CN
coi	厝	zh-CN
coio	厝	zh-CN
coj	锉	zh-CN
cojo	错	zh-CN
col	鹾	zh-CN
colg	鹾	zh-CN
con	酂	zh-CN
cone	酂	zh-CN
coo	脞	zh-CN
coot	脞	zh-CN
cou	矬	zh-CN
coug	磋	zh-CN
cout	矬	zh-CN
cowg	瑳	zh-CN
coz	蹉	zh-CN
cozg	蹉	zh-CN
crb	窜	zh-CN
crbi	窜	zh-CN
crf	攒	zh-CN
crfi	撺	zh-CN
crfr	攒	zh-CN
crj	镩	zh-CN
crp	爨	zh-CN
crph	爨	zh-CN
crr	汆	zh-CN
crv	篡	zh-CN
crvs	篡	zh-CN
crz	蹿	zh-CN
crzi	蹿	zh-CN
csb	匆	zh-CN
csbd	匆	zh-CN
csc	葱	zh-CN
cscr	苁	zh-CN
cscx	葱	zh-CN
csd	淙	zh-CN
csdx	淙	zh-CN
cse	聪	zh-CN
csex	聪	zh-CN
csh	熜	zh-CN
csm	骢	zh-CN
csmr	枞	zh-CN
csmx	骢	zh-CN
csp	囱	zh-CN
cspw	囱	zh-CN
csr	丛	zh-CN
csra	丛	zh-CN
csrr	从	zh-CN
csw	琮	zh-CN
cswx	璁	zh-CN
csx	悰	zh-CN
csxx	悰	zh-CN
cua	蹙	zh-CN
cuar	蹙	zh-CN
cuc	蔟	zh-CN
cud	殂	zh-CN
cudq	殂	zh-CN
cui	徂	zh-CN
cuiq	徂	zh-CN
cum	粗	zh-CN
cumq	粗	zh-CN
cuq	猝	zh-CN
cuqu	猝	zh-CN
cur	促	zh-CN
curr	促	zh-CN
cuv	簇	zh-CN
cuvu	簇	zh-CN
cuw	卒	zh-CN
cuwr	蹙	zh-CN
cuy	醋	zh-CN
cuyo	醋	zh-CN
cuyv	酢	zh-CN
cuz	蹴	zh-CN
cuzy	蹴	zh-CN
cvb	瘁	zh-CN
cvbu	瘁	zh-CN
cvc	萃	zh-CN
cvd	淬	zh-CN
cvdf	漼	zh-CN
cvdu	淬	zh-CN
cve	崔	zh-CN
cvef	崔	zh-CN
cvf	摧	zh-CN
cvff	摧	zh-CN
cvk	啐	zh-CN
cvku	啐	zh-CN
cvm	粹	zh-CN
cvmu	粹	zh-CN
cvmy	榱	zh-CN
cvo	脆	zh-CN
cvov	脆	zh-CN
cvr	催	zh-CN
cvrf	催	zh-CN
cvs	缞	zh-CN
cvsy	缞	zh-CN
cvw	璀	zh-CN
cvwf	璀	zh-CN
cvwy	衰	zh-CN
cvx	翠	zh-CN
cvxu	悴	zh-CN
cya	寸	zh-CN
cyad	寸	zh-CN
cym	村	zh-CN
cymc	村	zh-CN
cys	皴	zh-CN
cysy	皴	zh-CN
cyt	邨	zh-CN
cyte	邨	zh-CN
cyu	存	zh-CN
cyuz	存	zh-CN
cyx	忖	zh-CN
cyxc	忖	zh-CN
czdt	凑	zh-CN
czi	辏	zh-CN
czit	辏	zh-CN
czo	腠	zh-CN
czot	腠	zh-CN
d	的	zh-CN
dab	瘩	zh-CN
dac	荙	zh-CN
dacz	荙	zh-CN
dad	耷	zh-CN
dade	耷	zh-CN
daf	打	zh-CN
dafd	打	zh-CN
dafk	搭	zh-CN
dag	鞑	zh-CN
daga	靼	zh-CN
dah	炟	zh-CN
dajz	𫟼	zh-CN
dak	哒	zh-CN
dakk	嗒	zh-CN
dan	妲	zh-CN
dap	褡	zh-CN
dat	垯	zh-CN
dau	沓	zh-CN
daun	大	zh-CN
dauo	沓	zh-CN
dav	答	zh-CN
dava	笪	zh-CN
davk	答	zh-CN
dax	怛	zh-CN
daxa	怛	zh-CN
daz	达	zh-CN
dazz	跶	zh-CN
dca	鱽	zh-CN
dcad	到	zh-CN
dcd	盗	zh-CN
dcf	捣	zh-CN
dcfd	捯	zh-CN
dcfe	捣	zh-CN
dcfh	焘	zh-CN
dcfx	纛	zh-CN
dch	稻	zh-CN
dcj	帱	zh-CN
dcjc	帱	zh-CN
dck	叨	zh-CN
dckd	叨	zh-CN
dcp	岛	zh-CN
dcpc	祷	zh-CN
dcpe	岛	zh-CN
dcq	氘	zh-CN
dcr	倒	zh-CN
dcrd	倒	zh-CN
dcs	导	zh-CN
dcsc	导	zh-CN
dcv	刀	zh-CN
dcvd	舠	zh-CN
dcvp	刀	zh-CN
dcx	悼	zh-CN
dcxd	忉	zh-CN
dcz	道	zh-CN
dczj	蹈	zh-CN
dda	歹	zh-CN
ddax	歹	zh-CN
ddd	殆	zh-CN
dde	叇	zh-CN
ddez	叇	zh-CN
ddf	带	zh-CN
ddi	待	zh-CN
ddic	待	zh-CN
ddid	轪	zh-CN
ddk	呆	zh-CN
ddkm	呆	zh-CN
ddkt	呔	zh-CN
ddr	贷	zh-CN
ddre	岱	zh-CN
ddrh	黛	zh-CN
ddrr	贷	zh-CN
ddrt	垈	zh-CN
ddru	傣	zh-CN
ddry	袋	zh-CN
dds	怠	zh-CN
ddsk	绐	zh-CN
ddsx	怠	zh-CN
ddtn	埭	zh-CN
ddu	戴	zh-CN
ddub	戴	zh-CN
ddun	大	zh-CN
ddw	玳	zh-CN
ddwy	玳	zh-CN
ddz	逮	zh-CN
ddzk	迨	zh-CN
ddzn	逮	zh-CN
debu	的	zh-CN
dei	德	zh-CN
deic	得	zh-CN
deix	德	zh-CN
dej	锝	zh-CN
dejc	锝	zh-CN
dek	嘚	zh-CN
dekc	嘚	zh-CN
det	地	zh-CN
dety	地	zh-CN
dff	扽	zh-CN
dfft	扽	zh-CN
dgd	澄	zh-CN
dgda	澄	zh-CN
dge	嶝	zh-CN
dgea	嶝	zh-CN
dgh	灯	zh-CN
dghd	灯	zh-CN
dgja	镫	zh-CN
dgk	噔	zh-CN
dgka	噔	zh-CN
dgo	瞪	zh-CN
dgoa	瞪	zh-CN
dgog	戥	zh-CN
dgu	磴	zh-CN
dgua	磴	zh-CN
dgv	登	zh-CN
dgva	登	zh-CN
dgvj	凳	zh-CN
dgw	璒	zh-CN
dgwa	璒	zh-CN
dgy	邓	zh-CN
dgye	邓	zh-CN
dgz	蹬	zh-CN
dgza	蹬	zh-CN
dhb	宕	zh-CN
dhbu	宕	zh-CN
dhc	荡	zh-CN
dhcp	荡	zh-CN
dhcu	菪	zh-CN
dhdy	𬍡	zh-CN
dhf	挡	zh-CN
dhfe	挡	zh-CN
dhj	铛	zh-CN
dhje	铛	zh-CN
dhm	档	zh-CN
dhme	𣗋	zh-CN
dhp	裆	zh-CN
dhpe	裆	zh-CN
dht	垱	zh-CN
dhte	垱	zh-CN
dhu	凼	zh-CN
dhuk	凼	zh-CN
dhup	砀	zh-CN
dhw	珰	zh-CN
dhwe	珰	zh-CN
dhx	党	zh-CN
dhxe	当	zh-CN
dhy	谠	zh-CN
dia	髢	zh-CN
diay	髢	zh-CN
dib	弟	zh-CN
dibp	弟	zh-CN
dic	蒂	zh-CN
dich	荻	zh-CN
dicj	蒂	zh-CN
dicu	菂	zh-CN
did	涤	zh-CN
dide	邸	zh-CN
didk	滴	zh-CN
dif	抵	zh-CN
difd	抵	zh-CN
difr	提	zh-CN
dig	底	zh-CN
digd	骶	zh-CN
digr	鞮	zh-CN
dii	䗖	zh-CN
dij	镝	zh-CN
dijk	镝	zh-CN
dik	嘀	zh-CN
dikk	嘀	zh-CN
dim	棣	zh-CN
dimd	柢	zh-CN
dimn	棣	zh-CN
din	嫡	zh-CN
dinj	媂	zh-CN
dink	嫡	zh-CN
dinp	娣	zh-CN
dio	睇	zh-CN
diop	睇	zh-CN
diq	敌	zh-CN
diqh	狄	zh-CN
diqw	敌	zh-CN
dir	低	zh-CN
dird	低	zh-CN
dirm	籴	zh-CN
dis	缔	zh-CN
dit	堤	zh-CN
ditd	坻	zh-CN
ditr	堤	zh-CN
dity	地	zh-CN
diu	氐	zh-CN
diud	砥	zh-CN
diue	觌	zh-CN
diuj	碲	zh-CN
diul	䃅	zh-CN
div	第	zh-CN
divp	第	zh-CN
divy	笛	zh-CN
diw	帝	zh-CN
diwj	𤧛	zh-CN
dixf	翟	zh-CN
diy	谛	zh-CN
diyd	诋	zh-CN
diz	递	zh-CN
dizk	蹢	zh-CN
dizp	递	zh-CN
dizr	踶	zh-CN
dizy	迪	zh-CN
dja	石	zh-CN
djak	石	zh-CN
djb	单	zh-CN
djba	疸	zh-CN
djbe	郸	zh-CN
djbl	瘅	zh-CN
djc	萏	zh-CN
djcj	萏	zh-CN
djd	淡	zh-CN
djdl	殚	zh-CN
dje	耽	zh-CN
djer	聃	zh-CN
djev	耽	zh-CN
djf	担	zh-CN
djfa	担	zh-CN
djfl	掸	zh-CN
djg	弹	zh-CN
djk	啖	zh-CN
djkh	赕	zh-CN
djo	胆	zh-CN
djoa	旦	zh-CN
djov	眈	zh-CN
djp	丹	zh-CN
djpa	丹	zh-CN
djq	氮	zh-CN
djqh	氮	zh-CN
djr	儋	zh-CN
djra	但	zh-CN
djrk	儋	zh-CN
djrl	𫢸	zh-CN
djs	𬘘	zh-CN
djsv	𬘘	zh-CN
djv	蛋	zh-CN
djva	疍	zh-CN
djwa	亶	zh-CN
djx	惮	zh-CN
djxk	憺	zh-CN
djy	诞	zh-CN
dka	丁	zh-CN
dkal	丁	zh-CN
dkb	疔	zh-CN
dkbd	疔	zh-CN
dkbr	定	zh-CN
dkcr	萣	zh-CN
dkd	顶	zh-CN
dke	耵	zh-CN
dked	耵	zh-CN
dkj	钉	zh-CN
dkjd	钉	zh-CN
dkjr	锭	zh-CN
dkjz	铤	zh-CN
dkk	叮	zh-CN
dkkd	叮	zh-CN
dkkr	啶	zh-CN
dko	盯	zh-CN
dkod	盯	zh-CN
dkor	腚	zh-CN
dkov	鼎	zh-CN
dkr	仃	zh-CN
dkrd	仃	zh-CN
dkt	町	zh-CN
dktd	町	zh-CN
dku	碇	zh-CN
dkur	碇	zh-CN
dkw	玎	zh-CN
dkwd	玎	zh-CN
dky	订	zh-CN
dkyd	酊	zh-CN
dmb	癫	zh-CN
dmbd	奠	zh-CN
dmbr	癫	zh-CN
dmbt	甸	zh-CN
dmby	癜	zh-CN
dmd	滇	zh-CN
dmdb	滇	zh-CN
dmdr	淀	zh-CN
dme	巅	zh-CN
dmek	阽	zh-CN
dmer	巅	zh-CN
dmf	垫	zh-CN
dmfk	掂	zh-CN
dmfr	靛	zh-CN
dmft	垫	zh-CN
dmg	店	zh-CN
dmgk	店	zh-CN
dmh	扂	zh-CN
dmhk	扂	zh-CN
dmj	钿	zh-CN
dmjt	钿	zh-CN
dml	电	zh-CN
dmlb	典	zh-CN
dmlh	点	zh-CN
dmlv	电	zh-CN
dmr	佃	zh-CN
dmrt	佃	zh-CN
dmtk	坫	zh-CN
dmu	殿	zh-CN
dmub	碘	zh-CN
dmur	颠	zh-CN
dmw	玷	zh-CN
dmwk	玷	zh-CN
dmwr	琔	zh-CN
dmx	惦	zh-CN
dmz	踮	zh-CN
dmzk	踮	zh-CN
dna	鲷	zh-CN
dnak	鲷	zh-CN
dnb	窎	zh-CN
dnbn	窎	zh-CN
dnd	凋	zh-CN
dnf	掉	zh-CN
dnfu	掉	zh-CN
dnj	钓	zh-CN
dnjd	铫	zh-CN
dnjj	铞	zh-CN
dnk	吊	zh-CN
dnkd	叼	zh-CN
dnkf	雕	zh-CN
dnkj	吊	zh-CN
dnp	鸟	zh-CN
dnpa	鸟	zh-CN
dnuk	碉	zh-CN
dnv	刁	zh-CN
dnvk	貂	zh-CN
dnw	鸟	zh-CN
dnwd	鸟	zh-CN
dnyk	调	zh-CN
dod	夺	zh-CN
doe	堕	zh-CN
doet	堕	zh-CN
dof	掇	zh-CN
dofy	掇	zh-CN
dog	度	zh-CN
dogy	度	zh-CN
doj	朵	zh-CN
dojd	剁	zh-CN
dojl	铎	zh-CN
dok	咄	zh-CN
doki	咄	zh-CN
dokm	哚	zh-CN
dokx	哆	zh-CN
dom	驮	zh-CN
domb	柁	zh-CN
domd	杕	zh-CN
dop	裰	zh-CN
dopy	裰	zh-CN
dot	垛	zh-CN
doti	埵	zh-CN
doty	㙍	zh-CN
dou	躲	zh-CN
doum	躲	zh-CN
dov	舵	zh-CN
dovb	舵	zh-CN
dowl	亸	zh-CN
dox	惰	zh-CN
doxo	惰	zh-CN
doyd	剟	zh-CN
doz	跺	zh-CN
dozm	跺	zh-CN
dozy	踱	zh-CN
dpa	鲽	zh-CN
dpam	鲽	zh-CN
dpb	爹	zh-CN
dpbx	爹	zh-CN
dpej	𫶇	zh-CN
dpg	瓞	zh-CN
dpgu	瓞	zh-CN
dpi	蝶	zh-CN
dpim	蝶	zh-CN
dpk	喋	zh-CN
dpkm	喋	zh-CN
dpl	耋	zh-CN
dplt	耋	zh-CN
dpmm	楪	zh-CN
dpo	昳	zh-CN
dpop	䏲	zh-CN
dpou	昳	zh-CN
dpp	牒	zh-CN
dps	绖	zh-CN
dpst	绖	zh-CN
dpt	垤	zh-CN
dptm	堞	zh-CN
dptt	垤	zh-CN
dpu	碟	zh-CN
dpum	碟	zh-CN
dpy	叠	zh-CN
dpym	谍	zh-CN
dpyq	叠	zh-CN
dpz	迭	zh-CN
dpzm	蹀	zh-CN
dpzu	跌	zh-CN
dqj	铥	zh-CN
dqjs	铥	zh-CN
dqp	丢	zh-CN
dqps	丢	zh-CN
dre	耑	zh-CN
dree	耑	zh-CN
drh	煅	zh-CN
drj	锻	zh-CN
drjy	锻	zh-CN
drl	端	zh-CN
drm	断	zh-CN
drmy	椴	zh-CN
drpy	段	zh-CN
drs	缎	zh-CN
drsy	缎	zh-CN
drt	塅	zh-CN
drty	塅	zh-CN
dru	短	zh-CN
drua	短	zh-CN
drv	簖	zh-CN
drvj	簖	zh-CN
drwy	瑖	zh-CN
dsa	东	zh-CN
dsad	东	zh-CN
dsc	董	zh-CN
dscv	董	zh-CN
dsd	洞	zh-CN
dsdd	冻	zh-CN
dsdk	洞	zh-CN
dsdn	鸫	zh-CN
dse	岽	zh-CN
dsed	岽	zh-CN
dsek	峒	zh-CN
dsel	动	zh-CN
dsi	𬟽	zh-CN
dsid	𬟽	zh-CN
dsk	咚	zh-CN
dsm	栋	zh-CN
dso	胴	zh-CN
dsod	胨	zh-CN
dsok	胴	zh-CN
dsq	氡	zh-CN
dsqd	氡	zh-CN
dsr	侗	zh-CN
dsrk	侗	zh-CN
dst	垌	zh-CN
dsu	硐	zh-CN
dsuk	硐	zh-CN
dsw	冬	zh-CN
dswd	冬	zh-CN
dsx	懂	zh-CN
dsxk	恫	zh-CN
dsxv	懂	zh-CN
dua	蠹	zh-CN
duct	芏	zh-CN
dud	渡	zh-CN
dudd	渎	zh-CN
dudy	渡	zh-CN
duf	毒	zh-CN
dufm	毒	zh-CN
dug	度	zh-CN
dugi	髑	zh-CN
duh	黩	zh-CN
duj	镀	zh-CN
dujy	镀	zh-CN
duk	赌	zh-CN
duke	嘟	zh-CN
duko	赌	zh-CN
dul	都	zh-CN
dum	杜	zh-CN
dumd	椟	zh-CN
dumt	杜	zh-CN
dun	妒	zh-CN
dund	犊	zh-CN
duo	肚	zh-CN
duoo	睹	zh-CN
duot	肚	zh-CN
dup	牍	zh-CN
dupd	牍	zh-CN
duq	独	zh-CN
dut	堵	zh-CN
duto	堵	zh-CN
duu	督	zh-CN
duuo	督	zh-CN
duv	笃	zh-CN
duvm	笃	zh-CN
duvs	厾	zh-CN
duy	读	zh-CN
dvb	兑	zh-CN
dvbe	兑	zh-CN
dve	队	zh-CN
dver	队	zh-CN
dvj	镦	zh-CN
dvjw	镦	zh-CN
dvjz	𬭚	zh-CN
dvp	祋	zh-CN
dvpy	祋	zh-CN
dvt	堆	zh-CN
dvtf	堆	zh-CN
dvu	碓	zh-CN
dvuf	碓	zh-CN
dvw	敦	zh-CN
dvy	怼	zh-CN
dvyc	对	zh-CN
dwi	得	zh-CN
dwic	得	zh-CN
dxk	嗲	zh-CN
dxkx	嗲	zh-CN
dyd	沌	zh-CN
dydt	沌	zh-CN
dyh	炖	zh-CN
dyht	炖	zh-CN
dyj	钝	zh-CN
dyk	吨	zh-CN
dykt	囤	zh-CN
dymo	楯	zh-CN
dyo	盹	zh-CN
dyot	盹	zh-CN
dyp	盾	zh-CN
dypo	盾	zh-CN
dyt	墩	zh-CN
dytr	顿	zh-CN
dytw	墩	zh-CN
dyut	砘	zh-CN
dyuw	礅	zh-CN
dyw	敦	zh-CN
dywr	趸	zh-CN
dyxz	惇	zh-CN
dyz	蹲	zh-CN
dyzc	蹲	zh-CN
dyzo	遁	zh-CN
dza	豆	zh-CN
dzaa	豆	zh-CN
dzb	痘	zh-CN
dzba	痘	zh-CN
dzbd	窦	zh-CN
dzbe	兜	zh-CN
dzc	蔸	zh-CN
dzce	蔸	zh-CN
dzd	斗	zh-CN
dze	陡	zh-CN
dzer	陡	zh-CN
dzf	抖	zh-CN
dzi	蚪	zh-CN
dziu	蚪	zh-CN
dzj	钭	zh-CN
dzju	钭	zh-CN
dzp	兜	zh-CN
dzpe	兜	zh-CN
dzv	篼	zh-CN
dzve	篼	zh-CN
dzyd	读	zh-CN
dzz	逗	zh-CN
dzza	逗	zh-CN
e	二	zh-CN
eea	鳄	zh-CN
eeak	鳄	zh-CN
eeb	额	zh-CN
eebr	额	zh-CN
eec	萼	zh-CN
eeck	萼	zh-CN
eecv	苊	zh-CN
eecw	莪	zh-CN
eedw	涐	zh-CN
eee	峨	zh-CN
eeek	阿	zh-CN
eeew	峨	zh-CN
eef	扼	zh-CN
eefv	扼	zh-CN
eei	厄	zh-CN
eeiv	轭	zh-CN
eeiw	蛾	zh-CN
eej	锷	zh-CN
eejk	锷	zh-CN
eejw	锇	zh-CN
eek	呃	zh-CN
eeke	鄂	zh-CN
eekn	鹗	zh-CN
eekr	颚	zh-CN
eekv	呃	zh-CN
eekw	哦	zh-CN
eekx	𫫇	zh-CN
eem	阏	zh-CN
eemd	阏	zh-CN
een	娥	zh-CN
eenk	婀	zh-CN
eenw	娥	zh-CN
eeo	腭	zh-CN
eeok	腭	zh-CN
eer	俄	zh-CN
eerw	俄	zh-CN
eetv	堨	zh-CN
eeu	饿	zh-CN
eeuk	屙	zh-CN
eeuw	饿	zh-CN
eew	鹅	zh-CN
eewk	噩	zh-CN
eewn	鹅	zh-CN
eex	愕	zh-CN
eey	恶	zh-CN
eeyb	讹	zh-CN
eeyk	谔	zh-CN
eeyt	垩	zh-CN
eeyx	恶	zh-CN
eez	遏	zh-CN
eezv	遏	zh-CN
eis	欸	zh-CN
eisr	欸	zh-CN
enc	蒽	zh-CN
encx	蒽	zh-CN
enf	摁	zh-CN
enfx	摁	zh-CN
enk	嗯	zh-CN
enkx	恩	zh-CN
era	耳	zh-CN
eraa	二	zh-CN
erae	鲕	zh-CN
eral	而	zh-CN
erd	尔	zh-CN
erde	洱	zh-CN
erdx	尔	zh-CN
ere	鸸	zh-CN
eree	陑	zh-CN
eren	鸸	zh-CN
erep	耏	zh-CN
erj	铒	zh-CN
erje	铒	zh-CN
erk	咡	zh-CN
erp	儿	zh-CN
erpv	儿	zh-CN
err	佴	zh-CN
erre	佴	zh-CN
eru	饵	zh-CN
erue	饵	zh-CN
erw	珥	zh-CN
erwe	珥	zh-CN
ery	贰	zh-CN
erz	迩	zh-CN
erzx	迩	zh-CN
f	非	zh-CN
fam	阀	zh-CN
fap	乏	zh-CN
fapv	乏	zh-CN
far	伐	zh-CN
farg	伐	zh-CN
fart	垡	zh-CN
fas	罚	zh-CN
fasd	罚	zh-CN
fau	砝	zh-CN
faus	砝	zh-CN
fav	发	zh-CN
favd	发	zh-CN
favg	筏	zh-CN
faw	珐	zh-CN
faws	珐	zh-CN
ffa	鲼	zh-CN
ffar	鲼	zh-CN
ffb	忿	zh-CN
ffbx	忿	zh-CN
ffc	芬	zh-CN
ffcd	芬	zh-CN
ffcm	棻	zh-CN
ffd	奋	zh-CN
ffdb	瀵	zh-CN
ffdt	奋	zh-CN
ffjd	鼢	zh-CN
ffk	吩	zh-CN
ffm	粉	zh-CN
ffmb	粪	zh-CN
ffmd	棼	zh-CN
ffmh	焚	zh-CN
ffq	氛	zh-CN
ffqd	氛	zh-CN
ffr	份	zh-CN
ffrd	份	zh-CN
ffs	纷	zh-CN
fft	坟	zh-CN
fftd	坋	zh-CN
fftw	坟	zh-CN
ffur	豮	zh-CN
ffw	玢	zh-CN
ffx	愤	zh-CN
ffxd	翂	zh-CN
ffxr	愤	zh-CN
ffy	酚	zh-CN
ffyd	酚	zh-CN
fga	丰	zh-CN
fgal	丰	zh-CN
fgb	疯	zh-CN
fgbx	疯	zh-CN
fgc	葑	zh-CN
fgcc	葑	zh-CN
fgd	冯	zh-CN
fgdf	沣	zh-CN
fgdx	沨	zh-CN
fge	峰	zh-CN
fgec	崶	zh-CN
fgee	酆	zh-CN
fgef	峰	zh-CN
fgf	奉	zh-CN
fgfe	酆	zh-CN
fgh	烽	zh-CN
fghf	烽	zh-CN
fgi	蜂	zh-CN
fgj	锋	zh-CN
fgjf	锋	zh-CN
fgjx	风	zh-CN
fgjy	凤	zh-CN
fgk	唪	zh-CN
fgko	赗	zh-CN
fgm	枫	zh-CN
fgmx	枫	zh-CN
fgr	俸	zh-CN
fgrl	俸	zh-CN
fgs	缝	zh-CN
fgsz	缝	zh-CN
fgt	封	zh-CN
fgtc	封	zh-CN
fgtt	堼	zh-CN
fgu	砜	zh-CN
fgux	砜	zh-CN
fgy	讽	zh-CN
fgyx	讽	zh-CN
fgz	逢	zh-CN
fgzf	逢	zh-CN
fha	鲂	zh-CN
fhaf	鲂	zh-CN
fhc	芳	zh-CN
fhcf	芳	zh-CN
fhd	方	zh-CN
fhdw	方	zh-CN
fhe	防	zh-CN
fhef	防	zh-CN
fhf	邡	zh-CN
fhfe	邡	zh-CN
fhh	房	zh-CN
fhhf	房	zh-CN
fhi	彷	zh-CN
fhj	钫	zh-CN
fhjf	钫	zh-CN
fhm	枋	zh-CN
fhn	妨	zh-CN
fhnf	牥	zh-CN
fho	肪	zh-CN
fhof	昉	zh-CN
fhr	仿	zh-CN
fhs	纺	zh-CN
fhsf	纺	zh-CN
fht	坊	zh-CN
fhtf	坊	zh-CN
fhv	舫	zh-CN
fhy	访	zh-CN
fjc	范	zh-CN
fjct	藩	zh-CN
fjcv	范	zh-CN
fjcx	蘩	zh-CN
fjd	泛	zh-CN
fjdf	泛	zh-CN
fjh	烦	zh-CN
fjht	燔	zh-CN
fjj	凡	zh-CN
fjjf	帆	zh-CN
fjjt	幡	zh-CN
fjk	贩	zh-CN
fjm	樊	zh-CN
fjp	翻	zh-CN
fjpt	番	zh-CN
fjpx	繁	zh-CN
fjpy	反	zh-CN
fjq	犯	zh-CN
fjqv	犯	zh-CN
fjt	畈	zh-CN
fjtt	墦	zh-CN
fjty	畈	zh-CN
fju	饭	zh-CN
fjuy	饭	zh-CN
fjw	璠	zh-CN
fjwt	璠	zh-CN
fjz	返	zh-CN
fjzt	蹯	zh-CN
fjzy	返	zh-CN
for	佛	zh-CN
forf	佛	zh-CN
fua	夫	zh-CN
fuac	鲋	zh-CN
fuad	甫	zh-CN
fub	富	zh-CN
fuba	釜	zh-CN
fubb	宓	zh-CN
fubj	斧	zh-CN
fubt	匐	zh-CN
fubx	父	zh-CN
fuc	芙	zh-CN
fucb	芣	zh-CN
fucc	苻	zh-CN
fucf	茀	zh-CN
fucl	芾	zh-CN
fucq	茯	zh-CN
fucy	菔	zh-CN
fucz	莩	zh-CN
fud	负	zh-CN
fuda	滏	zh-CN
fudk	涪	zh-CN
fudq	洑	zh-CN
fudr	负	zh-CN
fudx	㳇	zh-CN
fudz	浮	zh-CN
fue	附	zh-CN
fuec	附	zh-CN
fuer	𫖯	zh-CN
fuf	扶	zh-CN
fufb	艴	zh-CN
fufc	拊	zh-CN
fuff	拂	zh-CN
fug	府	zh-CN
fuge	鄜	zh-CN
fugr	腐	zh-CN
fuh	馥	zh-CN
fuhz	稃	zh-CN
fui	辅	zh-CN
fuif	蚨	zh-CN
fuit	辐	zh-CN
fuiw	蝮	zh-CN
fuj	幅	zh-CN
fujn	幞	zh-CN
fujt	幅	zh-CN
fuk	赋	zh-CN
fukc	咐	zh-CN
fukf	呋	zh-CN
fukw	呒	zh-CN
ful	孵	zh-CN
fulz	孵	zh-CN
fum	驸	zh-CN
fumc	榑	zh-CN
fumz	桴	zh-CN
fun	妇	zh-CN
fune	妇	zh-CN
fuo	服	zh-CN
fuoc	腑	zh-CN
fuof	肤	zh-CN
fuow	腹	zh-CN
fuoy	服	zh-CN
fup	福	zh-CN
fupe	郛	zh-CN
fupq	袱	zh-CN
fupt	福	zh-CN
fupu	阜	zh-CN
fupw	复	zh-CN
fupz	孚	zh-CN
fuq	氟	zh-CN
fuqf	氟	zh-CN
fur	付	zh-CN
furc	傅	zh-CN
furq	伏	zh-CN
furz	俘	zh-CN
fus	缚	zh-CN
fusb	罘	zh-CN
fusc	缚	zh-CN
fusd	绂	zh-CN
fusf	绋	zh-CN
fut	赴	zh-CN
futb	赴	zh-CN
fuu	砆	zh-CN
fuv	符	zh-CN
fuvc	符	zh-CN
fuvm	簠	zh-CN
fuwd	韨	zh-CN
fuwf	玞	zh-CN
fuwz	琈	zh-CN
fux	覆	zh-CN
fuxf	怫	zh-CN
fuxw	覆	zh-CN
fuy	讣	zh-CN
fuyd	黻	zh-CN
fuyf	黼	zh-CN
fuz	跗	zh-CN
fuzf	趺	zh-CN
fwa	鲱	zh-CN
fwaf	鲱	zh-CN
fwb	痱	zh-CN
fwc	菲	zh-CN
fwcf	菲	zh-CN
fwcl	芾	zh-CN
fwd	沸	zh-CN
fwdb	淝	zh-CN
fwdf	沸	zh-CN
fwf	斐	zh-CN
fwfd	剕	zh-CN
fwfi	蜚	zh-CN
fwfm	棐	zh-CN
fwfr	费	zh-CN
fwfx	翡	zh-CN
fwg	废	zh-CN
fwh	扉	zh-CN
fwhf	扉	zh-CN
fwj	镄	zh-CN
fwjr	镄	zh-CN
fwk	匪	zh-CN
fwkf	啡	zh-CN
fwkq	吠	zh-CN
fwla	非	zh-CN
fwm	榧	zh-CN
fwmf	𬴂	zh-CN
fwn	妃	zh-CN
fwo	肥	zh-CN
fwob	肥	zh-CN
fwof	腓	zh-CN
fwoi	朏	zh-CN
fwol	肺	zh-CN
fwq	狒	zh-CN
fwqf	狒	zh-CN
fws	绯	zh-CN
fwsf	绯	zh-CN
fwv	飞	zh-CN
fwvd	飞	zh-CN
fwvf	篚	zh-CN
fwxf	悱	zh-CN
fwy	诽	zh-CN
fwyf	霏	zh-CN
fzb	否	zh-CN
fzbk	否	zh-CN
fzw	缶	zh-CN
fzwk	缶	zh-CN
g	个	zh-CN
gaa	夹	zh-CN
gaag	戛	zh-CN
gaan	夹	zh-CN
gai	轧	zh-CN
gaiv	轧	zh-CN
gajo	旮	zh-CN
gajv	钆	zh-CN
gak	噶	zh-CN
gakg	嘎	zh-CN
gakk	咖	zh-CN
gakv	噶	zh-CN
gan	尕	zh-CN
ganx	尕	zh-CN
gao	胳	zh-CN
gaok	胳	zh-CN
gar	伽	zh-CN
gark	伽	zh-CN
gau	尬	zh-CN
gaul	尬	zh-CN
gax	尜	zh-CN
gaxx	尜	zh-CN
gay	尬	zh-CN
gayl	尬	zh-CN
gcb	皋	zh-CN
gcbu	皋	zh-CN
gcc	藁	zh-CN
gccm	藁	zh-CN
gcf	搞	zh-CN
gcfk	搞	zh-CN
gch	稿	zh-CN
gcj	镐	zh-CN
gcjk	锆	zh-CN
gcm	糕	zh-CN
gcmh	糕	zh-CN
gcmu	槔	zh-CN
gcn	告	zh-CN
gcne	郜	zh-CN
gcnk	告	zh-CN
gco	杲	zh-CN
gcom	杲	zh-CN
gcp	睾	zh-CN
gcpg	睾	zh-CN
gcsk	缟	zh-CN
gcv	篙	zh-CN
gcvk	筶	zh-CN
gcw	膏	zh-CN
gcwk	高	zh-CN
gcwo	膏	zh-CN
gcy	羔	zh-CN
gcyk	诰	zh-CN
gda	丐	zh-CN
gdav	丐	zh-CN
gdc	荄	zh-CN
gdcr	荄	zh-CN
gdd	溉	zh-CN
gddv	溉	zh-CN
gde	陔	zh-CN
gdej	𬮿	zh-CN
gder	陔	zh-CN
gdj	改	zh-CN
gdjg	钙	zh-CN
gdjw	改	zh-CN
gdk	赅	zh-CN
gdkr	赅	zh-CN
gdm	概	zh-CN
gdmv	概	zh-CN
gdn	戤	zh-CN
gdng	戤	zh-CN
gdo	晐	zh-CN
gdor	晐	zh-CN
gdt	垓	zh-CN
gdtr	垓	zh-CN
gdy	盖	zh-CN
gdyr	该	zh-CN
gea	歌	zh-CN
gead	戈	zh-CN
geal	鬲	zh-CN
geb	割	zh-CN
gebd	割	zh-CN
gebq	疙	zh-CN
gec	葛	zh-CN
gecv	葛	zh-CN
ged	歌	zh-CN
gedk	哥	zh-CN
gedl	滆	zh-CN
gee	隔	zh-CN
geel	隔	zh-CN
gef	搁	zh-CN
gefk	搁	zh-CN
geg	骼	zh-CN
gegk	骼	zh-CN
gei	蛤	zh-CN
geik	蛤	zh-CN
geiq	虼	zh-CN
gej	铬	zh-CN
gejk	铬	zh-CN
gejl	镉	zh-CN
gek	嗝	zh-CN
gekk	咯	zh-CN
gekl	嗝	zh-CN
gel	哿	zh-CN
gelk	哿	zh-CN
gem	格	zh-CN
gen	革	zh-CN
genl	革	zh-CN
geo	胳	zh-CN
geok	胳	zh-CN
geol	膈	zh-CN
gep	袼	zh-CN
gepk	袼	zh-CN
ger	鸽	zh-CN
gerk	合	zh-CN
gerl	个	zh-CN
gern	鸽	zh-CN
gerq	仡	zh-CN
gerr	颌	zh-CN
ges	纥	zh-CN
gesq	纥	zh-CN
get	圪	zh-CN
getl	塥	zh-CN
getq	圪	zh-CN
geu	硌	zh-CN
geuk	饹	zh-CN
gev	舸	zh-CN
gevk	舸	zh-CN
gewk	各	zh-CN
gey	盖	zh-CN
geym	盖	zh-CN
gfa	亘	zh-CN
gfaa	亘	zh-CN
gfc	茛	zh-CN
gfcg	茛	zh-CN
gfe	艮	zh-CN
gfen	艮	zh-CN
gfk	哏	zh-CN
gfkg	哏	zh-CN
gfm	根	zh-CN
gfmg	根	zh-CN
gfv	艮	zh-CN
gfvn	艮	zh-CN
gfzg	跟	zh-CN
gga	鲠	zh-CN
ggag	鲠	zh-CN
ggan	更	zh-CN
ggd	浭	zh-CN
ggdg	浭	zh-CN
gge	耿	zh-CN
ggeh	耿	zh-CN
ggg	庚	zh-CN
gggn	鹒	zh-CN
gggr	赓	zh-CN
ggk	哽	zh-CN
ggkg	哽	zh-CN
ggl	耕	zh-CN
gglj	耕	zh-CN
ggm	梗	zh-CN
ggmg	梗	zh-CN
ggs	绠	zh-CN
ggsg	绠	zh-CN
ggt	埂	zh-CN
ggtg	埂	zh-CN
ggu	𬒔	zh-CN
gguo	𬒔	zh-CN
ggv	颈	zh-CN
ggvr	颈	zh-CN
ggy	羹	zh-CN
ggyd	羹	zh-CN
ghd	港	zh-CN
ghdg	冮	zh-CN
ghds	港	zh-CN
ghe	岗	zh-CN
ghex	岗	zh-CN
ghf	缸	zh-CN
ghfg	扛	zh-CN
ghj	钢	zh-CN
ghk	冈	zh-CN
ghkd	刚	zh-CN
ghkx	冈	zh-CN
ghl	戆	zh-CN
ghlx	戆	zh-CN
ghm	杠	zh-CN
ghmx	㭎	zh-CN
gho	肛	zh-CN
ghog	肛	zh-CN
ghs	纲	zh-CN
ghsv	罡	zh-CN
ghsx	纲	zh-CN
ght	堽	zh-CN
ght	堽	zh-CN
ghtv	堽	zh-CN
ghtl	鿍	zh-CN
ghu	矼	zh-CN
ghug	矼	zh-CN
ghv	筻	zh-CN
gja	甘	zh-CN
gjaa	甘	zh-CN
gjau	干	zh-CN
gjax	鳡	zh-CN
gjb	疳	zh-CN
gjc	苷	zh-CN
gjcg	苷	zh-CN
gjd	淦	zh-CN
gjdg	泔	zh-CN
gjdw	澉	zh-CN
gjf	擀	zh-CN
gjfg	擀	zh-CN
gjh	秆	zh-CN
gjhg	秆	zh-CN
gjl	赣	zh-CN
gjlr	赣	zh-CN
gjm	杆	zh-CN
gjmg	柑	zh-CN
gjmw	橄	zh-CN
gjn	甘	zh-CN
gjna	甘	zh-CN
gjo	肝	zh-CN
gjog	旰	zh-CN
gjs	绀	zh-CN
gjsg	绀	zh-CN
gjt	赶	zh-CN
gjtg	坩	zh-CN
gju	尴	zh-CN
gjug	矸	zh-CN
gjum	尴	zh-CN
gjv	敢	zh-CN
gjvg	竿	zh-CN
gjw	感	zh-CN
gjwg	玕	zh-CN
gjwx	感	zh-CN
gjx	感	zh-CN
gjxx	感	zh-CN
gjy	尴	zh-CN
gjyg	酐	zh-CN
gjym	尴	zh-CN
gkf	拐	zh-CN
gkfl	拐	zh-CN
gkq	乖	zh-CN
gkqb	乖	zh-CN
gkv	夬	zh-CN
gkvn	夬	zh-CN
gkxt	怪	zh-CN
gld	广	zh-CN
gldi	广	zh-CN
gldw	洸	zh-CN
gliw	𨐈	zh-CN
glk	咣	zh-CN
glkw	咣	zh-CN
glmw	桄	zh-CN
glo	胱	zh-CN
glow	胱	zh-CN
glq	犷	zh-CN
glqg	犷	zh-CN
gltw	垙	zh-CN
glw	广	zh-CN
glwp	广	zh-CN
glxw	光	zh-CN
glz	逛	zh-CN
glzw	逛	zh-CN
gob	馘	zh-CN
godn	涡	zh-CN
gody	𬇹	zh-CN
goe	聒	zh-CN
goek	聒	zh-CN
goez	崞	zh-CN
gof	掴	zh-CN
gofy	掴	zh-CN
goi	蜾	zh-CN
goiy	蝈	zh-CN
goj	锅	zh-CN
gojy	帼	zh-CN
gok	国	zh-CN
gokn	呙	zh-CN
goky	国	zh-CN
gol	果	zh-CN
goln	果	zh-CN
gomg	粿	zh-CN
gomz	椁	zh-CN
goo	腘	zh-CN
gooy	腘	zh-CN
gop	虢	zh-CN
got	埚	zh-CN
gotn	埚	zh-CN
gow	郭	zh-CN
gowe	郭	zh-CN
gowy	裹	zh-CN
gra	鳏	zh-CN
grad	鳏	zh-CN
grak	鳤	zh-CN
grb	官	zh-CN
grbc	冠	zh-CN
grbt	关	zh-CN
grc	莞	zh-CN
grcc	蒄	zh-CN
grcn	鹳	zh-CN
grd	灌	zh-CN
grdf	灌	zh-CN
grdk	涫	zh-CN
grf	罐	zh-CN
grfr	掼	zh-CN
grg	贯	zh-CN
grh	爟	zh-CN
grhf	爟	zh-CN
grm	棺	zh-CN
grmr	贯	zh-CN
grp	盥	zh-CN
grpg	祼	zh-CN
grpm	盥	zh-CN
grr	倌	zh-CN
grrk	倌	zh-CN
grs	纶	zh-CN
grsb	纶	zh-CN
grsv	矜	zh-CN
gru	馆	zh-CN
gruk	馆	zh-CN
grv	管	zh-CN
grva	毌	zh-CN
grvk	管	zh-CN
grvr	贯	zh-CN
grwf	瓘	zh-CN
grwk	琯	zh-CN
grx	惯	zh-CN
grxr	惯	zh-CN
gry	观	zh-CN
grye	观	zh-CN
gsa	工	zh-CN
gsaa	工	zh-CN
gsb	公	zh-CN
gsbk	宫	zh-CN
gsbs	公	zh-CN
gsc	恭	zh-CN
gscb	共	zh-CN
gscx	恭	zh-CN
gsd	觥	zh-CN
gsdw	觥	zh-CN
gsf	拱	zh-CN
gsfb	拱	zh-CN
gsg	贡	zh-CN
gsgf	巩	zh-CN
gsgl	功	zh-CN
gsgw	攻	zh-CN
gsi	蚣	zh-CN
gsis	蚣	zh-CN
gsk	唝	zh-CN
gsl	龚	zh-CN
gso	肱	zh-CN
gsos	肱	zh-CN
gsr	供	zh-CN
gsrb	供	zh-CN
gsu	躬	zh-CN
gsv	弓	zh-CN
gsvv	弓	zh-CN
gsw	珙	zh-CN
gswb	珙	zh-CN
gua	鲴	zh-CN
guak	鲴	zh-CN
gub	谷	zh-CN
gubk	痼	zh-CN
guc	菇	zh-CN
gucg	菰	zh-CN
guck	菇	zh-CN
gud	沽	zh-CN
gudo	汩	zh-CN
gudy	瀔	zh-CN
gue	崮	zh-CN
guek	崮	zh-CN
gug	鹘	zh-CN
gugn	鹘	zh-CN
guh	雇	zh-CN
guhf	雇	zh-CN
gui	顾	zh-CN
guik	轱	zh-CN
guim	蛊	zh-CN
guir	顾	zh-CN
guj	钴	zh-CN
gujk	锢	zh-CN
guk	固	zh-CN
gukg	呱	zh-CN
gukk	咕	zh-CN
gul	骨	zh-CN
gulo	骨	zh-CN
gum	梏	zh-CN
gumk	梏	zh-CN
gun	姑	zh-CN
gunk	牯	zh-CN
guo	股	zh-CN
guok	𦙶	zh-CN
guoy	臌	zh-CN
gur	估	zh-CN
gurk	估	zh-CN
gus	罟	zh-CN
gusk	罟	zh-CN
gutk	堌	zh-CN
guu	鼓	zh-CN
guuk	古	zh-CN
guun	鸪	zh-CN
guuo	瞽	zh-CN
guuu	辜	zh-CN
guuw	故	zh-CN
guuy	毂	zh-CN
guv	箍	zh-CN
guvj	箍	zh-CN
gux	贾	zh-CN
guy	诂	zh-CN
guyk	酤	zh-CN
guyy	羖	zh-CN
guz	孤	zh-CN
guzg	孤	zh-CN
gva	鲑	zh-CN
gvar	鳜	zh-CN
gvat	鲑	zh-CN
gvb	皈	zh-CN
gvbj	宄	zh-CN
gvby	皈	zh-CN
gvd	龟	zh-CN
gvdj	氿	zh-CN
gve	刿	zh-CN
gved	刿	zh-CN
gvf	规	zh-CN
gvfe	规	zh-CN
gvfl	鬶	zh-CN
gvg	庋	zh-CN
gvi	轨	zh-CN
gvij	轨	zh-CN
gvk	匦	zh-CN
gvkj	匦	zh-CN
gvl	归	zh-CN
gvm	桂	zh-CN
gvmj	柜	zh-CN
gvms	桧	zh-CN
gvmt	闺	zh-CN
gvn	妫	zh-CN
gvnw	妫	zh-CN
gvo	晷	zh-CN
gvoh	炅	zh-CN
gvok	晷	zh-CN
gvp	鬼	zh-CN
gvps	鬼	zh-CN
gvr	刽	zh-CN
gvrd	刽	zh-CN
gvt	圭	zh-CN
gvte	邽	zh-CN
gvtt	圭	zh-CN
gvu	硅	zh-CN
gvut	硅	zh-CN
hvuv	硊	zh-CN
gvv	癸	zh-CN
gvvm	簋	zh-CN
gvvr	贵	zh-CN
gvvt	筀	zh-CN
gvw	瑰	zh-CN
gvwg	瑰	zh-CN
gvwt	珪	zh-CN
gvy	诡	zh-CN
gvz	跪	zh-CN
gws	给	zh-CN
gwsk	给	zh-CN
gxb	寡	zh-CN
gxbd	寡	zh-CN
gxf	挂	zh-CN
gxft	挂	zh-CN
gxk	剐	zh-CN
gxkg	呱	zh-CN
gxm	栝	zh-CN
gxo	胍	zh-CN
gxog	胍	zh-CN
gxp	瓜	zh-CN
gxpb	褂	zh-CN
gxpn	瓜	zh-CN
gxq	刮	zh-CN
gxqd	刮	zh-CN
gxqn	鸹	zh-CN
gxt	卦	zh-CN
gxtb	卦	zh-CN
gxtg	坬	zh-CN
gxyt	诖	zh-CN
gya	鲧	zh-CN
gyax	鲧	zh-CN
gydy	滚	zh-CN
gyi	辊	zh-CN
gyib	辊	zh-CN
gym	棍	zh-CN
gymb	棍	zh-CN
gys	绲	zh-CN
gysb	绲	zh-CN
gyu	磙	zh-CN
gyw	衮	zh-CN
gywy	衮	zh-CN
gza	觏	zh-CN
gzae	觏	zh-CN
gzb	勾	zh-CN
gzbs	勾	zh-CN
gzbx	够	zh-CN
gzc	苟	zh-CN
gzck	苟	zh-CN
gzd	沟	zh-CN
gze	岣	zh-CN
gzek	岣	zh-CN
gzg	鞲	zh-CN
gzj	钩	zh-CN
gzje	觏	zh-CN
gzjs	钩	zh-CN
gzk	购	zh-CN
gzks	购	zh-CN
gzlk	耇	zh-CN
gzm	构	zh-CN
gzms	构	zh-CN
gzn	媾	zh-CN
gznk	姤	zh-CN
gznr	媾	zh-CN
gzq	狗	zh-CN
gzqk	狗	zh-CN
gzr	佝	zh-CN
gzrk	佝	zh-CN
gzs	缑	zh-CN
gzsu	缑	zh-CN
gzt	垢	zh-CN
gztk	垢	zh-CN
gzuy	彀	zh-CN
gzv	篝	zh-CN
gzvk	笱	zh-CN
gzvr	篝	zh-CN
gzy	诟	zh-CN
gzyk	诟	zh-CN
gzz	遘	zh-CN
gzzr	遘	zh-CN
h	和	zh-CN
hai	蛤	zh-CN
haik	蛤	zh-CN
haj	铪	zh-CN
hajk	铪	zh-CN
hak	哈	zh-CN
hakk	哈	zh-CN
hcb	皓	zh-CN
hcbk	皓	zh-CN
hcc	薅	zh-CN
hccc	薅	zh-CN
hcck	蒿	zh-CN
hcd	浩	zh-CN
hcdk	浩	zh-CN
hcdr	灏	zh-CN
hcdt	淏	zh-CN
hci	蚝	zh-CN
hcim	蚝	zh-CN
hcj	镐	zh-CN
hcjk	镐	zh-CN
hck	号	zh-CN
hcku	嚎	zh-CN
hckv	号	zh-CN
hcl	耗	zh-CN
hcnz	好	zh-CN
hco	昊	zh-CN
hcor	颢	zh-CN
hcot	昊	zh-CN
hcrd	侴	zh-CN
hct	郝	zh-CN
hcte	郝	zh-CN
hctu	壕	zh-CN
hcv	貉	zh-CN
hcvk	貉	zh-CN
hcw	豪	zh-CN
hcwe	鄗	zh-CN
hcwm	毫	zh-CN
hdb	害	zh-CN
hdd	海	zh-CN
hddm	海	zh-CN
hdg	骸	zh-CN
hdk	嗨	zh-CN
hdkk	嗐	zh-CN
hdkm	嗨	zh-CN
hdkr	咳	zh-CN
hdm	骇	zh-CN
hdmr	骇	zh-CN
hdo	胲	zh-CN
hdor	胲	zh-CN
hdq	氦	zh-CN
hdqr	氦	zh-CN
hdw	亥	zh-CN
hdwr	亥	zh-CN
hdy	醢	zh-CN
hdym	醢	zh-CN
hdz	孩	zh-CN
hdzr	孩	zh-CN
hea	翮	zh-CN
heax	翮	zh-CN
hec	荷	zh-CN
heck	菏	zh-CN
hed	河	zh-CN
hedf	隺	zh-CN
hedn	鹤	zh-CN
heg	鞨	zh-CN
heh	熇	zh-CN
hehk	和	zh-CN
hehm	盉	zh-CN
hek	喝	zh-CN
hekk	呵	zh-CN
hekv	喝	zh-CN
hekx	吓	zh-CN
hel	贺	zh-CN
helr	贺	zh-CN
helt	壑	zh-CN
hem	核	zh-CN
hemm	阖	zh-CN
hemr	阂	zh-CN
heo	曷	zh-CN
heon	鹖	zh-CN
heov	曷	zh-CN
hep	褐	zh-CN
hepm	禾	zh-CN
hepv	褐	zh-CN
heq	禾	zh-CN
heqn	禾	zh-CN
her	合	zh-CN
here	郃	zh-CN
herh	龢	zh-CN
herk	何	zh-CN
herm	盒	zh-CN
herr	颌	zh-CN
hes	纥	zh-CN
hesq	纥	zh-CN
het	赫	zh-CN
hetd	赫	zh-CN
hetk	垎	zh-CN
hetm	盍	zh-CN
heuk	饸	zh-CN
hev	貉	zh-CN
hevk	貉	zh-CN
hevq	龁	zh-CN
hew	劾	zh-CN
hewl	劾	zh-CN
hex	翯	zh-CN
hey	诃	zh-CN
hfb	痕	zh-CN
hfbg	痕	zh-CN
hfig	很	zh-CN
hfq	狠	zh-CN
hfqg	狠	zh-CN
hfx	恨	zh-CN
hfxg	恨	zh-CN
hfyg	𬣳	zh-CN
hgc	蘅	zh-CN
hgci	蘅	zh-CN
hgi	衡	zh-CN
hgii	行	zh-CN
hgin	鸻	zh-CN
hgk	哼	zh-CN
hgkl	哼	zh-CN
hgm	桁	zh-CN
hgmb	横	zh-CN
hgmi	桁	zh-CN
hgn	姮	zh-CN
hgw	亨	zh-CN
hgwi	珩	zh-CN
hgwl	亨	zh-CN
hgx	恒	zh-CN
hgxa	恒	zh-CN
hhc	巷	zh-CN
hhcs	巷	zh-CN
hhd	夯	zh-CN
hhdj	沆	zh-CN
hhdl	夯	zh-CN
hhi	行	zh-CN
hhk	吭	zh-CN
hhkj	吭	zh-CN
hhm	杭	zh-CN
hhs	绗	zh-CN
hhsi	绗	zh-CN
hhv	航	zh-CN
hhw	颃	zh-CN
hhwr	颃	zh-CN
hjb	寒	zh-CN
hjbd	寒	zh-CN
hjbg	罕	zh-CN
hjc	菡	zh-CN
hjcg	蔊	zh-CN
hjck	菡	zh-CN
hjd	汉	zh-CN
hjdg	汗	zh-CN
hjdk	涵	zh-CN
hjdx	瀚	zh-CN
hjdy	汉	zh-CN
hje	崡	zh-CN
hjek	嵅	zh-CN
hjf	捍	zh-CN
hjfw	撖	zh-CN
hjfx	撼	zh-CN
hjg	邯	zh-CN
hjge	邗	zh-CN
hjgr	顸	zh-CN
hjh	焊	zh-CN
hjhg	焊	zh-CN
hjhk	焓	zh-CN
hji	蚶	zh-CN
hjig	虷	zh-CN
hjk	喊	zh-CN
hjkk	喊	zh-CN
hjkw	㘎	zh-CN
hjl	函	zh-CN
hjlk	函	zh-CN
hjm	阚	zh-CN
hjo	旱	zh-CN
hjok	晗	zh-CN
hjon	暵	zh-CN
hjq	犴	zh-CN
hjqg	犴	zh-CN
hjr	颔	zh-CN
hjrk	含	zh-CN
hjrr	颔	zh-CN
hjtg	垾	zh-CN
hju	韩	zh-CN
hjuw	韩	zh-CN
hjux	翰	zh-CN
hjv	憨	zh-CN
hjvx	憨	zh-CN
hjwk	琀	zh-CN
hjx	憾	zh-CN
hjxg	悍	zh-CN
hjxx	憾	zh-CN
hjy	酣	zh-CN
hjyg	酣	zh-CN
hjz	鼾	zh-CN
hjzg	鼾	zh-CN
hkd	淮	zh-CN
hkdf	淮	zh-CN
hki	徊	zh-CN
hkm	槐	zh-CN
hkmg	槐	zh-CN
hkt	坏	zh-CN
hktb	坏	zh-CN
hkx	怀	zh-CN
hkz	踝	zh-CN
hkzg	踝	zh-CN
hla	鳇	zh-CN
hlaw	鳇	zh-CN
hlb	皇	zh-CN
hlbb	癀	zh-CN
hlc	荒	zh-CN
hlcb	黄	zh-CN
hlcv	荒	zh-CN
hld	湟	zh-CN
hldb	潢	zh-CN
hldw	滉	zh-CN
hle	隍	zh-CN
hlh	煌	zh-CN
hli	蝗	zh-CN
hlib	蟥	zh-CN
hliw	徨	zh-CN
hlj	凰	zh-CN
hljw	幌	zh-CN
hlkw	喤	zh-CN
hln	媓	zh-CN
hlnw	媓	zh-CN
hlo	晃	zh-CN
hlow	晃	zh-CN
hlv	簧	zh-CN
hlvb	簧	zh-CN
hlvw	篁	zh-CN
hlwb	璜	zh-CN
hlwo	肓	zh-CN
hlx	慌	zh-CN
hlxv	慌	zh-CN
hlxw	惶	zh-CN
hly	谎	zh-CN
hlz	遑	zh-CN
hlzw	遑	zh-CN
hob	豁	zh-CN
hoc	获	zh-CN
hocd	劐	zh-CN
hocf	藿	zh-CN
hocq	获	zh-CN
hod	活	zh-CN
hodk	活	zh-CN
hodr	火	zh-CN
hody	濩	zh-CN
hoe	彟	zh-CN
hoey	彟	zh-CN
hof	攉	zh-CN
hoff	攉	zh-CN
hog	惑	zh-CN
hoga	或	zh-CN
hogx	夥	zh-CN
hoh	和	zh-CN
hohf	㸌	zh-CN
hohk	和	zh-CN
hoi	蠖	zh-CN
hoiy	蠖	zh-CN
hoj	镬	zh-CN
hojh	钬	zh-CN
hojy	镬	zh-CN
hok	嚯	zh-CN
hokf	嚯	zh-CN
hoky	嚄	zh-CN
hol	耠	zh-CN
holk	耠	zh-CN
hom	𬴃	zh-CN
homu	𬴃	zh-CN
hop	祸	zh-CN
hopn	祸	zh-CN
hor	货	zh-CN
horh	伙	zh-CN
hork	佸	zh-CN
horr	货	zh-CN
hoy	霍	zh-CN
hoyf	霍	zh-CN
hra	鲩	zh-CN
hrae	鲩	zh-CN
hray	鬟	zh-CN
hrb	痪	zh-CN
hrbd	痪	zh-CN
hrbe	郇	zh-CN
hrbi	宦	zh-CN
hrby	寰	zh-CN
hrc	萑	zh-CN
hrcf	萑	zh-CN
hrd	涣	zh-CN
hrde	浣	zh-CN
hrda	洹	zh-CN
hrdx	漶	zh-CN
hrdy	澴	zh-CN
hre	峘	zh-CN
hrea	峘	zh-CN
hrf	擐	zh-CN
hrfd	换	zh-CN
hrfy	擐	zh-CN
hrh	焕	zh-CN
hrhd	焕	zh-CN
hri	患	zh-CN
hrix	患	zh-CN
hrj	豢	zh-CN
hrjy	锾	zh-CN
hrk	唤	zh-CN
hrkd	唤	zh-CN
hrky	圜	zh-CN
hrm	桓	zh-CN
hrn	嬛	zh-CN
hrny	嬛	zh-CN
hro	㬊	zh-CN
hroy	㬊	zh-CN
hrq	獾	zh-CN
hrqf	獾	zh-CN
hrs	缓	zh-CN
hrse	𬘫	zh-CN
hrsn	鹮	zh-CN
hrsy	缳	zh-CN
hrv	貆	zh-CN
hrw	环	zh-CN
hrwb	环	zh-CN
hrwq	𤩽	zh-CN
hry	欢	zh-CN
hryv	幻	zh-CN
hrz	还	zh-CN
hrzb	还	zh-CN
hrzk	逭	zh-CN
hsb	宏	zh-CN
hsbb	谼	zh-CN
hsbk	訇	zh-CN
hsbs	宏	zh-CN
hsc	蕻	zh-CN
hscb	薨	zh-CN
hscg	荭	zh-CN
hsd	洪	zh-CN
hsdb	洪	zh-CN
hsdn	鸿	zh-CN
hsg	弘	zh-CN
hsgs	弘	zh-CN
hsh	烘	zh-CN
hshb	烘	zh-CN
hsi	虹	zh-CN
hsig	虹	zh-CN
hsiy	轰	zh-CN
hsj	𬭎	zh-CN
hsjb	𫟹	zh-CN
hsjs	𬭎	zh-CN
hsk	哄	zh-CN
hskb	哄	zh-CN
hskn	吽	zh-CN
hsl	竑	zh-CN
hsm	闳	zh-CN
hsms	闳	zh-CN
hss	纮	zh-CN
hssg	红	zh-CN
hsss	纮	zh-CN
hsu	硔	zh-CN
hsub	硔	zh-CN
hswg	玒	zh-CN
hsx	黉	zh-CN
hsy	讧	zh-CN
hsyg	讧	zh-CN
hua	互	zh-CN
huaa	互	zh-CN
huay	鳠	zh-CN
huc	葫	zh-CN
huco	葫	zh-CN
hud	沪	zh-CN
hudg	瓠	zh-CN
hudh	滹	zh-CN
hudo	湖	zh-CN
hudw	浒	zh-CN
hudx	淴	zh-CN
hue	岵	zh-CN
huek	岵	zh-CN
huf	护	zh-CN
hug	弧	zh-CN
hugg	弧	zh-CN
hugn	鹘	zh-CN
huh	虎	zh-CN
huhb	扈	zh-CN
huhk	和	zh-CN
huho	煳	zh-CN
huhu	戽	zh-CN
hui	蝴	zh-CN
huih	轷	zh-CN
huio	蝴	zh-CN
huk	呼	zh-CN
hukh	呼	zh-CN
hukj	唬	zh-CN
hukw	囫	zh-CN
hukx	唿	zh-CN
hum	糊	zh-CN
humo	糊	zh-CN
humr	核	zh-CN
humu	槲	zh-CN
hun	鹄	zh-CN
hunh	嫭	zh-CN
hunn	鹄	zh-CN
huny	鹱	zh-CN
huo	昒	zh-CN
huoh	昈	zh-CN
huow	昒	zh-CN
hup	乎	zh-CN
hupk	祜	zh-CN
hupl	乎	zh-CN
huq	狐	zh-CN
huqg	狐	zh-CN
huqo	猢	zh-CN
huu	胡	zh-CN
huun	鹕	zh-CN
huuy	壶	zh-CN
huv	笏	zh-CN
huvw	笏	zh-CN
huw	忽	zh-CN
huwj	琥	zh-CN
huwo	瑚	zh-CN
huwx	忽	zh-CN
hux	怙	zh-CN
huxx	惚	zh-CN
huy	醐	zh-CN
huye	鄠	zh-CN
huyo	醐	zh-CN
hva	惠	zh-CN
hvax	惠	zh-CN
hvc	荟	zh-CN
hvck	茴	zh-CN
hvcs	荟	zh-CN
hvcx	蕙	zh-CN
hvd	汇	zh-CN
hvdk	洄	zh-CN
hve	堕	zh-CN
hvet	堕	zh-CN
hvex	隳	zh-CN
hvf	挥	zh-CN
hvfe	彗	zh-CN
hvfi	挥	zh-CN
hvfx	慧	zh-CN
hvg	麾	zh-CN
hvgm	麾	zh-CN
hvh	秽	zh-CN
hvi	徽	zh-CN
hvik	蛔	zh-CN
hviw	徽	zh-CN
hvix	蟪	zh-CN
hvj	毁	zh-CN
hvjy	毁	zh-CN
hvk	回	zh-CN
hvkh	咴	zh-CN
hvkk	回	zh-CN
hvko	贿	zh-CN
hvku	喙	zh-CN
hvkx	哕	zh-CN
hvm	桧	zh-CN
hvms	桧	zh-CN
hvmx	橞	zh-CN
hvo	晖	zh-CN
hvoi	晖	zh-CN
hvom	晦	zh-CN
hvpw	袆	zh-CN
hvr	会	zh-CN
hvs	绘	zh-CN
hvss	绘	zh-CN
hvtx	恚	zh-CN
hvu	灰	zh-CN
hvuc	卉	zh-CN
hvw	珲	zh-CN
hvwi	虺	zh-CN
hvx	悔	zh-CN
hvxh	恢	zh-CN
hvxi	辉	zh-CN
hvy	讳	zh-CN
hvyh	诙	zh-CN
hvym	诲	zh-CN
hvyw	讳	zh-CN
hwjh	𬭶	zh-CN
hwk	嘿	zh-CN
hwkh	嘿	zh-CN
hwlh	黑	zh-CN
hxa	画	zh-CN
hxak	画	zh-CN
hxc	花	zh-CN
hxcb	花	zh-CN
hxd	滑	zh-CN
hxdt	觟	zh-CN
hxfu	砉	zh-CN
hxg	划	zh-CN
hxj	铧	zh-CN
hxk	哗	zh-CN
hxku	哗	zh-CN
hxm	桦	zh-CN
hxn	婳	zh-CN
hxnk	婳	zh-CN
hxq	猾	zh-CN
hxqg	猾	zh-CN
hxr	化	zh-CN
hxrb	化	zh-CN
hxru	华	zh-CN
hxyk	话	zh-CN
hyc	荤	zh-CN
hyci	荤	zh-CN
hyd	浑	zh-CN
hydb	混	zh-CN
hydi	浑	zh-CN
hydu	溷	zh-CN
hye	魂	zh-CN
hyeg	魂	zh-CN
hym	阍	zh-CN
hymo	阍	zh-CN
hyn	婚	zh-CN
hyno	婚	zh-CN
hyu	昏	zh-CN
hyub	馄	zh-CN
hyuo	昏	zh-CN
hyw	珲	zh-CN
hyxo	惛	zh-CN
hyy	诨	zh-CN
hyyi	诨	zh-CN
hza	鲘	zh-CN
hzak	鲘	zh-CN
hzb	瘊	zh-CN
hzg	骺	zh-CN
hzgk	骺	zh-CN
hzi	厚	zh-CN
hziz	厚	zh-CN
hzj	𬭤	zh-CN
hzju	𬭤	zh-CN
hzk	吼	zh-CN
hzku	喉	zh-CN
hzkv	吼	zh-CN
hzm	糇	zh-CN
hzp	垕	zh-CN
hzpe	郈	zh-CN
hzpk	后	zh-CN
hzpt	垕	zh-CN
hzq	猴	zh-CN
hzqu	猴	zh-CN
hzr	候	zh-CN
hzru	侯	zh-CN
hztu	堠	zh-CN
hzv	篌	zh-CN
hzvu	篌	zh-CN
hzx	鲎	zh-CN
hzxa	鲎	zh-CN
hzz	逅	zh-CN
hzzk	齁	zh-CN
i	出	zh-CN
iab	察	zh-CN
iabe	岔	zh-CN
iabx	察	zh-CN
iac	茶	zh-CN
iacm	茶	zh-CN
iact	茬	zh-CN
iad	汊	zh-CN
iadi	汊	zh-CN
iae	嵖	zh-CN
iaea	嵖	zh-CN
iaf	插	zh-CN
iafm	搽	zh-CN
iaj	镲	zh-CN
iajj	锸	zh-CN
iak	喳	zh-CN
iakx	嚓	zh-CN
iam	查	zh-CN
iama	楂	zh-CN
iamg	槎	zh-CN
iami	杈	zh-CN
iamx	檫	zh-CN
ian	姹	zh-CN
ianq	姹	zh-CN
iap	衩	zh-CN
iapi	衩	zh-CN
iaq	猹	zh-CN
iaqa	猹	zh-CN
iar	侘	zh-CN
iarq	侘	zh-CN
iatq	垞	zh-CN
iau	碴	zh-CN
iax	刹	zh-CN
iaxd	刹	zh-CN
iay	叉	zh-CN
iayd	叉	zh-CN
iayg	差	zh-CN
iayq	诧	zh-CN
iaz	蹅	zh-CN
icd	潮	zh-CN
icf	抄	zh-CN
icg	弨	zh-CN
icgk	弨	zh-CN
ich	炒	zh-CN
ichu	焯	zh-CN
icj	钞	zh-CN
icju	钞	zh-CN
ick	吵	zh-CN
icko	嘲	zh-CN
icl	耖	zh-CN
ico	晁	zh-CN
icod	晁	zh-CN
ics	绰	zh-CN
ict	超	zh-CN
icu	朝	zh-CN
icuo	朝	zh-CN
icv	巢	zh-CN
icvd	剿	zh-CN
icx	怊	zh-CN
idb	瘥	zh-CN
idbg	瘥	zh-CN
idc	茝	zh-CN
idcl	茝	zh-CN
idfi	拆	zh-CN
idj	钗	zh-CN
idr	侪	zh-CN
idrl	侪	zh-CN
idv	柴	zh-CN
idvc	豺	zh-CN
idvm	柴	zh-CN
idw	虿	zh-CN
idwi	虿	zh-CN
idy	差	zh-CN
idyg	差	zh-CN
iea	车	zh-CN
ieal	车	zh-CN
ied	澈	zh-CN
iedw	澈	zh-CN
ief	撤	zh-CN
iefv	扯	zh-CN
iei	彻	zh-CN
ieid	彻	zh-CN
ieo	㬚	zh-CN
ieow	㬚	zh-CN
iep	掣	zh-CN
iepu	掣	zh-CN
iet	坼	zh-CN
ieti	坼	zh-CN
ieu	砗	zh-CN
ifb	宸	zh-CN
ifbh	疢	zh-CN
ifbn	宸	zh-CN
ifd	沉	zh-CN
ifdj	沉	zh-CN
ife	陈	zh-CN
ifed	陈	zh-CN
iff	抻	zh-CN
ifh	称	zh-CN
ifhx	称	zh-CN
ifi	辰	zh-CN
ifin	辰	zh-CN
ifk	臣	zh-CN
ifkb	嗔	zh-CN
ifkl	臣	zh-CN
ifm	郴	zh-CN
ifme	郴	zh-CN
ifmv	梣	zh-CN
ifo	晨	zh-CN
ifob	瞋	zh-CN
ifon	晨	zh-CN
ifp	衬	zh-CN
ifr	伧	zh-CN
ifrv	伧	zh-CN
ifs	𬘭	zh-CN
ifsm	𬘭	zh-CN
ift	趁	zh-CN
iftp	趁	zh-CN
ifu	碜	zh-CN
ifup	碜	zh-CN
ifv	龀	zh-CN
ifvb	龀	zh-CN
ifw	琛	zh-CN
ifwm	琛	zh-CN
ifx	尘	zh-CN
ifxt	尘	zh-CN
ifxv	忱	zh-CN
ify	谶	zh-CN
ifyj	谶	zh-CN
ifyv	谌	zh-CN
igbi	宬	zh-CN
igda	澄	zh-CN
igdw	澂	zh-CN
igf	撑	zh-CN
iggw	庱	zh-CN
igh	称	zh-CN
ighp	秤	zh-CN
ighw	程	zh-CN
ighx	称	zh-CN
igi	惩	zh-CN
igim	盛	zh-CN
igit	蛏	zh-CN
igix	惩	zh-CN
igj	铖	zh-CN
igje	铛	zh-CN
igk	呈	zh-CN
igkw	呈	zh-CN
igl	丞	zh-CN
igla	丞	zh-CN
igm	橙	zh-CN
igma	橙	zh-CN
igmi	枨	zh-CN
igmt	柽	zh-CN
igmv	骋	zh-CN
igo	瞠	zh-CN
igoi	晟	zh-CN
igot	塍	zh-CN
igp	裎	zh-CN
igpw	裎	zh-CN
igq	乘	zh-CN
igqn	乘	zh-CN
igrr	偁	zh-CN
igt	城	zh-CN
igti	城	zh-CN
igtr	赪	zh-CN
igtw	埕	zh-CN
igv	承	zh-CN
igvn	承	zh-CN
igw	珵	zh-CN
igwi	珹	zh-CN
igwl	琤	zh-CN
igwv	成	zh-CN
igxa	憕	zh-CN
igxy	牚	zh-CN
igy	诚	zh-CN
igyw	酲	zh-CN
igz	逞	zh-CN
igzw	逞	zh-CN
iha	厂	zh-CN
ihao	鲳	zh-CN
ihap	厂	zh-CN
ihas	鲿	zh-CN
ihc	苌	zh-CN
ihco	菖	zh-CN
ihi	徜	zh-CN
ihk	唱	zh-CN
ihko	唱	zh-CN
ihm	阊	zh-CN
ihmo	阊	zh-CN
ihn	娼	zh-CN
ihnj	嫦	zh-CN
ihno	娼	zh-CN
iho	肠	zh-CN
ihoo	昌	zh-CN
ihop	肠	zh-CN
ihq	猖	zh-CN
ihqo	猖	zh-CN
ihr	偿	zh-CN
ihri	伥	zh-CN
ihro	倡	zh-CN
ihrs	偿	zh-CN
iht	场	zh-CN
ihtp	场	zh-CN
ihu	畅	zh-CN
ihup	畅	zh-CN
ihx	常	zh-CN
ihx	怅	zh-CN
ihxb	鬯	zh-CN
ihxj	常	zh-CN
ihxk	惝	zh-CN
ihxs	尝	zh-CN
ihxw	敞	zh-CN
ihxy	裳	zh-CN
ihy	昶	zh-CN
ihyo	昶	zh-CN
iia	豉	zh-CN
iiay	豉	zh-CN
iib	痴	zh-CN
iibk	痴	zh-CN
iibx	瘛	zh-CN
iic	茌	zh-CN
iid	池	zh-CN
iie	耻	zh-CN
iiev	耻	zh-CN
iif	持	zh-CN
iifc	持	zh-CN
iifd	摛	zh-CN
iig	弛	zh-CN
iigd	魑	zh-CN
iigy	弛	zh-CN
iih	炽	zh-CN
iihb	炽	zh-CN
iii	螭	zh-CN
iiid	螭	zh-CN
iik	嗤	zh-CN
iikb	叱	zh-CN
iikd	哧	zh-CN
iiki	嗤	zh-CN
iikq	吃	zh-CN
iim	驰	zh-CN
iimy	驰	zh-CN
iin	媸	zh-CN
iini	媸	zh-CN
iio	匙	zh-CN
iiob	匙	zh-CN
iiox	眵	zh-CN
iioy	胣	zh-CN
iip	斥	zh-CN
iipd	斥	zh-CN
iipj	褫	zh-CN
iipr	彳	zh-CN
iir	侈	zh-CN
iirk	佁	zh-CN
iirx	傺	zh-CN
iisj	𫄨	zh-CN
iit	赤	zh-CN
iitd	坻	zh-CN
iitn	墀	zh-CN
iiu	尺	zh-CN
iiul	饬	zh-CN
iiun	尺	zh-CN
iiuw	敕	zh-CN
iiux	翅	zh-CN
iiv	齿	zh-CN
iivj	篪	zh-CN
iivk	笞	zh-CN
iiw	啻	zh-CN
iiwk	啻	zh-CN
iixw	瓻	zh-CN
iiz	迟	zh-CN
iizk	踟	zh-CN
ijb	单	zh-CN
ijbl	单	zh-CN
ijbn	冁	zh-CN
ijc	蒇	zh-CN
ijcr	蒇	zh-CN
ijd	潺	zh-CN
ijda	澶	zh-CN
ijdt	瀍	zh-CN
ije	巉	zh-CN
ijed	巉	zh-CN
ijf	搀	zh-CN
ijfd	搀	zh-CN
ijfp	掺	zh-CN
ijgk	韂	zh-CN
ijgt	廛	zh-CN
ijh	𬊤	zh-CN
iji	蝉	zh-CN
ijik	蟾	zh-CN
ijil	蝉	zh-CN
ijj	铲	zh-CN
ijjd	镵	zh-CN
ijju	镡	zh-CN
ijk	啴	zh-CN
ijle	觇	zh-CN
ijlp	产	zh-CN
ijm	阐	zh-CN
ijml	阐	zh-CN
ijmz	骣	zh-CN
ijn	婵	zh-CN
ijnl	婵	zh-CN
ijo	旵	zh-CN
ijoe	旵	zh-CN
ijp	禅	zh-CN
ijrd	儳	zh-CN
ijs	缠	zh-CN
ijsl	缠	zh-CN
iju	馋	zh-CN
ijuy	羼	zh-CN
ijuz	孱	zh-CN
ijw	颤	zh-CN
ijwr	颤	zh-CN
ijx	忏	zh-CN
ijxq	忏	zh-CN
ijy	谄	zh-CN
ijyd	谗	zh-CN
ijz	躔	zh-CN
ijze	辿	zh-CN
ijzt	躔	zh-CN
ikf	搋	zh-CN
ikfe	揣	zh-CN
ikfj	搋	zh-CN
ikk	啜	zh-CN
ikky	啜	zh-CN
ikz	踹	zh-CN
ikze	踹	zh-CN
ilb	疮	zh-CN
ilbv	疮	zh-CN
ilbw	窗	zh-CN
ilg	床	zh-CN
ilgm	床	zh-CN
ilj	幢	zh-CN
iljl	幢	zh-CN
ilk	噇	zh-CN
ilkl	噇	zh-CN
ilm	闯	zh-CN
ilr	创	zh-CN
ilrd	创	zh-CN
ilx	怆	zh-CN
ilxv	怆	zh-CN
ioi	辍	zh-CN
ioiy	辍	zh-CN
iok	啜	zh-CN
ioky	啜	zh-CN
ios	绰	zh-CN
iosu	绰	zh-CN
iov	龊	zh-CN
iovr	龊	zh-CN
iox	惙	zh-CN
ioxg	戳	zh-CN
ioxy	惙	zh-CN
ioz	踔	zh-CN
iozu	逴	zh-CN
irb	穿	zh-CN
irj	钏	zh-CN
irji	钏	zh-CN
irk	喘	zh-CN
irke	圌	zh-CN
irl	串	zh-CN
irll	串	zh-CN
irm	椽	zh-CN
irmu	椽	zh-CN
irp	川	zh-CN
irpl	川	zh-CN
irq	氚	zh-CN
irrv	传	zh-CN
irto	堾	zh-CN
irv	船	zh-CN
irvk	船	zh-CN
irx	舛	zh-CN
irxl	舛	zh-CN
irz	遄	zh-CN
irze	遄	zh-CN
isb	宠	zh-CN
isbl	宠	zh-CN
isc	茺	zh-CN
isce	茺	zh-CN
isde	㳘	zh-CN
isdv	冲	zh-CN
isdx	漴	zh-CN
ise	崇	zh-CN
isex	崇	zh-CN
isf	舂	zh-CN
ish	种	zh-CN
isj	铳	zh-CN
isje	铳	zh-CN
isp	重	zh-CN
ispa	重	zh-CN
isv	虫	zh-CN
isvd	虫	zh-CN
isw	充	zh-CN
iswe	珫	zh-CN
isx	憧	zh-CN
isxv	忡	zh-CN
iua	亍	zh-CN
iuad	亍	zh-CN
iud	触	zh-CN
iude	刍	zh-CN
iudf	雏	zh-CN
iudh	滁	zh-CN
iudr	濋	zh-CN
iue	除	zh-CN
iueh	除	zh-CN
iuel	亍	zh-CN
iuf	搐	zh-CN
iufk	摴	zh-CN
iuft	搐	zh-CN
iuh	黜	zh-CN
iuhi	黜	zh-CN
iui	厨	zh-CN
iuic	厨	zh-CN
iuie	䢺	zh-CN
iuj	锄	zh-CN
ium	楚	zh-CN
iumc	橱	zh-CN
iume	柷	zh-CN
iumr	楚	zh-CN
iumw	杵	zh-CN
iup	初	zh-CN
iupo	褚	zh-CN
iur	储	zh-CN
iuro	储	zh-CN
iury	俶	zh-CN
ius	绌	zh-CN
iuu	础	zh-CN
iuuq	矗	zh-CN
iuvk	出	zh-CN
iuvr	𬺓	zh-CN
iuvx	䝙	zh-CN
iuw	畜	zh-CN
iuwb	处	zh-CN
iuwt	畜	zh-CN
iux	怵	zh-CN
iuxr	憷	zh-CN
iuz	躇	zh-CN
iuzc	蹰	zh-CN
iuzo	躇	zh-CN
ive	陲	zh-CN
ivei	陲	zh-CN
ivf	捶	zh-CN
ivfi	捶	zh-CN
ivh	炊	zh-CN
ivhr	炊	zh-CN
ivj	锤	zh-CN
ivji	锤	zh-CN
ivk	圌	zh-CN
ivke	圌	zh-CN
ivkr	吹	zh-CN
ivm	槌	zh-CN
ivmf	椎	zh-CN
ivmi	棰	zh-CN
ivp	垂	zh-CN
ivpa	垂	zh-CN
ivr	倕	zh-CN
ivri	倕	zh-CN
ixhr	欻	zh-CN
iya	䲠	zh-CN
iyao	䲠	zh-CN
iyc	莼	zh-CN
iyct	莼	zh-CN
iyd	淳	zh-CN
iyf	春	zh-CN
iyfi	蠢	zh-CN
iyfo	春	zh-CN
iyi	唇	zh-CN
iyik	唇	zh-CN
iyio	蝽	zh-CN
iyjz	𬭚	zh-CN
iym	椿	zh-CN
iymo	椿	zh-CN
iyst	纯	zh-CN
iyw	鹑	zh-CN
iywn	鹑	zh-CN
iywo	瑃	zh-CN
iyy	醇	zh-CN
izb	瘳	zh-CN
izbp	瘳	zh-CN
izfy	抽	zh-CN
izh	愁	zh-CN
izhk	稠	zh-CN
izj	帱	zh-CN
izjc	帱	zh-CN
izm	杻	zh-CN
izmk	椆	zh-CN
izo	瞅	zh-CN
izoh	瞅	zh-CN
izr	仇	zh-CN
izrc	俦	zh-CN
izrj	仇	zh-CN
izrn	犨	zh-CN
izs	绸	zh-CN
izsk	绸	zh-CN
izt	畴	zh-CN
iztc	畴	zh-CN
izv	丑	zh-CN
izva	丑	zh-CN
izvc	筹	zh-CN
izx	惆	zh-CN
izy	酬	zh-CN
izyv	酬	zh-CN
izz	臭	zh-CN
izzc	踌	zh-CN
izzq	臭	zh-CN
j	就	zh-CN
jbc	荩	zh-CN
jbcd	荩	zh-CN
jbd	津	zh-CN
jbda	殣	zh-CN
jbdo	溍	zh-CN
jbdy	浸	zh-CN
jbg	靳	zh-CN
jbga	廑	zh-CN
jbgj	靳	zh-CN
jbh	烬	zh-CN
jbhd	烬	zh-CN
jbi	尽	zh-CN
jbj	锦	zh-CN
jbjj	𬬱	zh-CN
jbk	噤	zh-CN
jbkx	噤	zh-CN
jbl	紧	zh-CN
jblv	卺	zh-CN
jblx	紧	zh-CN
jbm	禁	zh-CN
jbma	槿	zh-CN
jbmx	禁	zh-CN
jbn	妗	zh-CN
jbna	堇	zh-CN
jbne	觐	zh-CN
jbp	斤	zh-CN
jbpl	斤	zh-CN
jbpv	衿	zh-CN
jbpx	襟	zh-CN
jbpy	祲	zh-CN
jbr	金	zh-CN
jbra	金	zh-CN
jbrv	今	zh-CN
jbry	仅	zh-CN
jbs	缙	zh-CN
jbta	墐	zh-CN
jbua	馑	zh-CN
jbv	劲	zh-CN
jbvl	筋	zh-CN
jbw	瑾	zh-CN
jbwa	瑾	zh-CN
jbwy	珒	zh-CN
jby	谨	zh-CN
jbyo	晋	zh-CN
jbz	近	zh-CN
jbzj	进	zh-CN
jia	击	zh-CN
jiae	鲫	zh-CN
jiaj	鱾	zh-CN
jiak	髻	zh-CN
jial	鲚	zh-CN
jian	棘	zh-CN
jiax	𬶭	zh-CN
jib	寄	zh-CN
jibo	瘠	zh-CN
jibu	疾	zh-CN
jiby	寂	zh-CN
jic	藉	zh-CN
jica	蕺	zh-CN
jicj	芨	zh-CN
jicl	荠	zh-CN
jid	急	zh-CN
jidl	济	zh-CN
jido	脊	zh-CN
jidw	激	zh-CN
jidx	漈	zh-CN
jidz	洎	zh-CN
jie	际	zh-CN
jiej	岌	zh-CN
jiel	𬯀	zh-CN
jieo	嵴	zh-CN
jiex	际	zh-CN
jif	挤	zh-CN
jifk	掎	zh-CN
jifl	𪟝	zh-CN
jify	技	zh-CN
jig	即	zh-CN
jiga	暨	zh-CN
jigj	麂	zh-CN
jigt	堲	zh-CN
jigv	既	zh-CN
jih	稽	zh-CN
jihb	积	zh-CN
jihw	稷	zh-CN
jihz	季	zh-CN
jii	辑	zh-CN
jiij	虮	zh-CN
jiik	徛	zh-CN
jiit	墼	zh-CN
jij	忌	zh-CN
jijt	𫓯	zh-CN
jik	唧	zh-CN
jika	戢	zh-CN
jikd	戢	zh-CN
jikj	叽	zh-CN
jil	冀	zh-CN
jila	亟	zh-CN
jim	机	zh-CN
jime	楫	zh-CN
jimj	极	zh-CN
jin	嫉	zh-CN
jini	姬	zh-CN
jink	犄	zh-CN
jinl	姬	zh-CN
jiny	妓	zh-CN
jio	肌	zh-CN
jioj	肌	zh-CN
jip	及	zh-CN
jipr	𫌀	zh-CN
jipv	几	zh-CN
jipx	祭	zh-CN
jiq	基	zh-CN
jiqb	其	zh-CN
jiqo	期	zh-CN
jiqt	基	zh-CN
jiqx	惎	zh-CN
jir	集	zh-CN
jirk	佶	zh-CN
jirm	集	zh-CN
jirv	偈	zh-CN
jiry	伎	zh-CN
jis	级	zh-CN
jisd	罽	zh-CN
jise	缉	zh-CN
jisj	纪	zh-CN
jisk	给	zh-CN
jism	羁	zh-CN
jisr	绩	zh-CN
jit	圾	zh-CN
jitk	畸	zh-CN
jiu	吉	zh-CN
jiuj	饥	zh-CN
jiuk	吉	zh-CN
jiur	赍	zh-CN
jiuy	屐	zh-CN
jiv	己	zh-CN
jivb	箕	zh-CN
jivk	笄	zh-CN
jivo	籍	zh-CN
jiw	剂	zh-CN
jiwd	剂	zh-CN
jiwl	齑	zh-CN
jix	悸	zh-CN
jixz	悸	zh-CN
jiy	记	zh-CN
jiyj	讥	zh-CN
jiyk	诘	zh-CN
jiyl	霁	zh-CN
jiyn	鸡	zh-CN
jiyt	畿	zh-CN
jiz	迹	zh-CN
jizl	跻	zh-CN
jizo	蹐	zh-CN
jizx	跽	zh-CN
jka	井	zh-CN
jkal	井	zh-CN
jkax	鲸	zh-CN
jkb	痉	zh-CN
jkbg	痉	zh-CN
jkc	敬	zh-CN
jkcd	荆	zh-CN
jkcg	茎	zh-CN
jkck	警	zh-CN
jkco	菁	zh-CN
jkcw	敬	zh-CN
jkd	净	zh-CN
jkdg	泾	zh-CN
jkdj	汫	zh-CN
jkdl	净	zh-CN
jke	阱	zh-CN
jkej	阱	zh-CN
jkf	静	zh-CN
jkfe	靓	zh-CN
jkfl	静	zh-CN
jkfn	䴖	zh-CN
jkfu	旌	zh-CN
jkgx	麖	zh-CN
jki	径	zh-CN
jkj	镜	zh-CN
jkje	镜	zh-CN
jkjo	鼱	zh-CN
jkl	竟	zh-CN
jkle	竞	zh-CN
jkm	精	zh-CN
jkmg	粳	zh-CN
jkn	婧	zh-CN
jkno	婧	zh-CN
jko	晶	zh-CN
jkog	胫	zh-CN
jkoj	肼	zh-CN
jkoo	睛	zh-CN
jkox	景	zh-CN
jkq	獍	zh-CN
jkqe	獍	zh-CN
jkqx	猄	zh-CN
jkr	儆	zh-CN
jkrw	儆	zh-CN
jkrx	倞	zh-CN
jks	经	zh-CN
jksg	经	zh-CN
jkt	境	zh-CN
jkte	境	zh-CN
jku	兢	zh-CN
jkv	劲	zh-CN
jkvd	刭	zh-CN
jkvr	颈	zh-CN
jkw	京	zh-CN
jkwx	璟	zh-CN
jkx	惊	zh-CN
jkz	迳	zh-CN
jla	豇	zh-CN
jlac	鳉	zh-CN
jlag	豇	zh-CN
jlc	蒋	zh-CN
jlcc	蒋	zh-CN
jlcg	茳	zh-CN
jld	江	zh-CN
jldd	奖	zh-CN
jldg	江	zh-CN
jldl	洚	zh-CN
jldm	桨	zh-CN
jldu	浆	zh-CN
jldy	酱	zh-CN
jle	降	zh-CN
jlel	降	zh-CN
jlg	疆	zh-CN
jlga	疆	zh-CN
jlgi	强	zh-CN
jlgn	犟	zh-CN
jlgx	弶	zh-CN
jlk	匠	zh-CN
jlkj	匠	zh-CN
jll	耩	zh-CN
jllr	耩	zh-CN
jlm	糨	zh-CN
jlmi	糨	zh-CN
jlo	膙	zh-CN
jloi	膙	zh-CN
jlr	僵	zh-CN
jlra	僵	zh-CN
jls	缰	zh-CN
jlsa	缰	zh-CN
jlsl	绛	zh-CN
jlu	礓	zh-CN
jlua	礓	zh-CN
jly	讲	zh-CN
jlyn	姜	zh-CN
jma	柬	zh-CN
jmad	戋	zh-CN
jman	鳒	zh-CN
jmat	鲣	zh-CN
jmb	兼	zh-CN
jmbd	剪	zh-CN
jmbn	鹣	zh-CN
jmbr	蹇	zh-CN
jmbx	翦	zh-CN
jmc	荐	zh-CN
jmci	茧	zh-CN
jmck	菅	zh-CN
jmcn	蒹	zh-CN
jmcz	荐	zh-CN
jmd	减	zh-CN
jmdd	湔	zh-CN
jmdj	渐	zh-CN
jmdo	涧	zh-CN
jmdq	歼	zh-CN
jmf	捡	zh-CN
jmfd	拣	zh-CN
jmfn	搛	zh-CN
jmg	鞯	zh-CN
jmgg	靬	zh-CN
jmgz	鞬	zh-CN
jmh	肩	zh-CN
jmj	键	zh-CN
jmjo	锏	zh-CN
jmjz	键	zh-CN
jmk	见	zh-CN
jmkj	贱	zh-CN
jml	坚	zh-CN
jmlj	鉴	zh-CN
jmm	检	zh-CN
jmme	枧	zh-CN
jmmz	毽	zh-CN
jmn	奸	zh-CN
jmng	奸	zh-CN
jmnz	犍	zh-CN
jmo	腱	zh-CN
jmoa	睑	zh-CN
jmoj	暕	zh-CN
jmoz	腱	zh-CN
jmp	裥	zh-CN
jmpo	裥	zh-CN
jmr	件	zh-CN
jmra	俭	zh-CN
jmrd	剑	zh-CN
jmrn	牮	zh-CN
jmrz	健	zh-CN
jms	缄	zh-CN
jmsk	缄	zh-CN
jmsn	缣	zh-CN
jmu	碱	zh-CN
jmuj	饯	zh-CN
jmuk	碱	zh-CN
jmv	简	zh-CN
jmvd	箭	zh-CN
jmve	舰	zh-CN
jmvj	笺	zh-CN
jmvo	简	zh-CN
jmx	尖	zh-CN
jmxd	尖	zh-CN
jmy	谏	zh-CN
jmyd	谫	zh-CN
jmyg	艰	zh-CN
jmz	建	zh-CN
jmzj	践	zh-CN
jmzk	趼	zh-CN
jmzy	建	zh-CN
jmzz	踺	zh-CN
jna	鲛	zh-CN
jnau	斠	zh-CN
jnax	鲛	zh-CN
jnb	窖	zh-CN
jnbc	皭	zh-CN
jnbx	皎	zh-CN
jnc	蕉	zh-CN
jncb	藠	zh-CN
jncj	艽	zh-CN
jncx	茭	zh-CN
jnd	角	zh-CN
jndh	湫	zh-CN
jndw	浇	zh-CN
jndy	角	zh-CN
jne	峤	zh-CN
jnex	峧	zh-CN
jnf	搅	zh-CN
jnfe	搅	zh-CN
jni	较	zh-CN
jnil	轿	zh-CN
jniw	徼	zh-CN
jnix	蛟	zh-CN
jnj	铰	zh-CN
jnk	嚼	zh-CN
jnkc	嚼	zh-CN
jnkh	噍	zh-CN
jnl	教	zh-CN
jnlw	教	zh-CN
jnm	骄	zh-CN
jnml	骄	zh-CN
jnmx	校	zh-CN
jnmy	椒	zh-CN
jnn	娇	zh-CN
jnnx	姣	zh-CN
jno	脚	zh-CN
jnoe	脚	zh-CN
jnox	胶	zh-CN
jnq	狡	zh-CN
jnqx	狡	zh-CN
jnr	焦	zh-CN
jnrn	鹪	zh-CN
jnrw	侥	zh-CN
jnrx	佼	zh-CN
jns	缴	zh-CN
jnsw	缴	zh-CN
jnsx	绞	zh-CN
jnu	礁	zh-CN
jnul	矫	zh-CN
jnux	饺	zh-CN
jnv	剿	zh-CN
jnvd	剿	zh-CN
jnw	交	zh-CN
jnwe	郊	zh-CN
jnwn	䴔	zh-CN
jnwx	交	zh-CN
jnx	觉	zh-CN
jnxe	觉	zh-CN
jny	酵	zh-CN
jnz	跤	zh-CN
jnzx	跤	zh-CN
jpa	鲒	zh-CN
jpak	鲒	zh-CN
jpb	皆	zh-CN
jpbb	皆	zh-CN
jpbe	疖	zh-CN
jpbl	疥	zh-CN
jpc	节	zh-CN
jpce	节	zh-CN
jpcl	芥	zh-CN
jpco	藉	zh-CN
jpd	洁	zh-CN
jpdb	湝	zh-CN
jpdn	解	zh-CN
jpe	阶	zh-CN
jpel	阶	zh-CN
jpf	揭	zh-CN
jpfk	拮	zh-CN
jpfn	㛃	zh-CN
jpfr	捷	zh-CN
jpfv	揭	zh-CN
jpfx	絜	zh-CN
jpg	戒	zh-CN
jph	秸	zh-CN
jpi	街	zh-CN
jpil	蚧	zh-CN
jpkb	喈	zh-CN
jpkg	嗟	zh-CN
jpl	竭	zh-CN
jpm	杰	zh-CN
jpmb	楷	zh-CN
jpmh	杰	zh-CN
jpmk	桔	zh-CN
jpmn	檞	zh-CN
jpn	姐	zh-CN
jpnq	姐	zh-CN
jpnr	婕	zh-CN
jpo	睫	zh-CN
jpor	睫	zh-CN
jpr	借	zh-CN
jprl	介	zh-CN
jpro	借	zh-CN
jprv	偈	zh-CN
jps	结	zh-CN
jpsk	结	zh-CN
jpt	界	zh-CN
jptl	劫	zh-CN
jpu	截	zh-CN
jpuf	截	zh-CN
jpul	劼	zh-CN
jpur	颉	zh-CN
jpuv	碣	zh-CN
jpuy	届	zh-CN
jpv	孑	zh-CN
jpva	孑	zh-CN
jpwl	玠	zh-CN
jpx	桀	zh-CN
jpxc	悈	zh-CN
jpy	诫	zh-CN
jpyg	讦	zh-CN
jpyv	羯	zh-CN
jqa	鬏	zh-CN
jqah	鬏	zh-CN
jqb	究	zh-CN
jqd	酒	zh-CN
jqdj	氿	zh-CN
jqdy	酒	zh-CN
jqe	㠇	zh-CN
jqey	㠇	zh-CN
jqf	揪	zh-CN
jqfa	韭	zh-CN
jqi	厩	zh-CN
jqiv	厩	zh-CN
jqj	舅	zh-CN
jqjh	灸	zh-CN
jqjn	鸠	zh-CN
jqk	啾	zh-CN
jqkh	啾	zh-CN
jql	旧	zh-CN
jqlo	旧	zh-CN
jqm	柩	zh-CN
jqmj	桕	zh-CN
jqmv	阄	zh-CN
jqp	九	zh-CN
jqpa	臼	zh-CN
jqpn	久	zh-CN
jqpv	九	zh-CN
jqq	救	zh-CN
jqqw	救	zh-CN
jqry	僦	zh-CN
jqs	纠	zh-CN
jqsl	纠	zh-CN
jqt	赳	zh-CN
jqtl	赳	zh-CN
jqw	玖	zh-CN
jqwk	咎	zh-CN
jqwn	鹫	zh-CN
jqwy	就	zh-CN
jrb	蠲	zh-CN
jrbi	蠲	zh-CN
jrd	涓	zh-CN
jrdo	涓	zh-CN
jrf	捐	zh-CN
jrfo	捐	zh-CN
jrho	焆	zh-CN
jrj	眷	zh-CN
jrjm	桊	zh-CN
jrjn	镌	zh-CN
jrk	鹃	zh-CN
jrkn	鹃	zh-CN
jrkv	圈	zh-CN
jrn	娟	zh-CN
jrno	娟	zh-CN
jrq	狷	zh-CN
jrqo	狷	zh-CN
jrr	倦	zh-CN
jrrn	隽	zh-CN
jrrv	倦	zh-CN
jrs	绢	zh-CN
jrxe	鄄	zh-CN
jsb	窘	zh-CN
jsbk	窘	zh-CN
jsdk	泂	zh-CN
jsh	炯	zh-CN
jshk	扃	zh-CN
jskk	冏	zh-CN
jsmk	𬳶	zh-CN
jso	炅	zh-CN
jsoh	䐃	zh-CN
jss	䌹	zh-CN
jssk	䌹	zh-CN
jst	坰	zh-CN
jstk	坰	zh-CN
jsz	迥	zh-CN
jszk	迥	zh-CN
jtc	蕨	zh-CN
jtcr	蕨	zh-CN
jtd	决	zh-CN
jtdg	觖	zh-CN
jtdy	角	zh-CN
jte	崛	zh-CN
jtei	崛	zh-CN
jtf	掘	zh-CN
jtfg	抉	zh-CN
jtfi	掘	zh-CN
jtfr	撅	zh-CN
jtfy	攫	zh-CN
jth	爝	zh-CN
jti	厥	zh-CN
jtid	劂	zh-CN
jtir	厥	zh-CN
jtjr	镢	zh-CN
jtk	嚼	zh-CN
jtkc	嚼	zh-CN
jtkr	噘	zh-CN
jtku	噱	zh-CN
jtm	桷	zh-CN
jtmr	橛	zh-CN
jtmy	桷	zh-CN
jto	矍	zh-CN
jtoy	矍	zh-CN
jtp	爵	zh-CN
jtpc	爵	zh-CN
jtq	獗	zh-CN
jtqr	獗	zh-CN
jtqy	玃	zh-CN
jtr	倔	zh-CN
jtrf	傕	zh-CN
jtri	倔	zh-CN
jts	绝	zh-CN
jtu	砄	zh-CN
jtv	孓	zh-CN
jtvn	孓	zh-CN
jtw	玦	zh-CN
jtwy	珏	zh-CN
jtx	觉	zh-CN
jtxe	觉	zh-CN
jty	诀	zh-CN
jtyg	诀	zh-CN
jtyk	谲	zh-CN
jtz	蹶	zh-CN
jtzr	蹶	zh-CN
jua	车	zh-CN
juak	𬶋	zh-CN
jual	车	zh-CN
jub	句	zh-CN
jubn	窭	zh-CN
jubq	疽	zh-CN
juc	菊	zh-CN
juck	莒	zh-CN
jucm	菊	zh-CN
jucq	苴	zh-CN
jud	沮	zh-CN
judk	泃	zh-CN
jue	聚	zh-CN
juej	岠	zh-CN
juek	崌	zh-CN
juen	聚	zh-CN
jueq	岨	zh-CN
juf	拒	zh-CN
jufk	拘	zh-CN
jufm	掬	zh-CN
jug	鞠	zh-CN
jugk	鞫	zh-CN
jugm	鞠	zh-CN
juh	炬	zh-CN
juhj	秬	zh-CN
juhk	焗	zh-CN
juj	锯	zh-CN
jujj	钜	zh-CN
jujk	锔	zh-CN
juk	巨	zh-CN
juka	巨	zh-CN
jukq	咀	zh-CN
jul	且	zh-CN
jula	且	zh-CN
jum	橘	zh-CN
jumj	柜	zh-CN
jumk	桔	zh-CN
juml	榉	zh-CN
junb	犋	zh-CN
juny	娵	zh-CN
juof	瞿	zh-CN
juok	腒	zh-CN
juon	䴗	zh-CN
jup	裾	zh-CN
jupk	裾	zh-CN
juq	具	zh-CN
juqf	雎	zh-CN
juqq	狙	zh-CN
jur	俱	zh-CN
jurb	俱	zh-CN
jurk	倨	zh-CN
jut	趄	zh-CN
jutc	弆	zh-CN
juu	局	zh-CN
juud	剧	zh-CN
juuj	矩	zh-CN
juuk	居	zh-CN
juun	屦	zh-CN
juuq	砠	zh-CN
juv	龃	zh-CN
juvk	筥	zh-CN
juw	琚	zh-CN
jux	举	zh-CN
juy	醵	zh-CN
juyj	讵	zh-CN
juz	距	zh-CN
juzk	踞	zh-CN
juzy	踽	zh-CN
jxa	夹	zh-CN
jxag	戛	zh-CN
jxan	夹	zh-CN
jxb	家	zh-CN
jxbk	痂	zh-CN
jxby	瘕	zh-CN
jxc	荚	zh-CN
jxck	茄	zh-CN
jxcy	葭	zh-CN
jxd	浃	zh-CN
jxe	岬	zh-CN
jxej	岬	zh-CN
jxf	恝	zh-CN
jxfx	恝	zh-CN
jxh	稼	zh-CN
jxi	蛱	zh-CN
jxj	钾	zh-CN
jxje	郏	zh-CN
jxjj	铗	zh-CN
jxjr	颊	zh-CN
jxku	斝	zh-CN
jxl	架	zh-CN
jxll	甲	zh-CN
jxlm	驾	zh-CN
jxly	袈	zh-CN
jxm	枷	zh-CN
jxmr	槚	zh-CN
jxn	嫁	zh-CN
jxo	胛	zh-CN
jxoj	胛	zh-CN
jxr	假	zh-CN
jxrk	伽	zh-CN
jxrl	价	zh-CN
jxrt	佳	zh-CN
jxu	嘉	zh-CN
jxv	笳	zh-CN
jxvk	笳	zh-CN
jxw	珈	zh-CN
jxwk	珈	zh-CN
jxx	贾	zh-CN
jxxr	贾	zh-CN
jxz	迦	zh-CN
jxzk	跏	zh-CN
jyak	鲪	zh-CN
jyb	军	zh-CN
jybi	军	zh-CN
jyby	皲	zh-CN
jyc	菌	zh-CN
jych	菌	zh-CN
jyck	莙	zh-CN
jycw	葰	zh-CN
jyd	龟	zh-CN
jydw	浚	zh-CN
jye	峻	zh-CN
jyew	峻	zh-CN
jyfk	捃	zh-CN
jyg	麇	zh-CN
jyh	焌	zh-CN
jyj	钧	zh-CN
jyjd	钧	zh-CN
jyl	竣	zh-CN
jym	骏	zh-CN
jyo	晙	zh-CN
jyow	晙	zh-CN
jyr	俊	zh-CN
jyrn	隽	zh-CN
jyrw	俊	zh-CN
jyt	鋆	zh-CN
jytd	均	zh-CN
jytw	畯	zh-CN
jyv	筠	zh-CN
jyvd	筠	zh-CN
jywk	珺	zh-CN
jyy	君	zh-CN
jyye	郡	zh-CN
k	可	zh-CN
kak	咖	zh-CN
kakb	咔	zh-CN
kakk	喀	zh-CN
kao	胩	zh-CN
kaob	胩	zh-CN
kau	卡	zh-CN
kaub	卡	zh-CN
kcd	洘	zh-CN
kcdv	洘	zh-CN
kcf	拷	zh-CN
kcfv	拷	zh-CN
kch	烤	zh-CN
kchf	㸆	zh-CN
kchv	烤	zh-CN
kcj	铐	zh-CN
kcjv	铐	zh-CN
kcl	考	zh-CN
kcm	栲	zh-CN
kcmv	栲	zh-CN
kcn	犒	zh-CN
kcnf	靠	zh-CN
kcnk	犒	zh-CN
kcu	尻	zh-CN
kda	开	zh-CN
kdac	开	zh-CN
kdc	蒈	zh-CN
kdcb	蒈	zh-CN
kde	凯	zh-CN
kded	剀	zh-CN
kdej	凯	zh-CN
kdf	揩	zh-CN
kdfb	揩	zh-CN
kdh	炌	zh-CN
kdjb	锴	zh-CN
kdjj	铠	zh-CN
kdjk	锎	zh-CN
kdm	楷	zh-CN
kdmb	楷	zh-CN
kdt	垲	zh-CN
kdx	慨	zh-CN
kdxj	恺	zh-CN
kdxq	忾	zh-CN
kdxv	慨	zh-CN
keb	客	zh-CN
kebg	窠	zh-CN
kebk	疴	zh-CN
kec	苛	zh-CN
keck	苛	zh-CN
ked	渴	zh-CN
kedk	可	zh-CN
kedm	溘	zh-CN
kee	岢	zh-CN
keek	岢	zh-CN
keg	颗	zh-CN
kegg	髁	zh-CN
keh	科	zh-CN
kehg	稞	zh-CN
kehk	炣	zh-CN
kei	轲	zh-CN
keik	轲	zh-CN
keiu	蝌	zh-CN
kej	锞	zh-CN
kejg	锞	zh-CN
kek	咳	zh-CN
kekk	呵	zh-CN
kekm	嗑	zh-CN
kekr	咳	zh-CN
kem	棵	zh-CN
kemg	骒	zh-CN
kemk	柯	zh-CN
keo	瞌	zh-CN
keom	瞌	zh-CN
kep	牁	zh-CN
kepk	牁	zh-CN
keq	氪	zh-CN
keqe	氪	zh-CN
kes	缂	zh-CN
kesg	缂	zh-CN
ket	坷	zh-CN
keu	壳	zh-CN
keue	克	zh-CN
keuj	壳	zh-CN
keum	磕	zh-CN
kew	刻	zh-CN
kewk	珂	zh-CN
kewr	颏	zh-CN
kex	恪	zh-CN
key	课	zh-CN
keyg	课	zh-CN
kfg	恳	zh-CN
kfgt	垦	zh-CN
kfk	啃	zh-CN
kfko	啃	zh-CN
kfp	裉	zh-CN
kfpg	裉	zh-CN
kfv	龈	zh-CN
kfvg	龈	zh-CN
kfvo	肯	zh-CN
kgj	铿	zh-CN
kgjt	铿	zh-CN
kgk	吭	zh-CN
kgkj	吭	zh-CN
kgt	坑	zh-CN
kgu	硁	zh-CN
kha	𩾌	zh-CN
khan	𩾌	zh-CN
khf	扛	zh-CN
khfg	扛	zh-CN
khfj	抗	zh-CN
khg	康	zh-CN
khgn	康	zh-CN
khh	炕	zh-CN
khj	钪	zh-CN
khjj	钪	zh-CN
khm	糠	zh-CN
khmj	闶	zh-CN
khmn	糠	zh-CN
khr	伉	zh-CN
khrj	伉	zh-CN
kht	𡐓	zh-CN
khtn	𡐓	zh-CN
khw	亢	zh-CN
khwj	亢	zh-CN
khx	慷	zh-CN
khxn	慷	zh-CN
kjc	莰	zh-CN
kjcr	莰	zh-CN
kje	崁	zh-CN
kjer	崁	zh-CN
kjev	嵁	zh-CN
kjg	刊	zh-CN
kjgd	刊	zh-CN
kjii	衎	zh-CN
kjm	槛	zh-CN
kjmm	槛	zh-CN
kjmw	阚	zh-CN
kjo	瞰	zh-CN
kjow	瞰	zh-CN
kjq	勘	zh-CN
kjqg	戡	zh-CN
kjql	勘	zh-CN
kjr	侃	zh-CN
kjrl	龛	zh-CN
kjrv	侃	zh-CN
kjt	坎	zh-CN
kjtl	墈	zh-CN
kjtr	坎	zh-CN
kjtv	堪	zh-CN
kju	砍	zh-CN
kjul	磡	zh-CN
kjuo	看	zh-CN
kjur	砍	zh-CN
kka	鲙	zh-CN
kkas	鲙	zh-CN
kkc	蒯	zh-CN
kkcd	蒯	zh-CN
kkd	浍	zh-CN
kkds	浍	zh-CN
kkf	㧟	zh-CN
kkfk	㧟	zh-CN
kkk	哙	zh-CN
kkks	哙	zh-CN
kko	脍	zh-CN
kkos	脍	zh-CN
kkq	狯	zh-CN
kkqs	狯	zh-CN
kkr	会	zh-CN
kkre	郐	zh-CN
kkrs	侩	zh-CN
kkt	块	zh-CN
kktg	块	zh-CN
kkv	筷	zh-CN
kkvg	筷	zh-CN
kkxg	快	zh-CN
kld	夼	zh-CN
klde	况	zh-CN
kldi	夼	zh-CN
kldw	洭	zh-CN
klg	邝	zh-CN
klge	邝	zh-CN
klk	匡	zh-CN
klkw	哐	zh-CN
klm	框	zh-CN
klmw	框	zh-CN
klo	旷	zh-CN
klog	旷	zh-CN
klow	眶	zh-CN
klq	狂	zh-CN
klqn	𫛭	zh-CN
klqw	狂	zh-CN
kls	纩	zh-CN
klsg	纩	zh-CN
klt	圹	zh-CN
kltg	圹	zh-CN
klu	矿	zh-CN
klug	矿	zh-CN
klv	筐	zh-CN
klvw	筐	zh-CN
kly	诳	zh-CN
klyw	诓	zh-CN
kof	括	zh-CN
kofg	扩	zh-CN
kofk	括	zh-CN
kog	廓	zh-CN
koge	廓	zh-CN
koi	蛞	zh-CN
koik	蛞	zh-CN
kom	阔	zh-CN
komk	栝	zh-CN
krb	宽	zh-CN
krbe	宽	zh-CN
krg	髋	zh-CN
krge	髋	zh-CN
kru	款	zh-CN
krur	款	zh-CN
ksbg	空	zh-CN
kse	崆	zh-CN
kseg	崆	zh-CN
ksf	控	zh-CN
ksfg	控	zh-CN
ksg	恐	zh-CN
ksgx	恐	zh-CN
ksr	倥	zh-CN
ksrg	倥	zh-CN
kstg	埪	zh-CN
ksu	硿	zh-CN
ksug	硿	zh-CN
ksv	箜	zh-CN
ksvg	箜	zh-CN
ksz	孔	zh-CN
kszv	孔	zh-CN
kub	窟	zh-CN
kuc	苦	zh-CN
kuck	苦	zh-CN
kud	刳	zh-CN
kug	库	zh-CN
kugi	库	zh-CN
kugk	骷	zh-CN
kuk	哭	zh-CN
kukf	圐	zh-CN
kukq	哭	zh-CN
kum	枯	zh-CN
kup	裤	zh-CN
kupi	裤	zh-CN
kus	绔	zh-CN
kusk	绔	zh-CN
kuu	矻	zh-CN
kuuq	矻	zh-CN
kux	喾	zh-CN
kuy	酷	zh-CN
kuyk	酷	zh-CN
kvb	窥	zh-CN
kvbe	窥	zh-CN
kvbw	夔	zh-CN
kvc	葵	zh-CN
kvcr	蒉	zh-CN
kvct	葵	zh-CN
kvd	溃	zh-CN
kvdr	溃	zh-CN
kvdt	奎	zh-CN
kve	岿	zh-CN
kvee	岿	zh-CN
kveg	隗	zh-CN
kver	聩	zh-CN
kvev	亏	zh-CN
kvf	揆	zh-CN
kvft	揆	zh-CN
kvg	魁	zh-CN
kvgu	魁	zh-CN
kvh	煃	zh-CN
kvht	煃	zh-CN
kvi	蝰	zh-CN
kvit	蝰	zh-CN
kvj	馗	zh-CN
kvk	匮	zh-CN
kvko	喟	zh-CN
kvkr	匮	zh-CN
kvkt	喹	zh-CN
kvmt	骙	zh-CN
kvmu	櫆	zh-CN
kvo	睽	zh-CN
kvot	暌	zh-CN
kvr	傀	zh-CN
kvrg	傀	zh-CN
kvu	盔	zh-CN
kvum	盔	zh-CN
kvur	馈	zh-CN
kvv	篑	zh-CN
kvvg	戣	zh-CN
kvvr	篑	zh-CN
kvx	愧	zh-CN
kvxg	愧	zh-CN
kvxl	悝	zh-CN
kvxr	愦	zh-CN
kvz	逵	zh-CN
kvzt	跬	zh-CN
kwud	剋	zh-CN
kxdk	夸	zh-CN
kxf	挎	zh-CN
kxfk	挎	zh-CN
kxn	姱	zh-CN
kxnk	姱	zh-CN
kxo	胯	zh-CN
kxok	胯	zh-CN
kxr	侉	zh-CN
kxrk	侉	zh-CN
kxt	垮	zh-CN
kxtk	垮	zh-CN
kxz	跨	zh-CN
kxzk	跨	zh-CN
kya	鲲	zh-CN
kyab	鲲	zh-CN
kyaw	髡	zh-CN
kyf	捆	zh-CN
kyfm	捆	zh-CN
kyft	堃	zh-CN
kyh	焜	zh-CN
kyhb	焜	zh-CN
kyj	锟	zh-CN
kyjb	锟	zh-CN
kykm	困	zh-CN
kymm	阃	zh-CN
kynb	婫	zh-CN
kyo	昆	zh-CN
kyob	昆	zh-CN
kyon	鹍	zh-CN
kypi	裈	zh-CN
kyt	坤	zh-CN
kytu	坤	zh-CN
kyu	壸	zh-CN
kyuy	壸	zh-CN
kyw	琨	zh-CN
kywb	琨	zh-CN
kyxm	悃	zh-CN
kyyb	醌	zh-CN
kzb	寇	zh-CN
kzby	寇	zh-CN
kzc	蔻	zh-CN
kzcv	芤	zh-CN
kzcy	蔻	zh-CN
kzf	扣	zh-CN
kzfk	扣	zh-CN
kzfx	抠	zh-CN
kzgx	𫸩	zh-CN
kzk	叩	zh-CN
kzl	口	zh-CN
kzla	口	zh-CN
kzo	眍	zh-CN
kzox	眍	zh-CN
kzv	筘	zh-CN
kzvk	筘	zh-CN
l	了	zh-CN
laad	𬶟	zh-CN
lab	瘌	zh-CN
labd	瘌	zh-CN
lac	落	zh-CN
lack	落	zh-CN
lafl	拉	zh-CN
lag	鞡	zh-CN
lagl	鞡	zh-CN
lai	蜡	zh-CN
laid	蝲	zh-CN
laio	蜡	zh-CN
laj	镴	zh-CN
lajv	镴	zh-CN
lak	啦	zh-CN
lakl	啦	zh-CN
lal	辣	zh-CN
lalu	辣	zh-CN
lao	腊	zh-CN
laoj	旯	zh-CN
laoo	腊	zh-CN
lat	垃	zh-CN
latl	垃	zh-CN
lau	剌	zh-CN
laud	剌	zh-CN
laul	砬	zh-CN
laz	邋	zh-CN
lazv	邋	zh-CN
lba	鳞	zh-CN
lbal	鳞	zh-CN
lbc	蔺	zh-CN
lbcf	蔺	zh-CN
lbd	淋	zh-CN
lbdl	潾	zh-CN
lbdm	淋	zh-CN
lbdx	凛	zh-CN
lbe	嶙	zh-CN
lbel	嶙	zh-CN
lbf	拎	zh-CN
lbfs	拎	zh-CN
lbg	麟	zh-CN
lbgl	麟	zh-CN
lbgx	廪	zh-CN
lbi	辚	zh-CN
lbk	啉	zh-CN
lbkm	啉	zh-CN
lbl	临	zh-CN
lbm	粼	zh-CN
lbmv	粼	zh-CN
lbmx	檩	zh-CN
lbo	瞵	zh-CN
lbol	膦	zh-CN
lbr	邻	zh-CN
lbre	邻	zh-CN
lbrr	赁	zh-CN
lbu	磷	zh-CN
lbul	磷	zh-CN
lbvm	箖	zh-CN
lbw	琳	zh-CN
lbwk	吝	zh-CN
lbwl	璘	zh-CN
lbwm	琳	zh-CN
lbxx	懔	zh-CN
lby	霖	zh-CN
lbym	霖	zh-CN
lbz	躏	zh-CN
lbzf	躏	zh-CN
lbzl	遴	zh-CN
lcb	牢	zh-CN
lcbl	痨	zh-CN
lcc	劳	zh-CN
lccb	荖	zh-CN
lcck	落	zh-CN
lccl	劳	zh-CN
lcd	涝	zh-CN
lcdl	涝	zh-CN
lcdx	潦	zh-CN
lce	崂	zh-CN
lcel	崂	zh-CN
lcf	捞	zh-CN
lcfl	捞	zh-CN
lch	烙	zh-CN
lchk	烙	zh-CN
lcj	铑	zh-CN
lcjb	铑	zh-CN
lcjl	铹	zh-CN
lck	唠	zh-CN
lckl	唠	zh-CN
lcl	耢	zh-CN
lclb	老	zh-CN
lcll	耢	zh-CN
lcm	栳	zh-CN
lcmb	栳	zh-CN
lcn	姥	zh-CN
lcnb	姥	zh-CN
lcnp	嫪	zh-CN
lcp	乐	zh-CN
lcr	佬	zh-CN
lcrb	佬	zh-CN
lcs	络	zh-CN
lcsk	络	zh-CN
lctl	𫭼	zh-CN
lcy	酪	zh-CN
lcyp	醪	zh-CN
lda	来	zh-CN
ldan	来	zh-CN
ldb	癞	zh-CN
ldbr	癞	zh-CN
ldc	莱	zh-CN
ldcl	莱	zh-CN
ldd	濑	zh-CN
lddl	涞	zh-CN
lddr	濑	zh-CN
lde	崃	zh-CN
ldel	崃	zh-CN
ldi	徕	zh-CN
ldlr	赉	zh-CN
ldm	梾	zh-CN
ldml	梾	zh-CN
ldo	睐	zh-CN
ldol	睐	zh-CN
ldrl	俫	zh-CN
ldu	赖	zh-CN
ldur	赖	zh-CN
ldv	籁	zh-CN
ldvr	籁	zh-CN
lea	鳓	zh-CN
leal	鳓	zh-CN
led	泐	zh-CN
ledl	泐	zh-CN
leg	勒	zh-CN
legl	勒	zh-CN
lek	嘞	zh-CN
lekl	叻	zh-CN
leo	肋	zh-CN
leol	肋	zh-CN
lep	乐	zh-CN
lepd	乐	zh-CN
ler	仂	zh-CN
lerl	仂	zh-CN
leu	饹	zh-CN
leuk	饹	zh-CN
lev	簕	zh-CN
levl	了	zh-CN
lge	崚	zh-CN
lgew	崚	zh-CN
lgm	楞	zh-CN
lgmw	棱	zh-CN
lgt	塄	zh-CN
lgtf	塄	zh-CN
lgtw	堎	zh-CN
lgx	愣	zh-CN
lgxf	愣	zh-CN
lhc	莨	zh-CN
lhcl	蒗	zh-CN
lhco	蓢	zh-CN
lhd	郎	zh-CN
lhde	郎	zh-CN
lhdl	浪	zh-CN
lhdm	㮾	zh-CN
lhdo	朗	zh-CN
lhdt	塱	zh-CN
lhe	崀	zh-CN
lhel	崀	zh-CN
lhg	廊	zh-CN
lhge	廊	zh-CN
lhh	烺	zh-CN
lhhl	稂	zh-CN
lhi	螂	zh-CN
lhie	螂	zh-CN
lhjl	锒	zh-CN
lhk	啷	zh-CN
lhke	啷	zh-CN
lhm	榔	zh-CN
lhme	榔	zh-CN
lhml	阆	zh-CN
lho	㫰	zh-CN
lhol	㫰	zh-CN
lhq	狼	zh-CN
lhql	狼	zh-CN
lhtl	埌	zh-CN
lhvl	筤	zh-CN
lhw	琅	zh-CN
lhwl	琅	zh-CN
lia	丽	zh-CN
liaa	鳢	zh-CN
liad	丽	zh-CN
lial	鲤	zh-CN
lib	痢	zh-CN
libl	疬	zh-CN
libw	疠	zh-CN
lic	莉	zh-CN
licl	莅	zh-CN
licu	藜	zh-CN
lid	漓	zh-CN
lida	澧	zh-CN
lidl	沥	zh-CN
lidm	溧	zh-CN
lie	峛	zh-CN
lied	峛	zh-CN
liel	𫵷	zh-CN
lih	利	zh-CN
lihh	黧	zh-CN
lihm	梨	zh-CN
lihn	犁	zh-CN
lihq	戾	zh-CN
lihu	黎	zh-CN
lii	历	zh-CN
liid	蜊	zh-CN
liil	励	zh-CN
liiw	厉	zh-CN
lij	锂	zh-CN
lik	哩	zh-CN
likl	喱	zh-CN
likq	唳	zh-CN
lil	郦	zh-CN
lila	里	zh-CN
lim	李	zh-CN
liml	粒	zh-CN
limu	㰀	zh-CN
limw	粝	zh-CN
limz	李	zh-CN
lin	娌	zh-CN
linl	娌	zh-CN
lip	礼	zh-CN
lipv	礼	zh-CN
liq	狸	zh-CN
liqd	猁	zh-CN
liql	狸	zh-CN
lir	例	zh-CN
lird	俐	zh-CN
lirl	俪	zh-CN
lirm	傈	zh-CN
lis	罹	zh-CN
lisd	缡	zh-CN
lisf	罹	zh-CN
lisk	詈	zh-CN
lit	坜	zh-CN
litl	坜	zh-CN
liu	砾	zh-CN
liuw	砺	zh-CN
liv	力	zh-CN
livd	篱	zh-CN
livl	笠	zh-CN
livm	篥	zh-CN
livn	隶	zh-CN
livp	力	zh-CN
liw	离	zh-CN
liwa	立	zh-CN
liwl	理	zh-CN
liwn	嫠	zh-CN
lix	栗	zh-CN
liy	雳	zh-CN
liya	醴	zh-CN
liyd	醨	zh-CN
liyl	雳	zh-CN
liz	逦	zh-CN
lizl	跞	zh-CN
ljb	兰	zh-CN
ljbs	兰	zh-CN
ljc	蓝	zh-CN
ljcm	蓝	zh-CN
ljd	滥	zh-CN
ljdj	澜	zh-CN
lje	岚	zh-CN
ljex	岚	zh-CN
ljf	拦	zh-CN
ljfe	揽	zh-CN
ljfs	拦	zh-CN
ljh	烂	zh-CN
ljhs	烂	zh-CN
ljj	镧	zh-CN
ljjj	镧	zh-CN
ljl	览	zh-CN
ljm	栏	zh-CN
ljme	榄	zh-CN
ljmj	阑	zh-CN
ljmn	婪	zh-CN
ljms	栏	zh-CN
ljp	褴	zh-CN
ljpj	襕	zh-CN
ljs	缆	zh-CN
ljsg	罱	zh-CN
ljue	𬒗	zh-CN
ljv	篮	zh-CN
ljvm	篮	zh-CN
ljw	斓	zh-CN
ljwj	斓	zh-CN
ljx	懒	zh-CN
ljxr	懒	zh-CN
ljy	谰	zh-CN
ljyj	谰	zh-CN
lka	鲮	zh-CN
lkaw	鲮	zh-CN
lkc	菱	zh-CN
lkcs	苓	zh-CN
lkcw	菱	zh-CN
lkd	凌	zh-CN
lkdw	凌	zh-CN
lke	岭	zh-CN
lkeh	灵	zh-CN
lkes	聆	zh-CN
lkew	陵	zh-CN
lki	蛉	zh-CN
lkis	蛉	zh-CN
lkj	铃	zh-CN
lkjs	铃	zh-CN
lkk	呤	zh-CN
lkkl	另	zh-CN
lkm	棱	zh-CN
lkmh	棂	zh-CN
lkms	柃	zh-CN
lkmw	棱	zh-CN
lkn	姈	zh-CN
lkns	姈	zh-CN
lkos	昤	zh-CN
lkp	祾	zh-CN
lkpw	祾	zh-CN
lkr	令	zh-CN
lkrn	鸰	zh-CN
lkrr	领	zh-CN
lkrs	伶	zh-CN
lkrw	瓴	zh-CN
lkrx	翎	zh-CN
lks	绫	zh-CN
lksw	绫	zh-CN
lkt	坽	zh-CN
lkv	龄	zh-CN
lkvs	舲	zh-CN
lkw	玲	zh-CN
lkws	玲	zh-CN
lkxw	㥄	zh-CN
lky	零	zh-CN
lkye	酃	zh-CN
lla	两	zh-CN
llad	两	zh-CN
llc	莨	zh-CN
llcl	𬜯	zh-CN
lld	梁	zh-CN
lldg	良	zh-CN
lldx	凉	zh-CN
llf	靓	zh-CN
llfe	靓	zh-CN
llg	魉	zh-CN
lli	辆	zh-CN
llil	辆	zh-CN
llix	辌	zh-CN
llm	粮	zh-CN
llml	粮	zh-CN
llmx	椋	zh-CN
llo	量	zh-CN
llol	量	zh-CN
llox	晾	zh-CN
llr	俩	zh-CN
llrl	俍	zh-CN
llsx	𫟅	zh-CN
llt	墚	zh-CN
llw	亮	zh-CN
llx	悢	zh-CN
lly	谅	zh-CN
llz	踉	zh-CN
llzl	踉	zh-CN
lma	鲢	zh-CN
lmaj	𬶠	zh-CN
lmaz	鲢	zh-CN
lmb	帘	zh-CN
lmc	莲	zh-CN
lmcw	蔹	zh-CN
lmcz	莲	zh-CN
lmd	殓	zh-CN
lmdn	濂	zh-CN
lmdw	潋	zh-CN
lmdx	奁	zh-CN
lmdz	涟	zh-CN
lme	联	zh-CN
lmet	联	zh-CN
lmg	廉	zh-CN
lmgn	廉	zh-CN
lmh	炼	zh-CN
lmhd	炼	zh-CN
lmi	蠊	zh-CN
lmin	蠊	zh-CN
lmj	链	zh-CN
lmjn	镰	zh-CN
lmjz	链	zh-CN
lmm	楝	zh-CN
lmmz	梿	zh-CN
lmo	脸	zh-CN
lmoa	脸	zh-CN
lmp	裢	zh-CN
lmpa	裣	zh-CN
lmpz	裢	zh-CN
lmr	敛	zh-CN
lmrw	敛	zh-CN
lms	练	zh-CN
lmun	磏	zh-CN
lmw	恋	zh-CN
lmwj	瑓	zh-CN
lmwx	恋	zh-CN
lmwz	琏	zh-CN
lmx	怜	zh-CN
lmxs	怜	zh-CN
lna	鹩	zh-CN
lnan	鹩	zh-CN
lnb	疗	zh-CN
lnbp	寥	zh-CN
lnbx	寮	zh-CN
lnc	蓼	zh-CN
lncp	蓼	zh-CN
lnd	潦	zh-CN
lndn	鹩	zh-CN
lndp	漻	zh-CN
lne	聊	zh-CN
lnee	聊	zh-CN
lnf	撩	zh-CN
lnfk	撂	zh-CN
lnfx	撩	zh-CN
lng	廖	zh-CN
lngp	髎	zh-CN
lnh	燎	zh-CN
lnhx	燎	zh-CN
lnj	镣	zh-CN
lnjl	钌	zh-CN
lnjx	镣	zh-CN
lnk	嘹	zh-CN
lnkx	嘹	zh-CN
lnm	料	zh-CN
lnmu	料	zh-CN
lnmx	橑	zh-CN
lnnx	嫽	zh-CN
lno	瞭	zh-CN
lnox	瞭	zh-CN
lnq	獠	zh-CN
lnqx	獠	zh-CN
lnr	僚	zh-CN
lnrx	僚	zh-CN
lns	缭	zh-CN
lnsx	缭	zh-CN
lntp	𪤗	zh-CN
lnu	尥	zh-CN
lnuu	尥	zh-CN
lnv	了	zh-CN
lnvl	了	zh-CN
lnvx	簝	zh-CN
lnx	憭	zh-CN
lny	尥	zh-CN
lnz	辽	zh-CN
lnzl	辽	zh-CN
lnzx	蹽	zh-CN
lob	瘰	zh-CN
lobx	瘰	zh-CN
loc	萝	zh-CN
locg	蓏	zh-CN
lock	落	zh-CN
locn	荦	zh-CN
locx	萝	zh-CN
lod	洛	zh-CN
lodl	泺	zh-CN
lodx	漯	zh-CN
lof	摞	zh-CN
lofc	捋	zh-CN
lofx	摞	zh-CN
loh	烙	zh-CN
lohk	烙	zh-CN
loi	螺	zh-CN
loix	螺	zh-CN
loj	锣	zh-CN
lojx	锣	zh-CN
lok	咯	zh-CN
lokk	咯	zh-CN
lokx	啰	zh-CN
lom	骡	zh-CN
lomk	骆	zh-CN
lomx	椤	zh-CN
loo	脶	zh-CN
loon	脶	zh-CN
lop	裸	zh-CN
lopg	裸	zh-CN
loq	猡	zh-CN
loqx	猡	zh-CN
lor	倮	zh-CN
lorg	倮	zh-CN
los	罗	zh-CN
losk	络	zh-CN
losx	罗	zh-CN
lou	硌	zh-CN
louk	硌	zh-CN
lov	箩	zh-CN
lovx	箩	zh-CN
low	雒	zh-CN
lowk	珞	zh-CN
loz	逻	zh-CN
lozl	跞	zh-CN
lozx	逻	zh-CN
lpa	鬣	zh-CN
lpav	𫚭	zh-CN
lpd	裂	zh-CN
lpdd	冽	zh-CN
lpdh	烈	zh-CN
lpdn	䴕	zh-CN
lpdy	裂	zh-CN
lpf	捩	zh-CN
lpfq	捩	zh-CN
lpk	咧	zh-CN
lpo	脟	zh-CN
lpoc	脟	zh-CN
lpq	猎	zh-CN
lpqo	猎	zh-CN
lpt	趔	zh-CN
lptc	埒	zh-CN
lptd	趔	zh-CN
lpu	劣	zh-CN
lpul	劣	zh-CN
lpz	躐	zh-CN
lqb	瘤	zh-CN
lqbt	瘤	zh-CN
lqd	流	zh-CN
lqdd	浏	zh-CN
lqdj	鎏	zh-CN
lqdt	溜	zh-CN
lqdy	瑬	zh-CN
lqe	陆	zh-CN
lqej	陆	zh-CN
lqf	旒	zh-CN
lqfv	旒	zh-CN
lqh	熘	zh-CN
lqht	熘	zh-CN
lqj	镏	zh-CN
lqjp	镠	zh-CN
lqjt	飗	zh-CN
lqjv	锍	zh-CN
lqm	柳	zh-CN
lqme	柳	zh-CN
lqmt	榴	zh-CN
lqp	留	zh-CN
lqpn	鹠	zh-CN
lqpt	留	zh-CN
lqs	绺	zh-CN
lqsk	绺	zh-CN
lqst	罶	zh-CN
lqtp	疁	zh-CN
lqu	硫	zh-CN
lqut	馏	zh-CN
lqw	六	zh-CN
lqwb	六	zh-CN
lqwd	刘	zh-CN
lqwe	珋	zh-CN
lqwv	琉	zh-CN
lqx	鹨	zh-CN
lqz	遛	zh-CN
lqzt	遛	zh-CN
lrd	滦	zh-CN
lrdm	滦	zh-CN
lrp	卵	zh-CN
lrpd	卵	zh-CN
lrq	乱	zh-CN
lrqv	乱	zh-CN
lrw	鸾	zh-CN
lrwe	峦	zh-CN
lrwj	銮	zh-CN
lrwm	栾	zh-CN
lrwn	娈	zh-CN
lrwr	脔	zh-CN
lrwu	挛	zh-CN
lrwz	孪	zh-CN
lsb	窿	zh-CN
lsbu	癃	zh-CN
lscl	茏	zh-CN
lsd	泷	zh-CN
lsdl	泷	zh-CN
lsdu	漋	zh-CN
lse	隆	zh-CN
lsel	陇	zh-CN
lseu	隆	zh-CN
lsf	拢	zh-CN
lsfl	拢	zh-CN
lsk	咙	zh-CN
lskc	哢	zh-CN
lskl	咙	zh-CN
lsl	聋	zh-CN
lslt	垄	zh-CN
lslu	砻	zh-CN
lsm	栊	zh-CN
lsml	栊	zh-CN
lso	胧	zh-CN
lsol	眬	zh-CN
lsu	龙	zh-CN
lsud	龙	zh-CN
lsv	笼	zh-CN
lsvl	笼	zh-CN
lsvr	𬕂	zh-CN
lsw	弄	zh-CN
lswc	弄	zh-CN
lswl	珑	zh-CN
ltf	掠	zh-CN
ltfu	䂮	zh-CN
ltfx	掠	zh-CN
ltjc	锊	zh-CN
ltk	圙	zh-CN
ltkm	圙	zh-CN
ltt	略	zh-CN
lttk	略	zh-CN
lua	鲁	zh-CN
luao	鲁	zh-CN
luau	鲈	zh-CN
luc	芦	zh-CN
luck	蕗	zh-CN
lucp	蓼	zh-CN
lucu	菉	zh-CN
lud	泸	zh-CN
ludb	漉	zh-CN
ludk	潞	zh-CN
ludo	澛	zh-CN
ludu	渌	zh-CN
luej	陆	zh-CN
luf	撸	zh-CN
lufl	掳	zh-CN
lufo	撸	zh-CN
lug	鹿	zh-CN
lugb	鹿	zh-CN
lugh	庐	zh-CN
luh	炉	zh-CN
luhh	炉	zh-CN
luhl	虏	zh-CN
luht	稑	zh-CN
lui	轳	zh-CN
luib	辘	zh-CN
luik	辂	zh-CN
luj	镥	zh-CN
lujo	镥	zh-CN
luju	𬬻	zh-CN
luk	赂	zh-CN
luko	噜	zh-CN
lul	卢	zh-CN
luln	鸬	zh-CN
lulr	颅	zh-CN
lulx	卤	zh-CN
lum	橹	zh-CN
lumb	麓	zh-CN
lumo	氇	zh-CN
lumu	栌	zh-CN
luo	胪	zh-CN
luou	胪	zh-CN
lup	禄	zh-CN
lupu	禄	zh-CN
lupy	甪	zh-CN
lurp	僇	zh-CN
lus	绿	zh-CN
lut	垆	zh-CN
luu	碌	zh-CN
lue	录	zh-CN
luv	箓	zh-CN
luw	璐	zh-CN
luwk	璐	zh-CN
luwu	琭	zh-CN
lux	勠	zh-CN
luxg	戮	zh-CN
luy	露	zh-CN
luz	鹭	zh-CN
luzk	路	zh-CN
luzn	鹭	zh-CN
luzu	逯	zh-CN
lvcy	葎	zh-CN
lvd	滤	zh-CN
lvdx	滤	zh-CN
lvf	旅	zh-CN
lvfc	捋	zh-CN
lvfn	旅	zh-CN
lvfo	膂	zh-CN
lvh	虑	zh-CN
lvhk	稆	zh-CN
lvi	律	zh-CN
lviy	律	zh-CN
lvj	铝	zh-CN
lvk	吕	zh-CN
lvkk	吕	zh-CN
lvm	驴	zh-CN
lvmh	驴	zh-CN
lvmk	榈	zh-CN
lvo	𦝼	zh-CN
lvon	𦝼	zh-CN
lvp	褛	zh-CN
lvpn	褛	zh-CN
lvq	氯	zh-CN
lvqu	氯	zh-CN
lvr	侣	zh-CN
lvrk	侣	zh-CN
lvrn	偻	zh-CN
lvs	绿	zh-CN
lvsn	缕	zh-CN
lvsu	绿	zh-CN
lvty	垏	zh-CN
lvu	屡	zh-CN
lvun	屡	zh-CN
lvuw	履	zh-CN
lvw	率	zh-CN
lvwu	率	zh-CN
lwa	耒	zh-CN
lwan	耒	zh-CN
lwbt	癗	zh-CN
lwc	蕾	zh-CN
lwct	藟	zh-CN
lwd	泪	zh-CN
lwdo	泪	zh-CN
lwf	擂	zh-CN
lwfn	耒	zh-CN
lwft	擂	zh-CN
lwg	勒	zh-CN
lwj	镭	zh-CN
lwjt	镭	zh-CN
lwk	嘞	zh-CN
lwm	檑	zh-CN
lwmd	类	zh-CN
lwmt	檑	zh-CN
lwn	嫘	zh-CN
lwnx	嫘	zh-CN
lwo	肋	zh-CN
lwol	肋	zh-CN
lwr	儡	zh-CN
lwrt	儡	zh-CN
lws	垒	zh-CN
lwst	垒	zh-CN
lwsx	缧	zh-CN
lwt	累	zh-CN
lwtf	罍	zh-CN
lwtx	累	zh-CN
lwu	磊	zh-CN
lwut	礌	zh-CN
lwuu	磊	zh-CN
lww	羸	zh-CN
lwwf	羸	zh-CN
lwy	雷	zh-CN
lwyc	酹	zh-CN
lwyl	诔	zh-CN
lwyt	雷	zh-CN
lxr	俩	zh-CN
lxrl	俩	zh-CN
lyd	沦	zh-CN
lydb	沦	zh-CN
lyf	抡	zh-CN
lyfb	抡	zh-CN
lyi	轮	zh-CN
lyib	轮	zh-CN
lyjb	𬬭	zh-CN
lyk	囵	zh-CN
lykb	囵	zh-CN
lyr	伦	zh-CN
lyrb	仑	zh-CN
lys	纶	zh-CN
lysb	纶	zh-CN
lytb	𫭢	zh-CN
lyyb	论	zh-CN
lza	剅	zh-CN
lzad	剅	zh-CN
lzb	瘘	zh-CN
lzbn	瘘	zh-CN
lzc	蒌	zh-CN
lzcn	蒌	zh-CN
lzd	漏	zh-CN
lze	陋	zh-CN
lzen	嵝	zh-CN
lzev	陋	zh-CN
lzf	搂	zh-CN
lzfn	搂	zh-CN
lzg	髅	zh-CN
lzgn	髅	zh-CN
lzi	蝼	zh-CN
lzin	蝼	zh-CN
lzj	镂	zh-CN
lzjn	镂	zh-CN
lzk	喽	zh-CN
lzkn	喽	zh-CN
lzl	耧	zh-CN
lzln	耧	zh-CN
lzm	娄	zh-CN
lzmn	楼	zh-CN
lzo	䁖	zh-CN
lzon	䁖	zh-CN
lzr	偻	zh-CN
lztn	𪣻	zh-CN
lzv	篓	zh-CN
lzvn	篓	zh-CN
lzy	露	zh-CN
lzyk	露	zh-CN
m	没	zh-CN
maf	抹	zh-CN
mafm	抹	zh-CN
mag	麻	zh-CN
magm	麻	zh-CN
magu	摩	zh-CN
mai	蚂	zh-CN
maid	蟆	zh-CN
maim	蚂	zh-CN
mak	嘛	zh-CN
makm	骂	zh-CN
mam	杩	zh-CN
mamm	杩	zh-CN
man	妈	zh-CN
manm	妈	zh-CN
map	祃	zh-CN
maps	么	zh-CN
mapm	祃	zh-CN
maq	犸	zh-CN
maqm	犸	zh-CN
mau	码	zh-CN
maum	码	zh-CN
mav	马	zh-CN
maw	玛	zh-CN
mawm	玛	zh-CN
maz	孖	zh-CN
mazz	孖	zh-CN
mbc	苠	zh-CN
mbcm	苠	zh-CN
mbd	泯	zh-CN
mbdm	泯	zh-CN
mbdo	湣	zh-CN
mbe	岷	zh-CN
mbem	岷	zh-CN
mbf	抿	zh-CN
mbfm	抿	zh-CN
mbk	黾	zh-CN
mbkd	黾	zh-CN
mbl	皿	zh-CN
mbla	皿	zh-CN
mbm	闽	zh-CN
mbmi	闽	zh-CN
mbmw	闵	zh-CN
mbmx	愍	zh-CN
mbo	旻	zh-CN
mbow	旻	zh-CN
mbp	敏	zh-CN
mbpa	鳘	zh-CN
mbpw	敏	zh-CN
mbs	缗	zh-CN
mbso	缗	zh-CN
mbuo	碈	zh-CN
mbvv	民	zh-CN
mbw	玟	zh-CN
mbwm	珉	zh-CN
mbwx	忞	zh-CN
mbx	悯	zh-CN
mbxw	悯	zh-CN
mca	髦	zh-CN
mcam	髦	zh-CN
mcc	茂	zh-CN
mcce	茆	zh-CN
mccm	芼	zh-CN
mccp	茅	zh-CN
mccw	茂	zh-CN
mcd	泖	zh-CN
mcde	泖	zh-CN
mce	峁	zh-CN
mcee	峁	zh-CN
mcf	旄	zh-CN
mcfm	旄	zh-CN
mcj	帽	zh-CN
mcje	铆	zh-CN
mcjo	帽	zh-CN
mcjt	锚	zh-CN
mck	冒	zh-CN
mcko	冒	zh-CN
mcl	耄	zh-CN
mclm	耄	zh-CN
mcm	懋	zh-CN
mcmm	楙	zh-CN
mcmx	懋	zh-CN
mcn	牦	zh-CN
mcnm	牦	zh-CN
mco	冒	zh-CN
mcoe	昴	zh-CN
mcom	眊	zh-CN
mcoo	冒	zh-CN
mcp	贸	zh-CN
mcpe	卯	zh-CN
mcpr	贸	zh-CN
mcpv	毛	zh-CN
mcq	猫	zh-CN
mcqt	猫	zh-CN
mcs	矛	zh-CN
mcsi	蝥	zh-CN
mcso	瞀	zh-CN
mcsp	矛	zh-CN
mcv	貌	zh-CN
mcw	袤	zh-CN
mcwo	瑁	zh-CN
mcwy	袤	zh-CN
mdc	荬	zh-CN
mdf	麦	zh-CN
mdfw	麦	zh-CN
mdk	唛	zh-CN
mdkw	唛	zh-CN
mdo	脉	zh-CN
mdoy	脉	zh-CN
mdt	埋	zh-CN
mdtl	埋	zh-CN
mdu	卖	zh-CN
mdud	卖	zh-CN
mdvd	买	zh-CN
mdw	劢	zh-CN
mdwl	劢	zh-CN
mdy	霾	zh-CN
mdyl	霾	zh-CN
mdz	迈	zh-CN
mdzw	迈	zh-CN
mep	么	zh-CN
meps	么	zh-CN
mfd	门	zh-CN
mfdv	门	zh-CN
mfdx	懑	zh-CN
mff	扪	zh-CN
mffm	扪	zh-CN
mfh	焖	zh-CN
mfhx	焖	zh-CN
mfj	钔	zh-CN
mfjm	钔	zh-CN
mfm	闷	zh-CN
mfmx	闷	zh-CN
mfrm	们	zh-CN
mfwl	𫞩	zh-CN
mfwq	亹	zh-CN
mgc	萌	zh-CN
mgcn	蒙	zh-CN
mgco	瞢	zh-CN
mgcu	蒙	zh-CN
mgcw	甍	zh-CN
mge	㠓	zh-CN
mgen	㠓	zh-CN
mgeu	㠓	zh-CN
mgi	蜢	zh-CN
mgim	蜢	zh-CN
mgin	蠓	zh-CN
mgiu	蠓	zh-CN
mgiw	虻	zh-CN
mgj	锰	zh-CN
mgjn	幪	zh-CN
mgju	幪	zh-CN
mgk	𫑡	zh-CN
mgke	𫑡	zh-CN
mgm	檬	zh-CN
mgmn	檬	zh-CN
mgmu	檬	zh-CN
mgmx	梦	zh-CN
mgo	盟	zh-CN
mgom	盟	zh-CN
mgon	朦	zh-CN
mgou	朦	zh-CN
mgq	猛	zh-CN
mgqm	猛	zh-CN
mgqn	獴	zh-CN
mgqu	獴	zh-CN
mgu	礞	zh-CN
mgud	尨	zh-CN
mgun	礞	zh-CN
mguu	礞	zh-CN
mgv	艋	zh-CN
mgvm	艋	zh-CN
mgvn	艨	zh-CN
mgw	氓	zh-CN
mgwm	氓	zh-CN
mgx	懵	zh-CN
mgxo	懵	zh-CN
mgzl	勐	zh-CN
mgzm	孟	zh-CN
mhc	茫	zh-CN
mhcc	莽	zh-CN
mhcw	芒	zh-CN
mhd	漭	zh-CN
mhdc	漭	zh-CN
mhi	蟒	zh-CN
mhic	蟒	zh-CN
mhid	厖	zh-CN
mhmw	杧	zh-CN
mhn	牤	zh-CN
mhnd	牻	zh-CN
mhnw	牤	zh-CN
mhu	硭	zh-CN
mhud	尨	zh-CN
mhuw	硭	zh-CN
mhw	盲	zh-CN
mhwe	邙	zh-CN
mhwm	氓	zh-CN
mhwo	盲	zh-CN
mhx	忙	zh-CN
mib	蜜	zh-CN
mibb	宓	zh-CN
mibe	密	zh-CN
mibj	幂	zh-CN
mic	蘼	zh-CN
micf	蘼	zh-CN
mid	泌	zh-CN
midb	泌	zh-CN
midm	洣	zh-CN
mido	汨	zh-CN
mig	弥	zh-CN
mige	弭	zh-CN
migf	靡	zh-CN
migm	糜	zh-CN
migx	縻	zh-CN
mih	秘	zh-CN
mihb	秘	zh-CN
mik	咪	zh-CN
mike	嘧	zh-CN
mikm	咪	zh-CN
mil	芈	zh-CN
mill	芈	zh-CN
mim	敉	zh-CN
mimw	敉	zh-CN
mio	眯	zh-CN
miom	脒	zh-CN
mip	觅	zh-CN
mipb	祕	zh-CN
mipe	觅	zh-CN
mipx	祢	zh-CN
miq	猕	zh-CN
miqx	猕	zh-CN
miy	谜	zh-CN
miym	谧	zh-CN
miyz	醚	zh-CN
miz	迷	zh-CN
mizm	迷	zh-CN
mja	鳗	zh-CN
mjay	鬘	zh-CN
mjc	蔓	zh-CN
mjck	𬜬	zh-CN
mjcr	颟	zh-CN
mjcy	蔓	zh-CN
mjd	满	zh-CN
mjdl	满	zh-CN
mjdy	漫	zh-CN
mjg	鞔	zh-CN
mjgv	鞔	zh-CN
mji	螨	zh-CN
mjil	螨	zh-CN
mjj	幔	zh-CN
mjjy	镘	zh-CN
mjn	嫚	zh-CN
mjny	嫚	zh-CN
mjo	瞒	zh-CN
mjol	瞒	zh-CN
mjoy	曼	zh-CN
mjs	缦	zh-CN
mjtl	埋	zh-CN
mjty	墁	zh-CN
mju	馒	zh-CN
mjuy	馒	zh-CN
mjw	蛮	zh-CN
mjwi	蛮	zh-CN
mjx	慢	zh-CN
mjxy	慢	zh-CN
mjy	谩	zh-CN
mjyy	谩	zh-CN
mkb	冥	zh-CN
mkbb	冥	zh-CN
mkc	茗	zh-CN
mkcb	蓂	zh-CN
mkck	茗	zh-CN
mkd	溟	zh-CN
mkdb	溟	zh-CN
mkdk	洺	zh-CN
mki	螟	zh-CN
mkib	螟	zh-CN
mkj	铭	zh-CN
mkk	鸣	zh-CN
mkkn	鸣	zh-CN
mko	明	zh-CN
mkob	瞑	zh-CN
mkoo	明	zh-CN
mkr	命	zh-CN
mkre	命	zh-CN
mky	酩	zh-CN
mma	丏	zh-CN
mmaa	面	zh-CN
mmav	𩾃	zh-CN
mmd	免	zh-CN
mmdd	渑	zh-CN
mmdl	勉	zh-CN
mmk	冕	zh-CN
mmkd	黾	zh-CN
mmkv	冕	zh-CN
mmm	棉	zh-CN
mmmj	棉	zh-CN
mmml	勔	zh-CN
mmn	娩	zh-CN
mmnv	娩	zh-CN
mmo	眠	zh-CN
mmom	腼	zh-CN
mmov	冕	zh-CN
mmrm	偭	zh-CN
mms	绵	zh-CN
mmsj	绵	zh-CN
mmsm	缅	zh-CN
mmx	愐	zh-CN
mnc	苗	zh-CN
mnce	藐	zh-CN
mncn	鹋	zh-CN
mnct	苗	zh-CN
mnd	渺	zh-CN
mndu	渺	zh-CN
mnf	描	zh-CN
mnft	描	zh-CN
mng	庙	zh-CN
mnk	喵	zh-CN
mnkt	喵	zh-CN
mnm	杪	zh-CN
mnmu	杪	zh-CN
mnn	妙	zh-CN
mnnu	妙	zh-CN
mno	瞄	zh-CN
mnot	瞄	zh-CN
mnou	眇	zh-CN
mns	缈	zh-CN
mnsp	缪	zh-CN
mnsu	缈	zh-CN
mnu	淼	zh-CN
mnz	邈	zh-CN
mnze	邈	zh-CN
moa	万	zh-CN
moan	末	zh-CN
moap	万	zh-CN
moay	无	zh-CN
mob	寞	zh-CN
moc	莫	zh-CN
mocd	莫	zh-CN
mocm	蓦	zh-CN
mocu	摹	zh-CN
mod	漠	zh-CN
modm	沫	zh-CN
mody	殁	zh-CN
moe	陌	zh-CN
moeb	陌	zh-CN
mof	摸	zh-CN
mofd	摸	zh-CN
mofm	抹	zh-CN
mog	磨	zh-CN
mogg	魔	zh-CN
mogm	麽	zh-CN
moh	墨	zh-CN
mohm	秣	zh-CN
mohq	默	zh-CN
moht	墨	zh-CN
moj	镆	zh-CN
mojd	镆	zh-CN
moko	冒	zh-CN
mol	耱	zh-CN
mom	模	zh-CN
momd	模	zh-CN
mon	嬷	zh-CN
mond	嫫	zh-CN
moo	膜	zh-CN
mood	膜	zh-CN
mooo	冒	zh-CN
mooy	脉	zh-CN
mos	𬙊	zh-CN
most	𬙊	zh-CN
mou	馍	zh-CN
moud	馍	zh-CN
mov	貊	zh-CN
movb	貊	zh-CN
movd	貘	zh-CN
movk	貉	zh-CN
moy	谟	zh-CN
moyd	谟	zh-CN
mpa	灭	zh-CN
mpah	灭	zh-CN
mpc	蔑	zh-CN
mpcu	蔑	zh-CN
mpk	咩	zh-CN
mpky	咩	zh-CN
mpv	篾	zh-CN
mpvu	篾	zh-CN
mpvv	乜	zh-CN
mqs	缪	zh-CN
mqsp	缪	zh-CN
mqy	谬	zh-CN
mqyp	谬	zh-CN
mua	木	zh-CN
muan	木	zh-CN
muc	幕	zh-CN
mucj	幕	zh-CN
mucl	募	zh-CN
muco	暮	zh-CN
muct	墓	zh-CN
mucx	慕	zh-CN
mud	沐	zh-CN
mudm	沐	zh-CN
muf	拇	zh-CN
mufm	拇	zh-CN
muh	穆	zh-CN
muhp	穆	zh-CN
muj	钼	zh-CN
mujm	𬭁	zh-CN
mujo	钼	zh-CN
muk	目	zh-CN
muka	目	zh-CN
mum	模	zh-CN
mumd	模	zh-CN
mumn	毪	zh-CN
mun	姆	zh-CN
munb	姥	zh-CN
munt	牡	zh-CN
munw	牧	zh-CN
muo	睦	zh-CN
muot	睦	zh-CN
murm	仫	zh-CN
mus	牟	zh-CN
musn	牟	zh-CN
muu	木	zh-CN
muun	木	zh-CN
muv	母	zh-CN
muvd	母	zh-CN
muw	亩	zh-CN
muwt	亩	zh-CN
muzm	𧿹	zh-CN
mwb	寐	zh-CN
mwbw	寐	zh-CN
mwc	莓	zh-CN
mwcm	莓	zh-CN
mwd	湄	zh-CN
mwdo	湄	zh-CN
mwdv	浼	zh-CN
mwdy	没	zh-CN
mwe	嵋	zh-CN
mweo	嵋	zh-CN
mwg	魅	zh-CN
mwgm	糜	zh-CN
mwh	煤	zh-CN
mwhm	煤	zh-CN
mwj	镁	zh-CN
mwjd	镁	zh-CN
mwjo	镅	zh-CN
mwm	枚	zh-CN
mwmm	梅	zh-CN
mwmo	楣	zh-CN
mwn	妹	zh-CN
mwnd	媄	zh-CN
mwno	媚	zh-CN
mwnw	妹	zh-CN
mwo	昧	zh-CN
mwow	昧	zh-CN
mwp	袂	zh-CN
mwpg	袂	zh-CN
mwv	眉	zh-CN
mwvn	鹛	zh-CN
mwvo	眉	zh-CN
mww	玫	zh-CN
mwwo	瑂	zh-CN
mwy	霉	zh-CN
mwyd	美	zh-CN
mwym	酶	zh-CN
mzgm	某	zh-CN
mzi	蛑	zh-CN
mzin	蛑	zh-CN
mzk	哞	zh-CN
mzkm	呣	zh-CN
mzkn	哞	zh-CN
mzo	眸	zh-CN
mzon	眸	zh-CN
mzr	侔	zh-CN
mzrn	侔	zh-CN
mzs	牟	zh-CN
mzsj	鍪	zh-CN
mzsn	牟	zh-CN
mzsp	缪	zh-CN
mzy	谋	zh-CN
mzym	谋	zh-CN
n	你	zh-CN
nace	𦰡	zh-CN
naf	捺	zh-CN
nafx	捺	zh-CN
naj	钠	zh-CN
naju	镎	zh-CN
nak	哪	zh-CN
nakn	呐	zh-CN
nan	娜	zh-CN
nane	娜	zh-CN
nao	肭	zh-CN
naon	肭	zh-CN
nap	衲	zh-CN
napn	衲	zh-CN
nar	拿	zh-CN
nas	纳	zh-CN
nasn	纳	zh-CN
nau	南	zh-CN
naug	南	zh-CN
naym	乸	zh-CN
nbr	恁	zh-CN
nbrx	您	zh-CN
ncb	孬	zh-CN
ncbz	孬	zh-CN
ncd	淖	zh-CN
ncdu	淖	zh-CN
ncf	挠	zh-CN
ncfw	挠	zh-CN
nci	蛲	zh-CN
nciw	蛲	zh-CN
ncj	铙	zh-CN
ncjw	铙	zh-CN
nck	呶	zh-CN
ncky	呶	zh-CN
ncm	闹	zh-CN
ncmj	闹	zh-CN
nco	脑	zh-CN
ncoe	臑	zh-CN
ncok	脑	zh-CN
ncq	猱	zh-CN
ncqe	峱	zh-CN
ncqm	猱	zh-CN
nct	垴	zh-CN
nctk	垴	zh-CN
ncu	硇	zh-CN
ncux	硇	zh-CN
ncw	瑙	zh-CN
ncwx	瑙	zh-CN
ncx	恼	zh-CN
ncxk	恼	zh-CN
ndc	萘	zh-CN
ndcn	艿	zh-CN
ndcx	萘	zh-CN
ndd	奈	zh-CN
nddx	奈	zh-CN
nde	耐	zh-CN
ndec	耐	zh-CN
ndep	耏	zh-CN
ndm	柰	zh-CN
ndmx	柰	zh-CN
ndn	奶	zh-CN
ndnn	奶	zh-CN
ndnv	鼐	zh-CN
ndq	氖	zh-CN
ndqn	氖	zh-CN
ndr	佴	zh-CN
ndv	乃	zh-CN
ndvp	乃	zh-CN
ndzx	迺	zh-CN
nek	呐	zh-CN
nekb	呢	zh-CN
neke	哪	zh-CN
nekn	呐	zh-CN
ney	讷	zh-CN
neyn	讷	zh-CN
nfnd	媆	zh-CN
nfnw	嫩	zh-CN
nfr	恁	zh-CN
nfrx	恁	zh-CN
ngs	能	zh-CN
ngsb	能	zh-CN
nha	囊	zh-CN
nhay	囊	zh-CN
nhf	攮	zh-CN
nhfy	攮	zh-CN
nhk	囔	zh-CN
nhky	囔	zh-CN
nho	曩	zh-CN
nhoy	曩	zh-CN
nhuy	馕	zh-CN
nhzy	齉	zh-CN
nia	鲵	zh-CN
niae	鲵	zh-CN
nic	薿	zh-CN
nicr	薿	zh-CN
nid	溺	zh-CN
nidb	泥	zh-CN
nidd	溺	zh-CN
nie	𨺙	zh-CN
niee	𨺙	zh-CN
nif	拟	zh-CN
nifb	旎	zh-CN
nifr	拟	zh-CN
nige	麑	zh-CN
niie	𫐐	zh-CN
nij	铌	zh-CN
nijb	铌	zh-CN
nik	匿	zh-CN
nikb	呢	zh-CN
nikk	匿	zh-CN
nin	妮	zh-CN
ninb	妮	zh-CN
nio	腻	zh-CN
niob	昵	zh-CN
nioe	睨	zh-CN
nior	腻	zh-CN
niq	猊	zh-CN
niqe	猊	zh-CN
nir	倪	zh-CN
nirb	伲	zh-CN
nire	倪	zh-CN
nirx	你	zh-CN
nit	坭	zh-CN
nitb	坭	zh-CN
niu	尼	zh-CN
niub	尼	zh-CN
nive	𫠜	zh-CN
nix	怩	zh-CN
nixb	怩	zh-CN
niy	霓	zh-CN
niye	霓	zh-CN
niz	逆	zh-CN
nizp	逆	zh-CN
nja	南	zh-CN
njc	萳	zh-CN
njcg	萳	zh-CN
nji	蝻	zh-CN
njk	喃	zh-CN
njkg	喃	zh-CN
njkn	囡	zh-CN
njm	楠	zh-CN
njmg	楠	zh-CN
njn	婻	zh-CN
njng	婻	zh-CN
njo	腩	zh-CN
njog	腩	zh-CN
njt	男	zh-CN
njtl	男	zh-CN
njty	赧	zh-CN
nju	南	zh-CN
njyf	难	zh-CN
nkb	甯	zh-CN
nkbd	宁	zh-CN
nkby	甯	zh-CN
nkcd	苧	zh-CN
nkd	凝	zh-CN
nkdd	泞	zh-CN
nkdr	凝	zh-CN
nke	聍	zh-CN
nked	聍	zh-CN
nkf	拧	zh-CN
nkfd	拧	zh-CN
nkk	咛	zh-CN
nkm	柠	zh-CN
nkmd	柠	zh-CN
nkq	狞	zh-CN
nkqd	狞	zh-CN
nkr	佞	zh-CN
nkrn	佞	zh-CN
nln	娘	zh-CN
nly	酿	zh-CN
nlyl	酿	zh-CN
nma	廿	zh-CN
nmaa	廿	zh-CN
nmak	鲇	zh-CN
nmc	蔫	zh-CN
nmca	廿	zh-CN
nmch	蔫	zh-CN
nmf	撵	zh-CN
nmfi	辇	zh-CN
nmfk	拈	zh-CN
nmfx	捻	zh-CN
nmh	黏	zh-CN
nmi	辗	zh-CN
nmin	辗	zh-CN
nmm	粘	zh-CN
nmmk	粘	zh-CN
nmp	年	zh-CN
nmpl	年	zh-CN
nmr	念	zh-CN
nmrx	念	zh-CN
nmt	埝	zh-CN
nmtx	埝	zh-CN
nmu	碾	zh-CN
nmun	碾	zh-CN
nnc	茑	zh-CN
nncn	茑	zh-CN
nnd	溺	zh-CN
nndd	溺	zh-CN
nno	脲	zh-CN
nnou	脲	zh-CN
nnp	袅	zh-CN
nnpy	袅	zh-CN
nnu	尿	zh-CN
nnuu	尿	zh-CN
nnw	鸟	zh-CN
nnwd	鸟	zh-CN
noc	𦰡	zh-CN
noce	𦰡	zh-CN
nof	挪	zh-CN
nofd	搦	zh-CN
nofe	挪	zh-CN
noj	锘	zh-CN
nojk	锘	zh-CN
nok	喏	zh-CN
nokk	喏	zh-CN
nom	糯	zh-CN
nome	糯	zh-CN
non	娜	zh-CN
none	娜	zh-CN
nor	傩	zh-CN
norf	傩	zh-CN
nox	懦	zh-CN
noxe	懦	zh-CN
noy	诺	zh-CN
noyk	诺	zh-CN
npc	孽	zh-CN
npcm	蘖	zh-CN
npcx	菍	zh-CN
npcz	孽	zh-CN
npd	涅	zh-CN
npdt	涅	zh-CN
npe	聂	zh-CN
npem	嵲	zh-CN
nper	颞	zh-CN
npet	陧	zh-CN
npey	聂	zh-CN
npf	捏	zh-CN
npft	捏	zh-CN
npj	镍	zh-CN
npjm	镍	zh-CN
npjy	镊	zh-CN
npk	啮	zh-CN
npkk	啮	zh-CN
npky	嗫	zh-CN
npm	𫔶	zh-CN
npmm	𫔶	zh-CN
npv	乜	zh-CN
npvv	乜	zh-CN
npz	蹑	zh-CN
npzm	臬	zh-CN
npzy	蹑	zh-CN
nqf	扭	zh-CN
nqfi	扭	zh-CN
nqfl	拗	zh-CN
nqj	钮	zh-CN
nqji	钮	zh-CN
nqm	杻	zh-CN
nqmi	杻	zh-CN
nqn	妞	zh-CN
nqpl	牛	zh-CN
nqq	狃	zh-CN
nqs	纽	zh-CN
nqsi	纽	zh-CN
nqx	忸	zh-CN
nqxi	忸	zh-CN
nro	暖	zh-CN
nroy	暖	zh-CN
nsd	农	zh-CN
nsdn	浓	zh-CN
nsh	秾	zh-CN
nshn	秾	zh-CN
nsk	哝	zh-CN
nskn	哝	zh-CN
nso	脓	zh-CN
nson	脓	zh-CN
nsr	侬	zh-CN
nsrn	侬	zh-CN
nsw	弄	zh-CN
nswc	弄	zh-CN
nsy	𬪩	zh-CN
nsyn	𬪩	zh-CN
ntb	疟	zh-CN
ntba	疟	zh-CN
nth	虐	zh-CN
ntha	虐	zh-CN
nun	奴	zh-CN
nung	弩	zh-CN
nunl	努	zh-CN
nunm	驽	zh-CN
nunr	胬	zh-CN
nunu	砮	zh-CN
nunx	怒	zh-CN
nuny	奴	zh-CN
nunz	孥	zh-CN
nurc	傉	zh-CN
nuvy	笯	zh-CN
nvex	恧	zh-CN
nvj	钕	zh-CN
nvjn	钕	zh-CN
nvv	女	zh-CN
nvva	女	zh-CN
nvx	衄	zh-CN
nvxi	衄	zh-CN
nwk	哪	zh-CN
nwld	内	zh-CN
nwu	馁	zh-CN
nwun	馁	zh-CN
nwv	那	zh-CN
nwve	那	zh-CN
nzlc	耨	zh-CN
o	哦	zh-CN
ogk	唔	zh-CN
ogkx	嗯	zh-CN
ogkk	唔	zh-CN
omk	呣	zh-CN
omkm	呣	zh-CN
omkw	呒	zh-CN
onk	唔	zh-CN
onkx	嗯	zh-CN
onkk	唔	zh-CN
ook	噢	zh-CN
ookd	噢	zh-CN
ookt	喔	zh-CN
ookw	哦	zh-CN
ooky	嚄	zh-CN
ouc	藕	zh-CN
oucy	藕	zh-CN
oud	沤	zh-CN
oudx	沤	zh-CN
ouhx	𬉼	zh-CN
ouk	呕	zh-CN
oukn	鸥	zh-CN
oukr	欧	zh-CN
oukw	瓯	zh-CN
oukx	区	zh-CN
ouky	殴	zh-CN
oul	耦	zh-CN
oulk	𠙶	zh-CN
ouly	耦	zh-CN
our	偶	zh-CN
oury	偶	zh-CN
oux	怄	zh-CN
ouxx	怄	zh-CN
ouy	讴	zh-CN
ouyx	讴	zh-CN
p	平	zh-CN
pac	葩	zh-CN
pacb	葩	zh-CN
padb	潖	zh-CN
paf	扒	zh-CN
pafb	扒	zh-CN
paj	帕	zh-CN
pajb	帕	zh-CN
pak	啪	zh-CN
pakb	啪	zh-CN
pal	耙	zh-CN
palb	耙	zh-CN
pam	杷	zh-CN
pamb	杷	zh-CN
pav	爬	zh-CN
pavb	筢	zh-CN
paw	琶	zh-CN
pawb	琶	zh-CN
pax	怕	zh-CN
paxb	怕	zh-CN
paz	趴	zh-CN
pazb	趴	zh-CN
pbb	贫	zh-CN
pbbr	贫	zh-CN
pbcr	𬞟	zh-CN
pbe	聘	zh-CN
pbev	聘	zh-CN
pbf	拼	zh-CN
pbfk	拼	zh-CN
pbk	品	zh-CN
pbkk	品	zh-CN
pbn	嫔	zh-CN
pbnb	牝	zh-CN
pbnk	姘	zh-CN
pbv	频	zh-CN
pbvr	频	zh-CN
pbvu	颦	zh-CN
pbw	玭	zh-CN
pbwb	玭	zh-CN
pcb	刨	zh-CN
pcbd	刨	zh-CN
pcbs	疱	zh-CN
pcd	泡	zh-CN
pcf	抛	zh-CN
pcfl	抛	zh-CN
pcg	庖	zh-CN
pcgs	庖	zh-CN
pch	炮	zh-CN
pck	咆	zh-CN
pco	脬	zh-CN
pcoz	脬	zh-CN
pcp	袍	zh-CN
pcq	狍	zh-CN
pcqs	狍	zh-CN
pcz	跑	zh-CN
pczs	跑	zh-CN
pdc	蒎	zh-CN
pdcn	蒎	zh-CN
pdd	派	zh-CN
pddf	湃	zh-CN
pddn	派	zh-CN
pdf	拍	zh-CN
pdff	排	zh-CN
pdi	徘	zh-CN
pdif	徘	zh-CN
pdk	哌	zh-CN
pdkn	哌	zh-CN
pdp	牌	zh-CN
pdpu	牌	zh-CN
pdr	俳	zh-CN
pdz	迫	zh-CN
pdzb	迫	zh-CN
pfbm	盆	zh-CN
pfd	湓	zh-CN
pfdm	湓	zh-CN
pfk	喷	zh-CN
pfkr	喷	zh-CN
pgc	蓬	zh-CN
pgcf	芃	zh-CN
pgcz	蓬	zh-CN
pgd	澎	zh-CN
pgdo	淜	zh-CN
pgdp	澎	zh-CN
pgf	捧	zh-CN
pgff	搒	zh-CN
pgfl	捧	zh-CN
pgfp	抨	zh-CN
pggo	弸	zh-CN
pgi	蟛	zh-CN
pgip	蟛	zh-CN
pgk	嘭	zh-CN
pgkp	嘭	zh-CN
pgm	棚	zh-CN
pgmo	棚	zh-CN
pgmy	椪	zh-CN
pgo	朋	zh-CN
pgon	鹏	zh-CN
pgoo	朋	zh-CN
pgop	膨	zh-CN
pgt	堋	zh-CN
pgto	堋	zh-CN
pgu	彭	zh-CN
pguo	硼	zh-CN
pgup	砰	zh-CN
pguy	碰	zh-CN
pgv	篷	zh-CN
pgvz	篷	zh-CN
pgw	烹	zh-CN
pgwh	烹	zh-CN
pgx	怦	zh-CN
pgxp	怦	zh-CN
pha	鳑	zh-CN
phaf	鳑	zh-CN
phd	滂	zh-CN
phdf	滂	zh-CN
phg	庞	zh-CN
phi	螃	zh-CN
phif	彷	zh-CN
phl	耪	zh-CN
phlf	耪	zh-CN
pho	胖	zh-CN
phob	胖	zh-CN
phof	膀	zh-CN
phq	乓	zh-CN
phqd	乓	zh-CN
phu	磅	zh-CN
phuf	磅	zh-CN
phw	旁	zh-CN
phwf	旁	zh-CN
phy	雱	zh-CN
phyf	雱	zh-CN
phz	逄	zh-CN
phzl	逄	zh-CN
piay	鲏	zh-CN
pib	疲	zh-CN
piba	丕	zh-CN
pibe	邳	zh-CN
pibk	痞	zh-CN
pibu	癖	zh-CN
piby	疲	zh-CN
picb	芘	zh-CN
pice	苉	zh-CN
pid	淠	zh-CN
pidu	澼	zh-CN
pie	陂	zh-CN
pieu	陴	zh-CN
piey	陂	zh-CN
pif	披	zh-CN
pifb	批	zh-CN
pify	披	zh-CN
pii	蜱	zh-CN
piib	蚍	zh-CN
piiu	蜱	zh-CN
pij	铍	zh-CN
pijy	铍	zh-CN
pik	啤	zh-CN
pikb	吡	zh-CN
pike	匹	zh-CN
piku	噼	zh-CN
pim	枇	zh-CN
pima	𬳵	zh-CN
pimp	𬳵	zh-CN
pin	媲	zh-CN
pinb	媲	zh-CN
pio	脾	zh-CN
piou	睥	zh-CN
pip	郫	zh-CN
pipe	邳	zh-CN
pipu	裨	zh-CN
piqp	狉	zh-CN
pir	僻	zh-CN
pirb	仳	zh-CN
pirp	伾	zh-CN
pis	纰	zh-CN
pisb	纰	zh-CN
pish	罴	zh-CN
pit	坯	zh-CN
pitb	毗	zh-CN
pitj	圮	zh-CN
pitp	坯	zh-CN
pitu	埤	zh-CN
piu	屁	zh-CN
piub	砒	zh-CN
piud	劈	zh-CN
piuk	譬	zh-CN
piun	䴙	zh-CN
piuu	辟	zh-CN
piuw	甓	zh-CN
piv	皮	zh-CN
pivb	貔	zh-CN
piw	琵	zh-CN
piwb	琵	zh-CN
piy	霹	zh-CN
pjb	判	zh-CN
pjbd	判	zh-CN
pjby	叛	zh-CN
pjd	潘	zh-CN
pjdb	泮	zh-CN
pjdt	潘	zh-CN
pji	蟠	zh-CN
pjit	蟠	zh-CN
pjm	攀	zh-CN
pjmu	攀	zh-CN
pjo	盼	zh-CN
pjob	胖	zh-CN
pjod	盼	zh-CN
pjp	襻	zh-CN
pjpb	袢	zh-CN
pjpt	番	zh-CN
pjpu	襻	zh-CN
pjt	畔	zh-CN
pjtb	畔	zh-CN
pjut	磻	zh-CN
pjv	磐	zh-CN
pjvm	槃	zh-CN
pjvp	爿	zh-CN
pjvu	磐	zh-CN
pjz	蹒	zh-CN
pjzl	蹒	zh-CN
pka	平	zh-CN
pkap	鲆	zh-CN
pkau	平	zh-CN
pkb	瓶	zh-CN
pkc	萍	zh-CN
pkck	荓	zh-CN
pkcp	苹	zh-CN
pkd	洴	zh-CN
pkdp	泙	zh-CN
pkdv	涄	zh-CN
pkip	蚲	zh-CN
pkm	枰	zh-CN
pkmp	枰	zh-CN
pkn	娉	zh-CN
pknv	娉	zh-CN
pkq	乒	zh-CN
pkqp	乒	zh-CN
pkr	俜	zh-CN
pkrj	凭	zh-CN
pkt	坪	zh-CN
pktp	坪	zh-CN
pku	屏	zh-CN
pkuk	屏	zh-CN
pkwp	玶	zh-CN
pky	评	zh-CN
pkyp	评	zh-CN
pmh	扁	zh-CN
pmhx	翩	zh-CN
pmm	骗	zh-CN
pmmc	骗	zh-CN
pmmg	楩	zh-CN
pmmk	骈	zh-CN
pmn	犏	zh-CN
pmnc	犏	zh-CN
pmng	㛹	zh-CN
pmo	胼	zh-CN
pmok	胼	zh-CN
pmpv	片	zh-CN
pmr	偏	zh-CN
pmrc	偏	zh-CN
pmrg	便	zh-CN
pmtc	𡎚	zh-CN
pmv	篇	zh-CN
pmvc	篇	zh-CN
pmy	谝	zh-CN
pmz	蹁	zh-CN
pmzc	蹁	zh-CN
pnc	薸	zh-CN
pncx	薸	zh-CN
pnd	漂	zh-CN
pndx	漂	zh-CN
pndz	殍	zh-CN
pni	螵	zh-CN
pnix	螵	zh-CN
pnk	嘌	zh-CN
pnkx	嘌	zh-CN
pnm	朴	zh-CN
pnmb	朴	zh-CN
pnmx	骠	zh-CN
pnn	嫖	zh-CN
pnnx	嫖	zh-CN
pno	瞟	zh-CN
pnox	瞟	zh-CN
pns	缥	zh-CN
pnsx	缥	zh-CN
pnx	飘	zh-CN
pnxd	剽	zh-CN
pnxg	瓢	zh-CN
pnxx	飘	zh-CN
pob	魄	zh-CN
pobg	魄	zh-CN
pobt	皤	zh-CN
pod	泼	zh-CN
podb	泊	zh-CN
podd	泼	zh-CN
podn	婆	zh-CN
poe	陂	zh-CN
poey	陂	zh-CN
poj	钋	zh-CN
pojd	䥽	zh-CN
pojk	钷	zh-CN
pok	叵	zh-CN
pokk	叵	zh-CN
pom	粕	zh-CN
pomb	朴	zh-CN
pop	鄱	zh-CN
pope	鄱	zh-CN
popx	繁	zh-CN
pot	坡	zh-CN
poty	坡	zh-CN
pou	破	zh-CN
pouy	破	zh-CN
pov	颇	zh-CN
povk	笸	zh-CN
povr	颇	zh-CN
pow	珀	zh-CN
powb	珀	zh-CN
poyd	酦	zh-CN
poz	迫	zh-CN
pozb	迫	zh-CN
ppc	苤	zh-CN
ppcp	苤	zh-CN
ppd	瞥	zh-CN
ppdo	瞥	zh-CN
ppf	撇	zh-CN
ppfw	撇	zh-CN
ppjw	𬭯	zh-CN
ppq	氕	zh-CN
ppqp	氕	zh-CN
pub	匍	zh-CN
pubf	匍	zh-CN
pubo	普	zh-CN
puc	蒲	zh-CN
pucf	葡	zh-CN
puck	菩	zh-CN
pud	瀑	zh-CN
pudc	溥	zh-CN
pudf	浦	zh-CN
pudn	濮	zh-CN
pudo	潽	zh-CN
puf	扑	zh-CN
pufb	扑	zh-CN
puh	穙	zh-CN
puhn	穙	zh-CN
puj	铺	zh-CN
pujn	镤	zh-CN
pujo	镨	zh-CN
puk	噗	zh-CN
pukf	圃	zh-CN
pukn	噗	zh-CN
pum	朴	zh-CN
pumb	朴	zh-CN
pumo	氆	zh-CN
puo	曝	zh-CN
puof	脯	zh-CN
puou	暴	zh-CN
pur	仆	zh-CN
purb	仆	zh-CN
purt	堡	zh-CN
put	埔	zh-CN
putn	墣	zh-CN
puw	璞	zh-CN
puwn	璞	zh-CN
puy	谱	zh-CN
puyf	酺	zh-CN
puyo	谱	zh-CN
puz	蹼	zh-CN
puzn	蹼	zh-CN
pwd	沛	zh-CN
pwdl	沛	zh-CN
pwdr	𬇙	zh-CN
pwe	陪	zh-CN
pwek	陪	zh-CN
pwf	裴	zh-CN
pwfl	旆	zh-CN
pwfy	裴	zh-CN
pwj	帔	zh-CN
pwjk	锫	zh-CN
pwjy	帔	zh-CN
pwk	赔	zh-CN
pwka	呸	zh-CN
pwkk	赔	zh-CN
pwkp	呸	zh-CN
pwo	胚	zh-CN
pwop	胚	zh-CN
pwr	佩	zh-CN
pwrj	佩	zh-CN
pws	辔	zh-CN
pwsk	辔	zh-CN
pwt	培	zh-CN
pwtk	培	zh-CN
pwxb	衃	zh-CN
pwy	霈	zh-CN
pwyk	醅	zh-CN
pwyl	霈	zh-CN
pzf	抔	zh-CN
pzfb	抔	zh-CN
pzfk	掊	zh-CN
pzl	剖	zh-CN
pzld	剖	zh-CN
pzw	裒	zh-CN
pzwy	裒	zh-CN
q	去	zh-CN
qbb	寝	zh-CN
qbby	寝	zh-CN
qbc	芹	zh-CN
qbcj	芹	zh-CN
qbcv	芩	zh-CN
qbd	沁	zh-CN
qbdh	溱	zh-CN
qbdx	沁	zh-CN
qbe	嵚	zh-CN
qbf	秦	zh-CN
qbfd	擒	zh-CN
qbfh	秦	zh-CN
qbfr	揿	zh-CN
qbga	廑	zh-CN
qbj	钦	zh-CN
qbjy	锓	zh-CN
qbk	噙	zh-CN
qbkd	噙	zh-CN
qbkh	嗪	zh-CN
qbm	檎	zh-CN
qbmd	檎	zh-CN
qbmy	骎	zh-CN
qbn	勤	zh-CN
qbr	侵	zh-CN
qbrd	禽	zh-CN
qbry	衾	zh-CN
qbs	矜	zh-CN
qbw	琴	zh-CN
qbwv	琴	zh-CN
qbx	覃	zh-CN
qbxa	慬	zh-CN
qbxu	覃	zh-CN
qia	七	zh-CN
qiab	鲯	zh-CN
qiad	戚	zh-CN
qiae	郪	zh-CN
qian	妻	zh-CN
qiao	鳍	zh-CN
qiav	七	zh-CN
qic	蕲	zh-CN
qicb	萁	zh-CN
qice	葺	zh-CN
qick	䓫	zh-CN
qicl	荠	zh-CN
qicn	萋	zh-CN
qicu	芪	zh-CN
qid	柒	zh-CN
qidb	淇	zh-CN
qidk	奇	zh-CN
qidl	泣	zh-CN
qidn	凄	zh-CN
qidq	汽	zh-CN
qie	岂	zh-CN
qiej	屺	zh-CN
qiek	崎	zh-CN
qiel	亓	zh-CN
qiey	岐	zh-CN
qif	旗	zh-CN
qifb	旗	zh-CN
qifd	契	zh-CN
qig	麒	zh-CN
qigb	麒	zh-CN
qih	启	zh-CN
qihm	棨	zh-CN
qii	蛴	zh-CN
qiib	蜞	zh-CN
qij	颀	zh-CN
qijk	锜	zh-CN
qijr	颀	zh-CN
qik	器	zh-CN
qikk	器	zh-CN
qikx	嘁	zh-CN
qil	耆	zh-CN
qila	亟	zh-CN
qim	骑	zh-CN
qimj	杞	zh-CN
qimx	栖	zh-CN
qin	婍	zh-CN
qink	婍	zh-CN
qio	脐	zh-CN
qiol	脐	zh-CN
qip	气	zh-CN
qipb	祺	zh-CN
qipe	祁	zh-CN
qipv	乞	zh-CN
qiq	欺	zh-CN
qiqb	其	zh-CN
qiqo	期	zh-CN
qiqx	綦	zh-CN
qir	企	zh-CN
qirv	企	zh-CN
qis	绮	zh-CN
qisk	绮	zh-CN
qit	起	zh-CN
qitj	圻	zh-CN
qitt	畦	zh-CN
qiu	砌	zh-CN
qiud	碶	zh-CN
qiue	𨙸	zh-CN
qiuk	呇	zh-CN
qiur	碛	zh-CN
qiux	磜	zh-CN
qiv	歧	zh-CN
qivy	歧	zh-CN
qiw	齐	zh-CN
qiwb	琪	zh-CN
qiwc	弃	zh-CN
qiwj	玘	zh-CN
qiwk	琦	zh-CN
qiwl	齐	zh-CN
qiwx	戚	zh-CN
qix	愭	zh-CN
qixo	愭	zh-CN
qiy	讫	zh-CN
qiyq	讫	zh-CN
qiz	蹊	zh-CN
qizk	踦	zh-CN
qizq	迄	zh-CN
qizy	跂	zh-CN
qka	鲭	zh-CN
qkao	鲭	zh-CN
qkb	顷	zh-CN
qkbr	顷	zh-CN
qkc	擎	zh-CN
qkck	苘	zh-CN
qkcm	檠	zh-CN
qkcu	擎	zh-CN
qkd	清	zh-CN
qkdo	清	zh-CN
qkf	青	zh-CN
qkfo	青	zh-CN
qkg	庆	zh-CN
qkgd	庆	zh-CN
qkh	黥	zh-CN
qki	轻	zh-CN
qkio	蜻	zh-CN
qkko	圊	zh-CN
qkl	亲	zh-CN
qko	晴	zh-CN
qkoo	晴	zh-CN
qkp	卿	zh-CN
qkpe	卿	zh-CN
qkq	氢	zh-CN
qkqg	氢	zh-CN
qkqo	氰	zh-CN
qkr	倾	zh-CN
qkro	倩	zh-CN
qkrr	倾	zh-CN
qku	磬	zh-CN
qkuf	罄	zh-CN
qkuo	碃	zh-CN
qkv	箐	zh-CN
qkvo	箐	zh-CN
qkw	勍	zh-CN
qkx	情	zh-CN
qkxo	情	zh-CN
qkyo	请	zh-CN
qlc	蔷	zh-CN
qlci	蔃	zh-CN
qlck	蔷	zh-CN
qld	将	zh-CN
qlf	抢	zh-CN
qlfv	抢	zh-CN
qlgi	强	zh-CN
qlh	炝	zh-CN
qlhv	炝	zh-CN
qli	蜣	zh-CN
qlj	镪	zh-CN
qljc	锵	zh-CN
qljo	锖	zh-CN
qlk	呛	zh-CN
qlkv	呛	zh-CN
qlm	枪	zh-CN
qlmk	樯	zh-CN
qlmv	枪	zh-CN
qln	嫱	zh-CN
qlnk	嫱	zh-CN
qlo	腔	zh-CN
qlog	腔	zh-CN
qlp	襁	zh-CN
qlpg	戕	zh-CN
qlpi	襁	zh-CN
qlr	戗	zh-CN
qlrg	戗	zh-CN
qlt	墙	zh-CN
qltk	墙	zh-CN
qlw	玱	zh-CN
qlwv	玱	zh-CN
qly	羌	zh-CN
qlyg	羟	zh-CN
qlz	跄	zh-CN
qlzv	跄	zh-CN
qmb	歉	zh-CN
qmbd	前	zh-CN
qmbr	歉	zh-CN
qmbu	搴	zh-CN
qmc	茜	zh-CN
qmcc	荨	zh-CN
qmco	蒨	zh-CN
qmcq	芊	zh-CN
qmcr	芡	zh-CN
qmcx	茜	zh-CN
qmd	浅	zh-CN
qmdn	牵	zh-CN
qmdo	潜	zh-CN
qmdr	欠	zh-CN
qme	嵌	zh-CN
qmek	岍	zh-CN
qmeq	阡	zh-CN
qmer	嵌	zh-CN
qmf	扦	zh-CN
qmfo	掮	zh-CN
qmfq	扦	zh-CN
qmh	黔	zh-CN
qmhw	虔	zh-CN
qmi	堑	zh-CN
qmim	椠	zh-CN
qmit	堑	zh-CN
qmix	愆	zh-CN
qmj	钱	zh-CN
qmjg	钳	zh-CN
qmjj	钱	zh-CN
qmjv	钤	zh-CN
qmmq	杄	zh-CN
qmn	犍	zh-CN
qmnz	犍	zh-CN
qmo	肷	zh-CN
qmor	肷	zh-CN
qmp	千	zh-CN
qmpu	千	zh-CN
qmr	仟	zh-CN
qmra	佥	zh-CN
qmre	伣	zh-CN
qmro	倩	zh-CN
qmrq	仟	zh-CN
qms	缱	zh-CN
qmso	𬘬	zh-CN
qmsq	纤	zh-CN
qmsz	缱	zh-CN
qmtq	圲	zh-CN
qmu	乾	zh-CN
qmun	磏	zh-CN
qmuq	乾	zh-CN
qmv	签	zh-CN
qmva	签	zh-CN
qmx	慊	zh-CN
qmxt	悭	zh-CN
qmy	谦	zh-CN
qmyn	谦	zh-CN
qmyz	谴	zh-CN
qmz	迁	zh-CN
qmzk	遣	zh-CN
qmzq	迁	zh-CN
qna	翘	zh-CN
qnax	翘	zh-CN
qnb	窍	zh-CN
qnc	荞	zh-CN
qncl	荞	zh-CN
qne	峭	zh-CN
qnel	峤	zh-CN
qneo	峭	zh-CN
qnf	撬	zh-CN
qnfm	撬	zh-CN
qng	巧	zh-CN
qngl	鞒	zh-CN
qngo	鞘	zh-CN
qngv	巧	zh-CN
qnj	锹	zh-CN
qnjh	锹	zh-CN
qnm	橇	zh-CN
qnmh	樵	zh-CN
qnml	桥	zh-CN
qno	瞧	zh-CN
qnoh	瞧	zh-CN
qnr	俏	zh-CN
qnrd	劁	zh-CN
qnrl	侨	zh-CN
qnro	俏	zh-CN
qns	缲	zh-CN
qnsm	缲	zh-CN
qnu	壳	zh-CN
qnuf	雀	zh-CN
qnuj	壳	zh-CN
qnul	硚	zh-CN
qnuw	硗	zh-CN
qnw	敲	zh-CN
qnwy	敲	zh-CN
qnx	悄	zh-CN
qnxh	憔	zh-CN
qnxo	悄	zh-CN
qny	乔	zh-CN
qnyh	谯	zh-CN
qnyl	乔	zh-CN
qnyo	诮	zh-CN
qnz	跷	zh-CN
qnzw	跷	zh-CN
qpb	窃	zh-CN
qpbd	窃	zh-CN
qpbv	癿	zh-CN
qpc	茄	zh-CN
qpck	茄	zh-CN
qpf	挈	zh-CN
qpj	锲	zh-CN
qpjd	锲	zh-CN
qpl	妾	zh-CN
qpla	且	zh-CN
qpln	妾	zh-CN
qpq	切	zh-CN
qpqd	切	zh-CN
qpr	伽	zh-CN
qprk	伽	zh-CN
qpt	趄	zh-CN
qptq	趄	zh-CN
qpu	砌	zh-CN
qpvj	箧	zh-CN
qpx	怯	zh-CN
qpxe	郄	zh-CN
qpxj	惬	zh-CN
qpxs	怯	zh-CN
qqa	鳅	zh-CN
qqad	求	zh-CN
qqah	鳅	zh-CN
qqb	酋	zh-CN
qqby	酋	zh-CN
qqc	萩	zh-CN
qqch	萩	zh-CN
qqd	龟	zh-CN
qqdh	湫	zh-CN
qqdr	泅	zh-CN
qqg	鞧	zh-CN
qqgy	鞧	zh-CN
qqh	秋	zh-CN
qqhn	鹙	zh-CN
qqi	蚯	zh-CN
qqiv	虬	zh-CN
qqj	丘	zh-CN
qqjk	訄	zh-CN
qqk	囚	zh-CN
qqkq	赇	zh-CN
qqkr	囚	zh-CN
qqm	糗	zh-CN
qqmh	楸	zh-CN
qqmq	糗	zh-CN
qqp	丘	zh-CN
qqpa	丘	zh-CN
qqq	邱	zh-CN
qqqe	邱	zh-CN
qqqj	犰	zh-CN
qqqy	裘	zh-CN
qqr	仇	zh-CN
qqrq	俅	zh-CN
qutx	𫭟	zh-CN
qqv	巯	zh-CN
qqw	球	zh-CN
qqwp	璆	zh-CN
qqwq	球	zh-CN
qqz	逑	zh-CN
qqzj	鼽	zh-CN
qqzq	逑	zh-CN
qqzy	遒	zh-CN
qra	鬈	zh-CN
qrau	鳈	zh-CN
qrav	鬈	zh-CN
qrb	泉	zh-CN
qrbw	痊	zh-CN
qrc	颧	zh-CN
qrcr	颧	zh-CN
qrcw	荃	zh-CN
qrd	犬	zh-CN
qrdd	犬	zh-CN
qri	蜷	zh-CN
qriv	蜷	zh-CN
qriw	辁	zh-CN
qrj	拳	zh-CN
qrjd	券	zh-CN
qrjw	铨	zh-CN
qrk	圈	zh-CN
qrkv	圈	zh-CN
qrm	权	zh-CN
qrmv	棬	zh-CN
qrmy	权	zh-CN
qrnv	婘	zh-CN
qro	𨟠	zh-CN
qroe	𨟠	zh-CN
qrr	佺	zh-CN
qrrw	全	zh-CN
qrs	绻	zh-CN
qrsv	绻	zh-CN
qrtq	畎	zh-CN
qrv	筌	zh-CN
qrvw	筌	zh-CN
qrw	瑔	zh-CN
qrx	悛	zh-CN
qrxw	悛	zh-CN
qry	劝	zh-CN
qryl	劝	zh-CN
qryw	诠	zh-CN
qsb	穹	zh-CN
qsbg	穹	zh-CN
qsbl	穷	zh-CN
qsc	茕	zh-CN
qscl	䓖	zh-CN
qscu	茕	zh-CN
qsg	邛	zh-CN
qsge	邛	zh-CN
qsgi	蛩	zh-CN
qsgj	銎	zh-CN
qsv	筇	zh-CN
qsve	筇	zh-CN
qsw	琼	zh-CN
qswx	琼	zh-CN
qtb	瘸	zh-CN
qtc	鹊	zh-CN
qtcn	鹊	zh-CN
qtf	缺	zh-CN
qtfg	缺	zh-CN
qth	炔	zh-CN
qthg	炔	zh-CN
qtm	阙	zh-CN
qtmf	榷	zh-CN
qtmo	棤	zh-CN
qtmr	阙	zh-CN
qtmt	阕	zh-CN
qtt	埆	zh-CN
qtte	却	zh-CN
qtty	埆	zh-CN
qtu	确	zh-CN
qtuf	雀	zh-CN
qtux	悫	zh-CN
qtuy	确	zh-CN
qub	癯	zh-CN
qubl	劬	zh-CN
qubn	鸲	zh-CN
quc	苣	zh-CN
quci	䓛	zh-CN
qucj	苣	zh-CN
qucm	蕖	zh-CN
qucz	蘧	zh-CN
qud	渠	zh-CN
qudf	灈	zh-CN
que	取	zh-CN
quen	娶	zh-CN
queq	𪨰	zh-CN
quex	岖	zh-CN
quey	取	zh-CN
qufm	麹	zh-CN
quh	觑	zh-CN
quhe	觑	zh-CN
quhw	黢	zh-CN
qui	蛆	zh-CN
quii	衢	zh-CN
quiq	蛐	zh-CN
quiy	蠼	zh-CN
quj	鼩	zh-CN
quk	区	zh-CN
qul	曲	zh-CN
qula	曲	zh-CN
qulk	竘	zh-CN
qum	驱	zh-CN
qumq	阒	zh-CN
qums	㭕	zh-CN
quo	瞿	zh-CN
quof	瞿	zh-CN
quok	朐	zh-CN
quom	氍	zh-CN
quos	胠	zh-CN
qup	祛	zh-CN
qups	袪	zh-CN
qut	趣	zh-CN
qute	趋	zh-CN
qutq	坥	zh-CN
quty	趣	zh-CN
quu	屈	zh-CN
quum	磲	zh-CN
quux	躯	zh-CN
quv	龋	zh-CN
quvy	龋	zh-CN
quw	璩	zh-CN
quy	诎	zh-CN
qxc	葜	zh-CN
qxcd	葜	zh-CN
qxd	洽	zh-CN
qxdk	洽	zh-CN
qxf	掐	zh-CN
qxfb	拤	zh-CN
qxfj	掐	zh-CN
qxg	髂	zh-CN
qxgk	髂	zh-CN
qxp	袷	zh-CN
qxpk	袷	zh-CN
qxu	卡	zh-CN
qxub	卡	zh-CN
qxx	恰	zh-CN
qxxk	恰	zh-CN
qyg	麇	zh-CN
qygh	麇	zh-CN
qyk	囷	zh-CN
qykh	囷	zh-CN
qyp	裙	zh-CN
qypk	裙	zh-CN
qyyy	群	zh-CN
qyz	逡	zh-CN
qyzw	逡	zh-CN
r	人	zh-CN
rcc	荛	zh-CN
rccw	荛	zh-CN
rcf	扰	zh-CN
rcfy	扰	zh-CN
rcm	桡	zh-CN
rcmw	桡	zh-CN
rcn	娆	zh-CN
rcnw	娆	zh-CN
rcs	绕	zh-CN
rcsw	绕	zh-CN
rcu	饶	zh-CN
rcuw	饶	zh-CN
rec	惹	zh-CN
recx	惹	zh-CN
ref	热	zh-CN
refh	热	zh-CN
rek	喏	zh-CN
rekk	喏	zh-CN
rfc	荏	zh-CN
rfcr	荏	zh-CN
rfd	刃	zh-CN
rfh	稔	zh-CN
rfhx	稔	zh-CN
rfi	轫	zh-CN
rfir	轫	zh-CN
rfn	妊	zh-CN
rfnr	妊	zh-CN
rfp	壬	zh-CN
rfpn	人	zh-CN
rfpr	衽	zh-CN
rfpu	壬	zh-CN
rfq	壬	zh-CN
rfqa	壬	zh-CN
rfr	忍	zh-CN
rfre	仁	zh-CN
rfrr	仞	zh-CN
rfrx	忍	zh-CN
rfs	纫	zh-CN
rfsr	纴	zh-CN
rfu	饪	zh-CN
rfur	饪	zh-CN
rfw	韧	zh-CN
rfwr	韧	zh-CN
rfy	认	zh-CN
rgf	扔	zh-CN
rgfn	扔	zh-CN
rgr	仍	zh-CN
rgrn	仍	zh-CN
rhc	蘘	zh-CN
rhcy	蘘	zh-CN
rhd	瀼	zh-CN
rhdy	瀼	zh-CN
rhf	攘	zh-CN
rhfy	攘	zh-CN
rhh	穰	zh-CN
rhhy	穰	zh-CN
rhk	嚷	zh-CN
rhky	嚷	zh-CN
rhp	禳	zh-CN
rhpy	禳	zh-CN
rhry	儴	zh-CN
rht	壤	zh-CN
rhw	瓤	zh-CN
rhwg	瓤	zh-CN
rhy	让	zh-CN
rik	日	zh-CN
rika	日	zh-CN
rimo	驲	zh-CN
rja	髯	zh-CN
rjar	髯	zh-CN
rjc	苒	zh-CN
rjcr	苒	zh-CN
rjd	染	zh-CN
rjh	燃	zh-CN
rjhh	燃	zh-CN
rji	蚺	zh-CN
rjir	蚺	zh-CN
rjl	冉	zh-CN
rjla	冉	zh-CN
rjph	然	zh-CN
rjrx	䎃	zh-CN
roc	鄀	zh-CN
rocd	蒻	zh-CN
roce	鄀	zh-CN
roch	爇	zh-CN
rock	若	zh-CN
rog	弱	zh-CN
rogd	弱	zh-CN
ron	婼	zh-CN
ronk	婼	zh-CN
ror	偌	zh-CN
rork	偌	zh-CN
rov	箬	zh-CN
rovk	箬	zh-CN
rre	阮	zh-CN
rree	阮	zh-CN
rri	软	zh-CN
rrir	软	zh-CN
rrn	媆	zh-CN
rrnd	媆	zh-CN
rrt	堧	zh-CN
rrtd	堧	zh-CN
rrwe	瓀	zh-CN
rsa	融	zh-CN
rsai	融	zh-CN
rsb	冗	zh-CN
rsbj	冗	zh-CN
rsbk	容	zh-CN
rsc	荣	zh-CN
rsce	茸	zh-CN
rsck	蓉	zh-CN
rscm	荣	zh-CN
rsd	溶	zh-CN
rsdk	溶	zh-CN
rse	嵘	zh-CN
rsem	嵘	zh-CN
rsg	戎	zh-CN
rsgu	戎	zh-CN
rsh	熔	zh-CN
rshk	熔	zh-CN
rsi	蝾	zh-CN
rsim	蝾	zh-CN
rsj	镕	zh-CN
rsjk	镕	zh-CN
rsm	榕	zh-CN
rsmk	榕	zh-CN
rsq	狨	zh-CN
rsqu	狨	zh-CN
rss	绒	zh-CN
rssu	绒	zh-CN
rsw	瑢	zh-CN
rswk	瑢	zh-CN
ruc	茹	zh-CN
rucc	蓐	zh-CN
ruce	薷	zh-CN
ruck	茹	zh-CN
rud	汝	zh-CN
rudc	溽	zh-CN
rude	濡	zh-CN
rudk	洳	zh-CN
rudn	汝	zh-CN
rui	辱	zh-CN
ruie	蠕	zh-CN
ruj	铷	zh-CN
ruk	嚅	zh-CN
ruke	嚅	zh-CN
run	嬬	zh-CN
rune	嬬	zh-CN
runk	如	zh-CN
rup	入	zh-CN
rupc	褥	zh-CN
rupe	襦	zh-CN
rupn	入	zh-CN
rupv	乳	zh-CN
rur	儒	zh-CN
rure	儒	zh-CN
rus	缛	zh-CN
rusc	缛	zh-CN
ruz	孺	zh-CN
ruze	孺	zh-CN
rvc	蕊	zh-CN
rvcn	芮	zh-CN
rvcu	蕤	zh-CN
rvcx	蕊	zh-CN
rvd	汭	zh-CN
rvdn	汭	zh-CN
rvi	蚋	zh-CN
rvin	蚋	zh-CN
rvj	锐	zh-CN
rvje	锐	zh-CN
rvl	睿	zh-CN
rvlo	睿	zh-CN
rvm	枘	zh-CN
rvmn	枘	zh-CN
rvw	瑞	zh-CN
rvwe	瑞	zh-CN
ryd	润	zh-CN
rydw	润	zh-CN
rym	闰	zh-CN
rymw	闰	zh-CN
rzf	揉	zh-CN
rzfm	揉	zh-CN
rzg	鞣	zh-CN
rzgm	鞣	zh-CN
rzim	𫐓	zh-CN
rzm	糅	zh-CN
rznr	肉	zh-CN
rzs	柔	zh-CN
rzsm	柔	zh-CN
rzz	蹂	zh-CN
rzzm	蹂	zh-CN
s	三	zh-CN
saa	卅	zh-CN
saal	卅	zh-CN
sac	萨	zh-CN
saci	萨	zh-CN
sad	洒	zh-CN
sadu	挲	zh-CN
sadw	潵	zh-CN
sadx	洒	zh-CN
saf	撒	zh-CN
safw	撒	zh-CN
sag	靸	zh-CN
sagj	靸	zh-CN
sal	飒	zh-CN
salx	飒	zh-CN
sao	脎	zh-CN
saom	脎	zh-CN
sar	仨	zh-CN
sars	仨	zh-CN
scb	瘙	zh-CN
scbi	瘙	zh-CN
scd	溞	zh-CN
scf	搔	zh-CN
scfe	扫	zh-CN
scfi	搔	zh-CN
scm	骚	zh-CN
scmi	骚	zh-CN
scmo	梢	zh-CN
scn	嫂	zh-CN
scny	嫂	zh-CN
sco	臊	zh-CN
scom	臊	zh-CN
scs	缫	zh-CN
scsg	缫	zh-CN
scsm	缲	zh-CN
sct	埽	zh-CN
sctj	埽	zh-CN
sda	鳃	zh-CN
sdax	鳃	zh-CN
sdb	塞	zh-CN
sdbr	赛	zh-CN
sdk	噻	zh-CN
sdkt	噻	zh-CN
sdo	腮	zh-CN
sdox	腮	zh-CN
sdtx	思	zh-CN
seb	塞	zh-CN
sebt	塞	zh-CN
sed	涩	zh-CN
sedb	色	zh-CN
sedv	涩	zh-CN
sedx	㴔	zh-CN
seh	穑	zh-CN
sehk	穑	zh-CN
sej	铯	zh-CN
sejb	铯	zh-CN
seu	啬	zh-CN
sew	瑟	zh-CN
sewb	璱	zh-CN
sfmm	森	zh-CN
sgro	僧	zh-CN
shf	搡	zh-CN
shfm	搡	zh-CN
shk	嗓	zh-CN
shkm	嗓	zh-CN
shu	丧	zh-CN
shum	磉	zh-CN
shun	丧	zh-CN
shy	桑	zh-CN
shym	桑	zh-CN
shyr	颡	zh-CN
sia	肆	zh-CN
siae	兕	zh-CN
siay	肆	zh-CN
sid	死	zh-CN
sidb	死	zh-CN
side	泗	zh-CN
sidj	澌	zh-CN
sids	汜	zh-CN
sidu	涘	zh-CN
sie	㟃	zh-CN
siek	㟃	zh-CN
sif	撕	zh-CN
sifj	撕	zh-CN
sih	私	zh-CN
sihs	私	zh-CN
sii	厮	zh-CN
siid	厕	zh-CN
siij	蛳	zh-CN
sij	锶	zh-CN
sik	嘶	zh-CN
sika	咝	zh-CN
sike	四	zh-CN
sikk	嗣	zh-CN
siks	咝	zh-CN
sil	耜	zh-CN
sim	驷	zh-CN
sime	驷	zh-CN
simx	楒	zh-CN
sin	姒	zh-CN
sinr	姒	zh-CN
sip	祀	zh-CN
sipj	虒	zh-CN
sips	祀	zh-CN
siq	斯	zh-CN
siqj	斯	zh-CN
sir	似	zh-CN
sirk	伺	zh-CN
sirl	食	zh-CN
sirr	似	zh-CN
siru	俟	zh-CN
sirx	偲	zh-CN
sis	缌	zh-CN
sisn	鸶	zh-CN
sisx	缌	zh-CN
sit	思	zh-CN
sitc	寺	zh-CN
sitx	思	zh-CN
siu	饲	zh-CN
siuk	饲	zh-CN
siv	司	zh-CN
siva	丝	zh-CN
sivk	笥	zh-CN
sivn	鸶	zh-CN
sivv	巳	zh-CN
sja	三	zh-CN
sjae	三	zh-CN
sjcw	散	zh-CN
sjm	糁	zh-CN
sjmp	糁	zh-CN
sjr	伞	zh-CN
sjru	伞	zh-CN
sjs	叁	zh-CN
sjsm	毵	zh-CN
sjss	叁	zh-CN
sju	馓	zh-CN
sjuw	馓	zh-CN
soc	蓑	zh-CN
socu	莎	zh-CN
socy	蓑	zh-CN
sod	挲	zh-CN
sodn	娑	zh-CN
sodu	挲	zh-CN
sodx	溹	zh-CN
soj	锁	zh-CN
sojr	锁	zh-CN
sok	唆	zh-CN
soko	嗍	zh-CN
sokr	唢	zh-CN
sokw	唆	zh-CN
sokx	嗦	zh-CN
som	梭	zh-CN
somu	桫	zh-CN
somw	梭	zh-CN
soo	睃	zh-CN
soow	睃	zh-CN
sopj	所	zh-CN
sos	缩	zh-CN
sosb	缩	zh-CN
sou	索	zh-CN
soux	索	zh-CN
sow	琐	zh-CN
sowr	琐	zh-CN
soy	羧	zh-CN
soyw	羧	zh-CN
src	蒜	zh-CN
srcx	蒜	zh-CN
srq	狻	zh-CN
srqw	狻	zh-CN
srv	算	zh-CN
srvc	算	zh-CN
sry	酸	zh-CN
sryw	酸	zh-CN
ssb	宋	zh-CN
ssbm	宋	zh-CN
ssbr	颂	zh-CN
ssc	菘	zh-CN
sscs	菘	zh-CN
ssd	淞	zh-CN
sse	嵩	zh-CN
ssek	嵩	zh-CN
sses	崧	zh-CN
ssfy	㧐	zh-CN
ssl	竦	zh-CN
ssm	松	zh-CN
ssms	松	zh-CN
ssnu	娀	zh-CN
ssr	怂	zh-CN
ssre	耸	zh-CN
ssrx	怂	zh-CN
ssx	忪	zh-CN
ssxs	忪	zh-CN
ssxu	悚	zh-CN
ssy	讼	zh-CN
ssyy	诵	zh-CN
ssz	送	zh-CN
sszt	送	zh-CN
sua	稣	zh-CN
suah	稣	zh-CN
sub	宿	zh-CN
subb	宿	zh-CN
subt	塑	zh-CN
subu	窣	zh-CN
suc	蔌	zh-CN
sucb	苏	zh-CN
sucr	蔌	zh-CN
sud	涑	zh-CN
sudo	溯	zh-CN
suf	素	zh-CN
sufx	素	zh-CN
sug	甦	zh-CN
sugu	甦	zh-CN
suj	夙	zh-CN
sujd	夙	zh-CN
suk	嗉	zh-CN
sukx	嗉	zh-CN
sums	骕	zh-CN
sur	俗	zh-CN
surk	俗	zh-CN
surm	僳	zh-CN
surx	傃	zh-CN
susn	鹔	zh-CN
suv	肃	zh-CN
suvd	肃	zh-CN
suvr	簌	zh-CN
sux	粟	zh-CN
suxx	愫	zh-CN
suy	酥	zh-CN
suyi	诉	zh-CN
suyw	谡	zh-CN
suz	速	zh-CN
suzb	蹜	zh-CN
suzu	速	zh-CN
svc	荽	zh-CN
svcn	荽	zh-CN
svd	濉	zh-CN
svdf	濉	zh-CN
sve	随	zh-CN
sveo	隋	zh-CN
svex	岁	zh-CN
svez	隧	zh-CN
svfz	旞	zh-CN
svg	髓	zh-CN
svgz	髓	zh-CN
svh	穗	zh-CN
svi	祟	zh-CN
svix	祟	zh-CN
sviz	𫟦	zh-CN
svjz	𬭼	zh-CN
svk	虽	zh-CN
svki	虽	zh-CN
svo	眭	zh-CN
svof	睢	zh-CN
svot	眭	zh-CN
svpz	襚	zh-CN
svs	绥	zh-CN
svsn	绥	zh-CN
svu	碎	zh-CN
svwz	璲	zh-CN
svyu	谇	zh-CN
svz	遂	zh-CN
svzu	邃	zh-CN
syc	荪	zh-CN
sycx	荪	zh-CN
syf	损	zh-CN
syfr	损	zh-CN
sym	榫	zh-CN
symu	榫	zh-CN
syq	狲	zh-CN
syqx	狲	zh-CN
syr	隼	zh-CN
syru	隼	zh-CN
syv	笋	zh-CN
syvy	笋	zh-CN
syx	飧	zh-CN
syxl	飧	zh-CN
syz	孙	zh-CN
syzx	孙	zh-CN
szc	薮	zh-CN
szcg	蒐	zh-CN
szcw	薮	zh-CN
szd	溲	zh-CN
szdy	溲	zh-CN
szf	擞	zh-CN
szfw	擞	zh-CN
szfy	搜	zh-CN
szgy	廋	zh-CN
szi	螋	zh-CN
sziy	螋	zh-CN
szj	飕	zh-CN
szjy	锼	zh-CN
szk	嗖	zh-CN
szkr	嗽	zh-CN
szku	嗾	zh-CN
szky	嗖	zh-CN
szo	瞍	zh-CN
szoy	瞍	zh-CN
szp	叟	zh-CN
szpy	叟	zh-CN
szu	馊	zh-CN
szuy	馊	zh-CN
szv	艘	zh-CN
szvy	艘	zh-CN
t	他	zh-CN
taa	鳎	zh-CN
taax	鳎	zh-CN
tab	它	zh-CN
tabb	它	zh-CN
tad	溻	zh-CN
tadx	漯	zh-CN
taf	拓	zh-CN
tafu	拓	zh-CN
tafz	挞	zh-CN
tag	鞳	zh-CN
tagk	鞳	zh-CN
taj	铊	zh-CN
tak	嗒	zh-CN
takk	嗒	zh-CN
tam	榻	zh-CN
tamx	阘	zh-CN
tamz	闼	zh-CN
tan	她	zh-CN
tany	她	zh-CN
tap	褟	zh-CN
tapx	褟	zh-CN
taq	獭	zh-CN
taqr	獭	zh-CN
tary	他	zh-CN
tat	塌	zh-CN
tatk	塔	zh-CN
tatx	塌	zh-CN
tau	沓	zh-CN
tauo	沓	zh-CN
taz	踏	zh-CN
tazj	趿	zh-CN
tazo	踏	zh-CN
tazx	蹋	zh-CN
tcc	萄	zh-CN
tccf	萄	zh-CN
tcd	涛	zh-CN
tcdd	洮	zh-CN
tcdf	淘	zh-CN
tcdj	滔	zh-CN
tcds	套	zh-CN
tce	陶	zh-CN
tcef	陶	zh-CN
tcey	鼗	zh-CN
tcf	掏	zh-CN
tcfh	焘	zh-CN
tcg	弢	zh-CN
tcgy	弢	zh-CN
tck	啕	zh-CN
tckd	叨	zh-CN
tckf	啕	zh-CN
tckl	饕	zh-CN
tcm	桃	zh-CN
tcmc	梼	zh-CN
tcmd	桃	zh-CN
tcmf	𫘦	zh-CN
tcs	绦	zh-CN
tcsf	绹	zh-CN
tcsm	绦	zh-CN
tcw	韬	zh-CN
tcwj	韬	zh-CN
tcxj	慆	zh-CN
tcy	讨	zh-CN
tcz	逃	zh-CN
tda	鲐	zh-CN
tdak	鲐	zh-CN
tdc	苔	zh-CN
tdck	苔	zh-CN
tdct	薹	zh-CN
tdd	汰	zh-CN
tddd	太	zh-CN
tddt	汰	zh-CN
tdf	抬	zh-CN
tdfk	抬	zh-CN
tdfu	泰	zh-CN
tdj	钛	zh-CN
tdjt	钛	zh-CN
tdk	呔	zh-CN
tdkt	呔	zh-CN
tdm	骀	zh-CN
tdmk	骀	zh-CN
tdo	胎	zh-CN
tdok	胎	zh-CN
tdot	肽	zh-CN
tds	台	zh-CN
tdse	邰	zh-CN
tdsh	炱	zh-CN
tdsk	台	zh-CN
tdt	态	zh-CN
tdtx	态	zh-CN
tdy	酞	zh-CN
tdyt	酞	zh-CN
tdz	跆	zh-CN
tej	铽	zh-CN
tek	慝	zh-CN
tekx	慝	zh-CN
ten	特	zh-CN
tenc	特	zh-CN
tex	忑	zh-CN
texx	忑	zh-CN
tey	忒	zh-CN
twy	忒	zh-CN
teyx	忒	zh-CN
twyx	忒	zh-CN
tgb	疼	zh-CN
tgbd	疼	zh-CN
tgc	藤	zh-CN
tgcu	藤	zh-CN
tgh	熥	zh-CN
tghz	熥	zh-CN
tgj	誊	zh-CN
tgjk	誊	zh-CN
tgo	腾	zh-CN
tgoa	䲢	zh-CN
tgoi	螣	zh-CN
tgom	腾	zh-CN
tgou	滕	zh-CN
tgox	縢	zh-CN
thd	烫	zh-CN
thdh	烫	zh-CN
thdk	淌	zh-CN
thdp	汤	zh-CN
thf	搪	zh-CN
thfk	搪	zh-CN
thg	唐	zh-CN
thgk	唐	zh-CN
thi	螳	zh-CN
thik	螗	zh-CN
thit	螳	zh-CN
thj	镗	zh-CN
thje	镋	zh-CN
thjt	镗	zh-CN
thk	嘡	zh-CN
thkt	嘡	zh-CN
thlk	耥	zh-CN
thm	糖	zh-CN
thmk	糖	zh-CN
thmt	樘	zh-CN
thn	帑	zh-CN
thnj	帑	zh-CN
tho	膛	zh-CN
thot	膛	zh-CN
thr	倘	zh-CN
thre	傥	zh-CN
thrk	倘	zh-CN
tht	趟	zh-CN
thtk	塘	zh-CN
thu	躺	zh-CN
thuk	躺	zh-CN
thw	瑭	zh-CN
thwk	瑭	zh-CN
thx	堂	zh-CN
thxe	䣘	zh-CN
thxk	惝	zh-CN
thxm	棠	zh-CN
thxt	堂	zh-CN
thy	羰	zh-CN
thz	蹚	zh-CN
thzt	蹚	zh-CN
tia	鳀	zh-CN
tiar	鳀	zh-CN
tib	剃	zh-CN
tibd	剃	zh-CN
tibn	鹈	zh-CN
tic	荑	zh-CN
ticy	荑	zh-CN
tid	涕	zh-CN
tidp	涕	zh-CN
tif	提	zh-CN
tifo	替	zh-CN
tifr	提	zh-CN
tifz	擿	zh-CN
tij	锑	zh-CN
tik	啼	zh-CN
tikj	啼	zh-CN
tim	梯	zh-CN
timp	梯	zh-CN
timr	𫘨	zh-CN
tin	媞	zh-CN
tinr	媞	zh-CN
tio	题	zh-CN
tiod	剔	zh-CN
tior	题	zh-CN
tip	裼	zh-CN
tipn	䴘	zh-CN
tipw	裼	zh-CN
tir	倜	zh-CN
tirb	体	zh-CN
tirk	倜	zh-CN
tiry	俶	zh-CN
tis	缇	zh-CN
tisp	绨	zh-CN
tisr	缇	zh-CN
tit	趯	zh-CN
titf	趯	zh-CN
tiu	屉	zh-CN
tiuu	屉	zh-CN
tiwr	瑅	zh-CN
tix	悌	zh-CN
tixw	惕	zh-CN
tiy	醍	zh-CN
tiz	踢	zh-CN
tizh	逖	zh-CN
tizj	蹄	zh-CN
tizw	踢	zh-CN
tjb	瘫	zh-CN
tjbf	瘫	zh-CN
tjbh	痰	zh-CN
tjch	菼	zh-CN
tjd	滩	zh-CN
tjdf	滩	zh-CN
tjdk	澹	zh-CN
tjdu	潭	zh-CN
tje	炭	zh-CN
tjeh	炭	zh-CN
tjf	摊	zh-CN
tjfm	探	zh-CN
tjg	弹	zh-CN
tjgl	弹	zh-CN
tjh	郯	zh-CN
tjja	钽	zh-CN
tjjh	锬	zh-CN
tjju	镡	zh-CN
tjk	叹	zh-CN
tjkl	啴	zh-CN
tjky	叹	zh-CN
tjm	毯	zh-CN
tjma	檀	zh-CN
tjmh	毯	zh-CN
tjmt	榃	zh-CN
tjo	昙	zh-CN
tjos	昙	zh-CN
tjp	袒	zh-CN
tjr	贪	zh-CN
tjrh	倓	zh-CN
tjt	坦	zh-CN
tjtd	坍	zh-CN
tjts	坛	zh-CN
tju	碳	zh-CN
tjux	忐	zh-CN
tjw	璮	zh-CN
tjwa	璮	zh-CN
tjx	覃	zh-CN
tjxh	惔	zh-CN
tjy	谭	zh-CN
tkc	葶	zh-CN
tkcd	葶	zh-CN
tkcz	莛	zh-CN
tkd	汀	zh-CN
tkdd	渟	zh-CN
tkf	挺	zh-CN
tkfz	挺	zh-CN
tkg	庭	zh-CN
tkgz	庭	zh-CN
tkh	烃	zh-CN
tkhg	烃	zh-CN
tki	厅	zh-CN
tkiz	蜓	zh-CN
tkj	铤	zh-CN
tkjz	铤	zh-CN
tkm	梃	zh-CN
tkmw	桯	zh-CN
tkmz	梃	zh-CN
tkn	婷	zh-CN
tknd	婷	zh-CN
tkr	停	zh-CN
tkrd	停	zh-CN
tkrr	颋	zh-CN
tkrz	侹	zh-CN
tks	𬘩	zh-CN
tksz	𬘩	zh-CN
tkt	町	zh-CN
tktd	圢	zh-CN
tkv	艇	zh-CN
tkvz	艇	zh-CN
tkw	亭	zh-CN
tkwd	亭	zh-CN
tkwz	珽	zh-CN
tky	霆	zh-CN
tkz	廷	zh-CN
tkzr	廷	zh-CN
tmad	天	zh-CN
tmck	黇	zh-CN
tmd	添	zh-CN
tmdb	淟	zh-CN
tmdk	湉	zh-CN
tmdp	殄	zh-CN
tmdt	沺	zh-CN
tmdx	添	zh-CN
tmf	掭	zh-CN
tmfx	掭	zh-CN
tmj	钿	zh-CN
tmjt	钿	zh-CN
tmk	田	zh-CN
tmku	田	zh-CN
tmm	阗	zh-CN
tmmb	阗	zh-CN
tmo	腆	zh-CN
tmob	晪	zh-CN
tmod	盷	zh-CN
tmq	甜	zh-CN
tmqg	甜	zh-CN
tmqx	舔	zh-CN
tmr	佃	zh-CN
tmrt	佃	zh-CN
tmt	填	zh-CN
tmtb	填	zh-CN
tmtw	畋	zh-CN
tmtx	忝	zh-CN
tmx	恬	zh-CN
tna	鲦	zh-CN
tnak	髫	zh-CN
tnam	鲦	zh-CN
tnb	窕	zh-CN
tnbd	窕	zh-CN
tnc	苕	zh-CN
tnck	苕	zh-CN
tnf	挑	zh-CN
tnfd	挑	zh-CN
tni	蜩	zh-CN
tnik	蜩	zh-CN
tnim	粜	zh-CN
tnn	嬥	zh-CN
tnnf	嬥	zh-CN
tno	眺	zh-CN
tnod	朓	zh-CN
tnp	祧	zh-CN
tnpd	祧	zh-CN
tnr	佻	zh-CN
tnrd	佻	zh-CN
tnv	龆	zh-CN
tnvk	笤	zh-CN
tnw	条	zh-CN
tnwm	条	zh-CN
tnyk	调	zh-CN
tnz	跳	zh-CN
tnzd	跳	zh-CN
tnzk	迢	zh-CN
toa	橐	zh-CN
toab	𬶍	zh-CN
toam	橐	zh-CN
tocl	萚	zh-CN
tod	沱	zh-CN
todb	沱	zh-CN
toe	陀	zh-CN
toeb	陀	zh-CN
tof	拖	zh-CN
tofq	托	zh-CN
tofy	拖	zh-CN
tog	庹	zh-CN
togi	庹	zh-CN
toj	铊	zh-CN
tok	唾	zh-CN
tokd	鼍	zh-CN
toki	唾	zh-CN
tom	驼	zh-CN
tomb	柁	zh-CN
tomd	驮	zh-CN
tomi	柝	zh-CN
ton	鸵	zh-CN
tonb	鸵	zh-CN
too	脱	zh-CN
tooe	脱	zh-CN
top	妥	zh-CN
topn	妥	zh-CN
tor	佗	zh-CN
torb	佗	zh-CN
torq	侂	zh-CN
tot	坨	zh-CN
totb	坨	zh-CN
tou	砣	zh-CN
toub	砣	zh-CN
tov	箨	zh-CN
tovl	箨	zh-CN
toy	酡	zh-CN
toyb	酡	zh-CN
toz	跎	zh-CN
tozb	跎	zh-CN
tpc	萜	zh-CN
tpck	萜	zh-CN
tpd	餮	zh-CN
tpdl	餮	zh-CN
tpj	铁	zh-CN
tpjk	帖	zh-CN
tpju	铁	zh-CN
tpkk	贴	zh-CN
trd	湍	zh-CN
trde	湍	zh-CN
trf	抟	zh-CN
trfv	抟	zh-CN
trhe	煓	zh-CN
trk	团	zh-CN
trkc	团	zh-CN
trqe	猯	zh-CN
trt	疃	zh-CN
trtl	疃	zh-CN
trv	彖	zh-CN
trvu	彖	zh-CN
tsa	鲖	zh-CN
tsak	鲖	zh-CN
tsb	痛	zh-CN
tsby	痛	zh-CN
tsc	茼	zh-CN
tsck	茼	zh-CN
tsd	彤	zh-CN
tsdl	潼	zh-CN
tse	峂	zh-CN
tsed	峂	zh-CN
tsek	峒	zh-CN
tsf	捅	zh-CN
tsfy	捅	zh-CN
tshk	烔	zh-CN
tshl	穜	zh-CN
tsj	铜	zh-CN
tsk	嗵	zh-CN
tskz	嗵	zh-CN
tsl	童	zh-CN
tsll	童	zh-CN
tslx	𦒍	zh-CN
tsm	桶	zh-CN
tsml	橦	zh-CN
tsmy	桶	zh-CN
tsn	㛚	zh-CN
tso	瞳	zh-CN
tsol	曈	zh-CN
tsr	侗	zh-CN
tsrd	佟	zh-CN
tsrg	仝	zh-CN
tsrk	侗	zh-CN
tsrl	僮	zh-CN
tss	统	zh-CN
tst	垌	zh-CN
tstk	垌	zh-CN
tsug	砼	zh-CN
tsv	筒	zh-CN
tsvk	筒	zh-CN
tsx	恸	zh-CN
tsy	酮	zh-CN
tsyk	𫍣	zh-CN
tsz	通	zh-CN
tszy	通	zh-CN
tub	突	zh-CN
tubq	突	zh-CN
tuc	荼	zh-CN
tucd	菟	zh-CN
tuch	荼	zh-CN
tucq	葖	zh-CN
tud	涂	zh-CN
tudd	兔	zh-CN
tuh	秃	zh-CN
tuhh	稌	zh-CN
tuhj	秃	zh-CN
tui	徒	zh-CN
tuir	徒	zh-CN
tuj	钍	zh-CN
tuk	吐	zh-CN
tukt	吐	zh-CN
tul	凸	zh-CN
tula	凸	zh-CN
tum	𬳿	zh-CN
tumh	梌	zh-CN
tuo	腯	zh-CN
tuoo	腯	zh-CN
tut	堍	zh-CN
tutd	堍	zh-CN
tuu	土	zh-CN
tuuo	屠	zh-CN
tuwk	㻬	zh-CN
tuy	酴	zh-CN
tuz	途	zh-CN
tver	𬯎	zh-CN
tvff	推	zh-CN
tvg	魋	zh-CN
tvgf	魋	zh-CN
tvh	颓	zh-CN
tvi	蜕	zh-CN
tvo	腿	zh-CN
tvoz	腿	zh-CN
tvp	褪	zh-CN
tvpz	褪	zh-CN
tvy	忒	zh-CN
tvyx	忒	zh-CN
tvz	退	zh-CN
tvzg	退	zh-CN
tya	屯	zh-CN
tyat	鲀	zh-CN
tyav	屯	zh-CN
tyhz	焞	zh-CN
tyk	囤	zh-CN
tykt	囤	zh-CN
tyo	豚	zh-CN
tyou	豚	zh-CN
tyow	暾	zh-CN
typ	褪	zh-CN
typz	褪	zh-CN
tyt	吞	zh-CN
tytk	吞	zh-CN
tytt	坉	zh-CN
tyu	臀	zh-CN
tyuo	臀	zh-CN
tyut	饨	zh-CN
tzf	投	zh-CN
tzfy	投	zh-CN
tzg	骰	zh-CN
tzgy	骰	zh-CN
tzr	偷	zh-CN
tzrd	偷	zh-CN
tzz	透	zh-CN
tzzn	透	zh-CN
u	是	zh-CN
uia	十	zh-CN
uio	时	zh-CN
uab	痧	zh-CN
uac	莎	zh-CN
uacu	莎	zh-CN
uad	沙	zh-CN
uada	鲨	zh-CN
uadh	煞	zh-CN
uady	裟	zh-CN
uai	厦	zh-CN
uaiw	厦	zh-CN
uaj	铩	zh-CN
uajm	铩	zh-CN
uak	嗄	zh-CN
uakk	啥	zh-CN
uakn	唼	zh-CN
uakw	嗄	zh-CN
uam	杉	zh-CN
uaq	歃	zh-CN
uaqr	歃	zh-CN
uar	傻	zh-CN
uarw	傻	zh-CN
uas	纱	zh-CN
uasu	纱	zh-CN
uau	砂	zh-CN
uauu	砂	zh-CN
uax	杀	zh-CN
uaxd	刹	zh-CN
uaxm	杀	zh-CN
uay	霎	zh-CN
uayn	霎	zh-CN
ucb	勺	zh-CN
ucc	苕	zh-CN
ucck	苕	zh-CN
uccu	芍	zh-CN
ucd	邵	zh-CN
ucde	邵	zh-CN
ucdk	召	zh-CN
ucdl	劭	zh-CN
ucdo	潲	zh-CN
ucf	捎	zh-CN
ucfo	捎	zh-CN
ucg	鞘	zh-CN
uch	稍	zh-CN
uchw	烧	zh-CN
uck	哨	zh-CN
ucko	哨	zh-CN
ucl	韶	zh-CN
uclk	韶	zh-CN
ucm	梢	zh-CN
ucmk	柖	zh-CN
ucmo	梢	zh-CN
ucmu	杓	zh-CN
uco	睄	zh-CN
ucoo	睄	zh-CN
ucs	绍	zh-CN
ucsk	绍	zh-CN
ucv	艄	zh-CN
ucwk	玿	zh-CN
ucx	少	zh-CN
udd	色	zh-CN
uddb	色	zh-CN
udo	晒	zh-CN
udox	晒	zh-CN
udv	筛	zh-CN
udy	酾	zh-CN
udyl	酾	zh-CN
ued	涉	zh-CN
uedo	奢	zh-CN
uedp	涉	zh-CN
uedy	滠	zh-CN
uee	𪨶	zh-CN
ueei	𪨶	zh-CN
uef	摄	zh-CN
uefj	折	zh-CN
uefy	摄	zh-CN
ueg	麝	zh-CN
uegc	麝	zh-CN
uei	蛇	zh-CN
ueib	蛇	zh-CN
uek	赊	zh-CN
uekx	赊	zh-CN
uem	阇	zh-CN
uemo	阇	zh-CN
uep	社	zh-CN
uept	社	zh-CN
ueq	舌	zh-CN
ueqk	猞	zh-CN
uer	舍	zh-CN
uerk	舍	zh-CN
uerr	歙	zh-CN
uert	畲	zh-CN
uerx	佘	zh-CN
uet	赦	zh-CN
uetw	赦	zh-CN
ueu	射	zh-CN
ueuc	射	zh-CN
uex	慑	zh-CN
uexy	慑	zh-CN
ueyy	设	zh-CN
ufap	鲹	zh-CN
ufb	审	zh-CN
ufbp	瘆	zh-CN
ufbu	审	zh-CN
ufc	莘	zh-CN
ufcu	莘	zh-CN
ufcv	葚	zh-CN
ufd	沈	zh-CN
ufdp	渗	zh-CN
ufdv	沈	zh-CN
ufee	屾	zh-CN
ufhm	燊	zh-CN
ufi	蜃	zh-CN
ufju	𬬹	zh-CN
ufk	哂	zh-CN
ufku	呻	zh-CN
ufl	申	zh-CN
uflo	肾	zh-CN
ufm	糁	zh-CN
ufmp	糁	zh-CN
ufmv	椹	zh-CN
ufn	婶	zh-CN
ufnn	娠	zh-CN
ufnu	婶	zh-CN
ufo	胂	zh-CN
ufou	瞫	zh-CN
ufp	身	zh-CN
ufpp	身	zh-CN
ufpu	神	zh-CN
ufq	甚	zh-CN
ufr	什	zh-CN
ufre	侁	zh-CN
ufs	参	zh-CN
ufsp	参	zh-CN
ufu	砷	zh-CN
uful	矧	zh-CN
ufw	珅	zh-CN
ufx	慎	zh-CN
ufy	谂	zh-CN
ufyv	谌	zh-CN
ugd	渑	zh-CN
uge	嵊	zh-CN
uget	陞	zh-CN
ugi	盛	zh-CN
ugim	盛	zh-CN
ugn	牲	zh-CN
ugo	胜	zh-CN
ugoi	晟	zh-CN
ugou	昇	zh-CN
ugp	升	zh-CN
ugpc	升	zh-CN
ugpf	生	zh-CN
ugq	剩	zh-CN
ugqd	剩	zh-CN
ugqn	乘	zh-CN
ugs	绳	zh-CN
ugsd	绳	zh-CN
ugu	声	zh-CN
ugul	甥	zh-CN
uguo	省	zh-CN
ugup	声	zh-CN
ugv	笙	zh-CN
ugy	圣	zh-CN
uhd	殇	zh-CN
uhdp	觞	zh-CN
uhh	熵	zh-CN
uhla	上	zh-CN
uho	晌	zh-CN
uhok	晌	zh-CN
uhr	伤	zh-CN
uhrl	伤	zh-CN
uhs	绱	zh-CN
uhsk	绱	zh-CN
uht	墒	zh-CN
uhtk	垧	zh-CN
uhw	商	zh-CN
uhwk	商	zh-CN
uhx	尚	zh-CN
uhxr	赏	zh-CN
uiac	鲥	zh-CN
uiai	鲺	zh-CN
uiaj	𫚕	zh-CN
uiak	石	zh-CN
uial	十	zh-CN
uian	豕	zh-CN
uiav	世	zh-CN
uib	实	zh-CN
uibt	室	zh-CN
uic	蓍	zh-CN
uicc	莳	zh-CN
uid	湿	zh-CN
uidb	奭	zh-CN
uidq	殖	zh-CN
uidy	湿	zh-CN
uie	示	zh-CN
uiec	峙	zh-CN
uiex	示	zh-CN
uif	拾	zh-CN
uifg	拭	zh-CN
uifk	誓	zh-CN
uifl	势	zh-CN
uify	施	zh-CN
uii	轼	zh-CN
uijj	铈	zh-CN
uik	嗜	zh-CN
uika	噬	zh-CN
uiko	嗜	zh-CN
uikr	噬	zh-CN
uiky	嘘	zh-CN
uil	师	zh-CN
uilj	师	zh-CN
uiln	史	zh-CN
uim	驶	zh-CN
uimg	栻	zh-CN
uimj	柿	zh-CN
uin	始	zh-CN
uink	始	zh-CN
uiob	匙	zh-CN
uioc	时	zh-CN
uior	是	zh-CN
uiox	䏡	zh-CN
uip	视	zh-CN
uipe	视	zh-CN
uipf	失	zh-CN
uipl	释	zh-CN
uipt	矢	zh-CN
uipv	氏	zh-CN
uiq	狮	zh-CN
uiqj	狮	zh-CN
uir	使	zh-CN
uirc	侍	zh-CN
uirl	食	zh-CN
uirr	似	zh-CN
uiru	仕	zh-CN
uit	螫	zh-CN
uitc	埘	zh-CN
uite	邿	zh-CN
uiu	蚀	zh-CN
uiua	士	zh-CN
uiuj	饰	zh-CN
uium	屎	zh-CN
uiun	鸤	zh-CN
uiur	贳	zh-CN
uiv	尸	zh-CN
uivp	尸	zh-CN
uivr	筮	zh-CN
uiw	市	zh-CN
uix	恃	zh-CN
uixc	恃	zh-CN
uixg	弑	zh-CN
uiy	式	zh-CN
uiyb	识	zh-CN
uiyc	诗	zh-CN
uiyg	试	zh-CN
uiyl	酾	zh-CN
uiym	谥	zh-CN
uiyr	𬤊	zh-CN
uiz	适	zh-CN
uizj	逝	zh-CN
uizk	适	zh-CN
uja	鳝	zh-CN
ujak	鳝	zh-CN
ujb	单	zh-CN
ujbe	疝	zh-CN
ujbl	单	zh-CN
ujc	删	zh-CN
ujcd	删	zh-CN
ujck	苫	zh-CN
ujd	汕	zh-CN
ujde	汕	zh-CN
uje	陕	zh-CN
ujej	陕	zh-CN
ujek	嶦	zh-CN
ujf	擅	zh-CN
ujfh	掞	zh-CN
ujfl	掸	zh-CN
ujfp	掺	zh-CN
ujh	扇	zh-CN
ujhd	剡	zh-CN
ujhx	煽	zh-CN
uji	蟮	zh-CN
ujik	蟮	zh-CN
ujk	赡	zh-CN
ujkk	赡	zh-CN
ujlk	山	zh-CN
ujm	闪	zh-CN
ujmc	栅	zh-CN
ujmp	杉	zh-CN
ujmx	骟	zh-CN
ujn	姗	zh-CN
ujnc	姗	zh-CN
ujo	膳	zh-CN
ujoh	晱	zh-CN
ujok	膳	zh-CN
ujp	衫	zh-CN
ujpl	禅	zh-CN
ujpp	衫	zh-CN
ujs	缮	zh-CN
ujsk	缮	zh-CN
ujtk	墡	zh-CN
ujtl	𫮃	zh-CN
ujv	舢	zh-CN
ujw	珊	zh-CN
ujwc	珊	zh-CN
ujy	善	zh-CN
ujye	讪	zh-CN
ujz	跚	zh-CN
ujzc	跚	zh-CN
ukf	摔	zh-CN
ukfu	摔	zh-CN
uki	蟀	zh-CN
ukk	甩	zh-CN
ukkv	甩	zh-CN
uklj	帅	zh-CN
ukw	衰	zh-CN
ukwu	率	zh-CN
ukwy	衰	zh-CN
ula	爽	zh-CN
ulan	爽	zh-CN
uld	爽	zh-CN
uldl	泷	zh-CN
uldx	漴	zh-CN
ulmo	骦	zh-CN
uln	孀	zh-CN
ulno	孀	zh-CN
uluo	礵	zh-CN
uly	霜	zh-CN
ulyn	鹴	zh-CN
ulyo	霜	zh-CN
ulyy	双	zh-CN
uob	朔	zh-CN
uobm	槊	zh-CN
uobo	朔	zh-CN
uoc	蒴	zh-CN
uof	搠	zh-CN
uofo	搠	zh-CN
uoh	烁	zh-CN
uoj	铄	zh-CN
uojl	铄	zh-CN
uon	妁	zh-CN
uonu	妁	zh-CN
uou	硕	zh-CN
uour	硕	zh-CN
uoy	说	zh-CN
uoye	说	zh-CN
urd	涮	zh-CN
urdd	涮	zh-CN
urfw	拴	zh-CN
urm	闩	zh-CN
urma	闩	zh-CN
urmw	栓	zh-CN
uro	腨	zh-CN
uroe	腨	zh-CN
uua	束	zh-CN
uuad	戍	zh-CN
uuan	束	zh-CN
uuc	薯	zh-CN
uucv	蔬	zh-CN
uucy	菽	zh-CN
uud	澍	zh-CN
uudr	漱	zh-CN
uudu	沭	zh-CN
uudv	殊	zh-CN
uudy	淑	zh-CN
uue	隃	zh-CN
uuev	陎	zh-CN
uuf	抒	zh-CN
uufl	抒	zh-CN
uufx	摅	zh-CN
uug	庶	zh-CN
uugh	庶	zh-CN
uuh	黍	zh-CN
uui	输	zh-CN
uuj	鼠	zh-CN
uujv	鼠	zh-CN
uuk	赎	zh-CN
uukd	赎	zh-CN
uul	竖	zh-CN
uult	墅	zh-CN
uum	树	zh-CN
uumc	树	zh-CN
uumd	术	zh-CN
uumv	梳	zh-CN
uumx	枢	zh-CN
uun	恕	zh-CN
uunx	恕	zh-CN
uuny	婌	zh-CN
uuo	暑	zh-CN
uuod	腧	zh-CN
uuoo	曙	zh-CN
uur	舒	zh-CN
uurl	舒	zh-CN
uurm	毹	zh-CN
uurx	悆	zh-CN
uus	署	zh-CN
uusi	蜀	zh-CN
uusl	纾	zh-CN
uuso	署	zh-CN
uuu	属	zh-CN
uuuy	叔	zh-CN
uuv	书	zh-CN
uuvv	疏	zh-CN
uuw	熟	zh-CN
uuwd	戍	zh-CN
uuwh	熟	zh-CN
uuwt	塾	zh-CN
uuww	孰	zh-CN
uuz	述	zh-CN
uvh	税	zh-CN
uvhe	税	zh-CN
uvje	帨	zh-CN
uvo	睡	zh-CN
uvoi	睡	zh-CN
uvy	谁	zh-CN
uvye	说	zh-CN
uwy	谁	zh-CN
uwyf	谁	zh-CN
uxe	耍	zh-CN
uxen	耍	zh-CN
uxk	唰	zh-CN
uxkd	唰	zh-CN
uxu	刷	zh-CN
uxud	刷	zh-CN
uyi	顺	zh-CN
uyir	顺	zh-CN
uyk	吮	zh-CN
uyke	吮	zh-CN
uym	楯	zh-CN
uymo	楯	zh-CN
uyo	瞬	zh-CN
uyol	瞬	zh-CN
uyp	舜	zh-CN
uypl	舜	zh-CN
uzb	首	zh-CN
uzbc	守	zh-CN
uzbk	兽	zh-CN
uzby	瘦	zh-CN
uzbz	首	zh-CN
uzf	授	zh-CN
uzfc	寿	zh-CN
uzfy	授	zh-CN
uzp	手	zh-CN
uzpl	手	zh-CN
uzpy	受	zh-CN
uzq	狩	zh-CN
uzqc	狩	zh-CN
uzr	售	zh-CN
uzrk	售	zh-CN
uzs	绶	zh-CN
uzv	收	zh-CN
uzvw	收	zh-CN
uzw	熟	zh-CN
v	这	zh-CN
vaa	鲊	zh-CN
vaav	鲊	zh-CN
vab	痄	zh-CN
vabv	痄	zh-CN
vad	渣	zh-CN
vadg	溠	zh-CN
vadx	奓	zh-CN
vaf	揸	zh-CN
vafa	揸	zh-CN
vafq	挓	zh-CN
vafv	拃	zh-CN
vah	炸	zh-CN
vai	轧	zh-CN
vaiv	蚱	zh-CN
vaj	铡	zh-CN
vajd	铡	zh-CN
vak	喳	zh-CN
vakj	哳	zh-CN
vakm	喋	zh-CN
vakq	吒	zh-CN
vakv	咋	zh-CN
vam	榨	zh-CN
vamc	栅	zh-CN
vama	查	zh-CN
vamj	闸	zh-CN
vamv	札	zh-CN
vao	眨	zh-CN
vaof	眨	zh-CN
vap	乍	zh-CN
vapa	乍	zh-CN
vau	砟	zh-CN
vauv	砟	zh-CN
vaux	䃎	zh-CN
vav	劄	zh-CN
vavd	劄	zh-CN
vay	诈	zh-CN
vaya	鲝	zh-CN
vayv	诈	zh-CN
vaz	齇	zh-CN
vazq	齇	zh-CN
vca	𬶐	zh-CN
vcav	𬶐	zh-CN
vcd	召	zh-CN
vcdk	沼	zh-CN
vce	兆	zh-CN
vced	兆	zh-CN
vcf	招	zh-CN
vcfd	旐	zh-CN
vcfk	招	zh-CN
vch	肇	zh-CN
vcj	钊	zh-CN
vcjd	钊	zh-CN
vcjk	𬬿	zh-CN
vck	嘲	zh-CN
vckk	啁	zh-CN
vcko	嘲	zh-CN
vcm	棹	zh-CN
vco	照	zh-CN
vcog	曌	zh-CN
vcoh	照	zh-CN
vcok	昭	zh-CN
vcp	爪	zh-CN
vcpn	爪	zh-CN
vcs	罩	zh-CN
vcsu	罩	zh-CN
vct	赵	zh-CN
vctx	赵	zh-CN
vcu	朝	zh-CN
vcv	笊	zh-CN
vcy	诏	zh-CN
vcyo	着	zh-CN
vdb	窄	zh-CN
vdbm	寨	zh-CN
vdbq	宅	zh-CN
vdbx	瘵	zh-CN
vdf	摘	zh-CN
vdfk	摘	zh-CN
vdfl	择	zh-CN
vdp	祭	zh-CN
vdpx	祭	zh-CN
vdr	债	zh-CN
vdrd	侧	zh-CN
vdrr	债	zh-CN
vdw	斋	zh-CN
vdwe	斋	zh-CN
vdx	翟	zh-CN
vdxf	翟	zh-CN
vec	蔗	zh-CN
vech	蔗	zh-CN
ved	浙	zh-CN
vedj	浙	zh-CN
vef	折	zh-CN
vefi	蛰	zh-CN
vefk	哲	zh-CN
vefo	晢	zh-CN
veg	鹧	zh-CN
vegi	䗪	zh-CN
vegn	鹧	zh-CN
vei	辙	zh-CN
veiv	辄	zh-CN
veiw	辙	zh-CN
vej	锗	zh-CN
vejo	锗	zh-CN
vek	啫	zh-CN
veko	啫	zh-CN
vel	者	zh-CN
velk	詟	zh-CN
velo	者	zh-CN
vem	柘	zh-CN
vemu	柘	zh-CN
vep	褶	zh-CN
vepb	褶	zh-CN
vet	赭	zh-CN
veto	赭	zh-CN
veu	喆	zh-CN
veuk	喆	zh-CN
veum	磔	zh-CN
vey	谪	zh-CN
veyk	谪	zh-CN
veyo	着	zh-CN
vez	遮	zh-CN
vezh	遮	zh-CN
vezw	这	zh-CN
vfa	臻	zh-CN
vfab	鬒	zh-CN
vfah	臻	zh-CN
vfb	疹	zh-CN
vfc	蓁	zh-CN
vfck	葴	zh-CN
vfd	溱	zh-CN
vfdn	鸩	zh-CN
vfe	阵	zh-CN
vfei	阵	zh-CN
vff	振	zh-CN
vffn	振	zh-CN
vffv	揕	zh-CN
vfh	稹	zh-CN
vfhb	稹	zh-CN
vfi	轸	zh-CN
vfip	轸	zh-CN
vfj	镇	zh-CN
vfjr	帧	zh-CN
vfju	针	zh-CN
vfk	赈	zh-CN
vfkn	赈	zh-CN
vfl	贞	zh-CN
vfm	枕	zh-CN
vfmh	榛	zh-CN
vfmr	桢	zh-CN
vfmv	椹	zh-CN
vfo	朕	zh-CN
vfop	胗	zh-CN
vfot	朕	zh-CN
vfp	祯	zh-CN
vfpb	禛	zh-CN
vfpp	袗	zh-CN
vfpr	祯	zh-CN
vfq	斟	zh-CN
vfqu	斟	zh-CN
vfr	侦	zh-CN
vfrr	侦	zh-CN
vfs	缜	zh-CN
vfsb	缜	zh-CN
vfsl	纼	zh-CN
vft	圳	zh-CN
vfti	圳	zh-CN
vftp	畛	zh-CN
vfu	砧	zh-CN
vfub	真	zh-CN
vfuk	砧	zh-CN
vfv	箴	zh-CN
vfvk	箴	zh-CN
vfw	珍	zh-CN
vfwb	瑱	zh-CN
vfwp	珍	zh-CN
vfx	甄	zh-CN
vfxw	甄	zh-CN
vfy	震	zh-CN
vfyn	震	zh-CN
vfyp	诊	zh-CN
vga	丁	zh-CN
vgav	正	zh-CN
vgb	郑	zh-CN
vgbe	郑	zh-CN
vgbv	症	zh-CN
vgc	蒸	zh-CN
vgch	蒸	zh-CN
vgd	争	zh-CN
vgdl	争	zh-CN
vge	峥	zh-CN
vgel	峥	zh-CN
vgf	挣	zh-CN
vgfl	挣	zh-CN
vgi	征	zh-CN
vgiv	征	zh-CN
vgj	铮	zh-CN
vgjl	铮	zh-CN
vgjv	钲	zh-CN
vgl	烝	zh-CN
vglh	烝	zh-CN
vgo	睁	zh-CN
vgol	睁	zh-CN
vgq	狰	zh-CN
vgu	整	zh-CN
vgv	政	zh-CN
vgvw	政	zh-CN
vgx	怔	zh-CN
vgxv	怔	zh-CN
vgy	证	zh-CN
vgyl	诤	zh-CN
vgyv	证	zh-CN
vha	丈	zh-CN
vhan	丈	zh-CN
vhb	瘴	zh-CN
vhd	涨	zh-CN
vhdi	涨	zh-CN
vhdu	漳	zh-CN
vhe	障	zh-CN
vheu	嶂	zh-CN
vhg	张	zh-CN
vhgi	张	zh-CN
vhi	蟑	zh-CN
vhj	帐	zh-CN
vhji	帐	zh-CN
vhju	幛	zh-CN
vhk	账	zh-CN
vhki	账	zh-CN
vhl	章	zh-CN
vhlp	彰	zh-CN
vhlu	章	zh-CN
vhm	樟	zh-CN
vhmv	杖	zh-CN
vhn	嫜	zh-CN
vhnu	嫜	zh-CN
vho	胀	zh-CN
vhoi	胀	zh-CN
vhou	暲	zh-CN
vhpn	长	zh-CN
vhq	獐	zh-CN
vhqu	獐	zh-CN
vhr	仗	zh-CN
vhrj	仉	zh-CN
vhrv	仗	zh-CN
vhw	璋	zh-CN
vhx	掌	zh-CN
via	至	zh-CN
viae	郅	zh-CN
viat	至	zh-CN
viaw	致	zh-CN
vib	旨	zh-CN
vibc	痔	zh-CN
vibt	窒	zh-CN
vibx	痣	zh-CN
vic	芝	zh-CN
vicb	𦭜	zh-CN
vicv	芷	zh-CN
vid	治	zh-CN
vidj	滞	zh-CN
vidl	觯	zh-CN
vidn	之	zh-CN
vidq	殖	zh-CN
vidv	沚	zh-CN
vie	职	zh-CN
vieb	职	zh-CN
viec	峙	zh-CN
viem	骘	zh-CN
viep	陟	zh-CN
vif	指	zh-CN
vife	掷	zh-CN
vifn	鸷	zh-CN
vifo	指	zh-CN
vifr	贽	zh-CN
vifx	絷	zh-CN
vifz	擿	zh-CN
vigc	庤	zh-CN
vih	秩	zh-CN
vihf	稚	zh-CN
vihq	稙	zh-CN
vii	咫	zh-CN
viib	轵	zh-CN
viik	蜘	zh-CN
viit	蛭	zh-CN
viiw	徵	zh-CN
vij	帜	zh-CN
vijr	锧	zh-CN
vik	吱	zh-CN
vikb	只	zh-CN
viky	吱	zh-CN
vil	止	zh-CN
vila	止	zh-CN
vim	枝	zh-CN
vime	栉	zh-CN
vimo	榰	zh-CN
vimq	植	zh-CN
vimr	𬃊	zh-CN
vimt	桎	zh-CN
vimv	栀	zh-CN
vimx	梽	zh-CN
vimy	枝	zh-CN
vio	脂	zh-CN
viod	胝	zh-CN
vioo	脂	zh-CN
viot	晊	zh-CN
vioy	肢	zh-CN
vip	制	zh-CN
viph	炙	zh-CN
vipp	豸	zh-CN
vipr	质	zh-CN
vipv	祉	zh-CN
vir	值	zh-CN
virq	值	zh-CN
virt	侄	zh-CN
vis	纸	zh-CN
visb	织	zh-CN
visq	置	zh-CN
visu	纸	zh-CN
vit	址	zh-CN
vitc	畤	zh-CN
vitq	埴	zh-CN
vitv	址	zh-CN
viu	知	zh-CN
viuf	雉	zh-CN
viuq	直	zh-CN
viur	疐	zh-CN
viux	志	zh-CN
viuy	支	zh-CN
viv	彘	zh-CN
vivb	彘	zh-CN
vix	忮	zh-CN
viy	识	zh-CN
viyo	酯	zh-CN
viz	踯	zh-CN
vizr	踬	zh-CN
vizv	趾	zh-CN
vja	鳣	zh-CN
vjaa	鳣	zh-CN
vjc	蘸	zh-CN
vjd	沾	zh-CN
vjdk	詹	zh-CN
vje	崭	zh-CN
vjej	崭	zh-CN
vjf	搌	zh-CN
vjfd	旃	zh-CN
vjfn	搌	zh-CN
vji	斩	zh-CN
vjij	斩	zh-CN
vjin	辗	zh-CN
vjj	盏	zh-CN
vjjk	飐	zh-CN
vjl	站	zh-CN
vjlg	战	zh-CN
vjm	粘	zh-CN
vjmd	栴	zh-CN
vjmj	栈	zh-CN
vjmk	毡	zh-CN
vjo	瞻	zh-CN
vjok	瞻	zh-CN
vjr	偡	zh-CN
vjrv	偡	zh-CN
vjs	绽	zh-CN
vjsr	绽	zh-CN
vju	展	zh-CN
vjun	展	zh-CN
vjw	颤	zh-CN
vjwn	鹯	zh-CN
vjwr	颤	zh-CN
vjy	谵	zh-CN
vkf	拽	zh-CN
vkfy	拽	zh-CN
vld	壮	zh-CN
vldn	妆	zh-CN
vldq	状	zh-CN
vldy	装	zh-CN
vlf	撞	zh-CN
vlfl	撞	zh-CN
vlg	庄	zh-CN
vlgt	庄	zh-CN
vlj	幢	zh-CN
vljl	幢	zh-CN
vllx	戆	zh-CN
vlm	桩	zh-CN
vlmt	桩	zh-CN
vlp	奘	zh-CN
vlpd	奘	zh-CN
vlr	僮	zh-CN
vlrl	僮	zh-CN
vlv	奘	zh-CN
voc	茁	zh-CN
voci	茁	zh-CN
voco	著	zh-CN
vocu	䓬	zh-CN
vod	浊	zh-CN
vodf	濯	zh-CN
vodi	浊	zh-CN
vodn	涿	zh-CN
vodr	浞	zh-CN
vodu	汋	zh-CN
vof	捉	zh-CN
voff	擢	zh-CN
vofi	拙	zh-CN
vofn	𬸦	zh-CN
vofr	捉	zh-CN
voh	灼	zh-CN
vohu	焯	zh-CN
voj	镯	zh-CN
voji	镯	zh-CN
vojo	䦃	zh-CN
vok	啄	zh-CN
vokn	啄	zh-CN
vol	卓	zh-CN
volm	桌	zh-CN
vom	椓	zh-CN
vome	棁	zh-CN
vomn	椓	zh-CN
voo	晫	zh-CN
voou	晫	zh-CN
vop	禚	zh-CN
voph	禚	zh-CN
vor	倬	zh-CN
voru	倬	zh-CN
vos	缴	zh-CN
vosw	缴	zh-CN
vou	斫	zh-CN
vouj	斫	zh-CN
vow	琢	zh-CN
vown	琢	zh-CN
voy	酌	zh-CN
voyn	诼	zh-CN
voyo	着	zh-CN
voyu	酌	zh-CN
voyy	叕	zh-CN
vra	专	zh-CN
vrad	专	zh-CN
vrd	沌	zh-CN
vre	颛	zh-CN
vrf	撰	zh-CN
vrfb	撰	zh-CN
vri	转	zh-CN
vriv	转	zh-CN
vrk	赚	zh-CN
vrkn	赚	zh-CN
vrkv	啭	zh-CN
vro	䏝	zh-CN
vrov	䏝	zh-CN
vrr	传	zh-CN
vrrb	僎	zh-CN
vrrv	传	zh-CN
vru	砖	zh-CN
vrub	馔	zh-CN
vruv	砖	zh-CN
vrv	篆	zh-CN
vrwu	瑑	zh-CN
vsb	冢	zh-CN
vscv	茽	zh-CN
vsh	种	zh-CN
vshl	穜	zh-CN
vshv	种	zh-CN
vsj	钟	zh-CN
vsjv	锺	zh-CN
vsmd	柊	zh-CN
vso	肿	zh-CN
vsov	肿	zh-CN
vsp	重	zh-CN
vspa	重	zh-CN
vsr	众	zh-CN
vsrr	众	zh-CN
vsrv	仲	zh-CN
vss	终	zh-CN
vssd	终	zh-CN
vsv	忠	zh-CN
vsvm	盅	zh-CN
vsvx	忠	zh-CN
vsw	衷	zh-CN
vswi	螽	zh-CN
vswy	衷	zh-CN
vsxs	忪	zh-CN
vsz	踵	zh-CN
vubn	瘃	zh-CN
vubv	疰	zh-CN
vuc	著	zh-CN
vuca	苎	zh-CN
vuco	著	zh-CN
vucv	茱	zh-CN
vud	注	zh-CN
vudv	洙	zh-CN
vuf	拄	zh-CN
vufv	拄	zh-CN
vug	竹	zh-CN
vugv	麈	zh-CN
vuh	烛	zh-CN
vuhi	烛	zh-CN
vuhv	炷	zh-CN
vui	蛛	zh-CN
vuiv	蛀	zh-CN
vuj	铸	zh-CN
vujc	铸	zh-CN
vujv	铢	zh-CN
vuk	嘱	zh-CN
vuka	贮	zh-CN
vuky	嘱	zh-CN
vul	煮	zh-CN
vulh	煮	zh-CN
vulx	翥	zh-CN
vum	柱	zh-CN
vumd	术	zh-CN
vume	柷	zh-CN
vuml	杼	zh-CN
vumo	槠	zh-CN
vumv	驻	zh-CN
vun	朱	zh-CN
vunn	朱	zh-CN
vuo	瞩	zh-CN
vuoy	瞩	zh-CN
vup	祝	zh-CN
vupe	祝	zh-CN
vupl	竹	zh-CN
vupo	褚	zh-CN
vupw	朱	zh-CN
vuq	猪	zh-CN
vuql	助	zh-CN
vuqo	猪	zh-CN
vur	住	zh-CN
vura	伫	zh-CN
vurv	侏	zh-CN
vus	纻	zh-CN
vusa	纻	zh-CN
vuuv	砫	zh-CN
vuuy	属	zh-CN
vuv	筑	zh-CN
vuve	竺	zh-CN
vuvo	箸	zh-CN
vuvy	舳	zh-CN
vuw	珠	zh-CN
vuwv	珠	zh-CN
vuy	诸	zh-CN
vuyo	诸	zh-CN
vuyv	诛	zh-CN
vuz	逐	zh-CN
vuzi	躅	zh-CN
vve	坠	zh-CN
vvet	坠	zh-CN
vvf	赘	zh-CN
vvfr	赘	zh-CN
vvj	锥	zh-CN
vvjf	锥	zh-CN
vvm	椎	zh-CN
vvmf	骓	zh-CN
vvr	隹	zh-CN
vvs	缀	zh-CN
vvsy	缀	zh-CN
vvsz	缒	zh-CN
vvx	惴	zh-CN
vvxe	惴	zh-CN
vvz	追	zh-CN
vvzk	追	zh-CN
vwz	这	zh-CN
vwzw	这	zh-CN
vxa	髽	zh-CN
vxat	髽	zh-CN
vxf	挝	zh-CN
vxfv	抓	zh-CN
vxfz	挝	zh-CN
vxp	爪	zh-CN
vxpn	爪	zh-CN
vya	屯	zh-CN
vyav	屯	zh-CN
vybt	窀	zh-CN
vyd	准	zh-CN
vydf	准	zh-CN
vyi	衠	zh-CN
vyo	肫	zh-CN
vyot	肫	zh-CN
vysz	𬘯	zh-CN
totq	圫	zh-CN
vyy	谆	zh-CN
vyyz	谆	zh-CN
vzb	宙	zh-CN
vzby	宙	zh-CN
vzc	荮	zh-CN
vzcc	荮	zh-CN
vzd	州	zh-CN
vzdl	洲	zh-CN
vzdv	洲	zh-CN
vzdy	皱	zh-CN
vze	帚	zh-CN
vzej	帚	zh-CN
vzg	粥	zh-CN
vzgg	粥	zh-CN
vzi	轴	zh-CN
vzia	昼	zh-CN
vziv	辀	zh-CN
vziy	轴	zh-CN
vzk	咒	zh-CN
vzkk	啁	zh-CN
vzm	骤	zh-CN
vzmn	骤	zh-CN
vzn	妯	zh-CN
vznk	婤	zh-CN
vzny	妯	zh-CN
vzo	肘	zh-CN
vzoc	肘	zh-CN
vzp	舟	zh-CN
vzpd	舟	zh-CN
vzre	㑇	zh-CN
vzs	绉	zh-CN
vzsc	纣	zh-CN
vzse	绉	zh-CN
vzu	碡	zh-CN
vzum	碡	zh-CN
vzv	籀	zh-CN
vzvn	鸼	zh-CN
vzvt	籀	zh-CN
vzx	㤘	zh-CN
vzy	诌	zh-CN
vzyc	酎	zh-CN
vzyo	胄	zh-CN
w	我	zh-CN
waa	瓦	zh-CN
waad	瓦	zh-CN
wabg	窊	zh-CN
wad	洼	zh-CN
wadt	洼	zh-CN
wafv	挖	zh-CN
wai	蛙	zh-CN
wait	蛙	zh-CN
wak	哇	zh-CN
wakt	哇	zh-CN
wal	凹	zh-CN
wan	娃	zh-CN
wann	娲	zh-CN
want	娃	zh-CN
wao	腽	zh-CN
waom	腽	zh-CN
wap	袜	zh-CN
war	佤	zh-CN
warw	佤	zh-CN
wat	畖	zh-CN
watg	畖	zh-CN
wdb	歪	zh-CN
wdbv	歪	zh-CN
wde	崴	zh-CN
wden	崴	zh-CN
wfa	鳁	zh-CN
wfam	鳁	zh-CN
wfb	瘟	zh-CN
wfcw	芠	zh-CN
wfd	温	zh-CN
wfdm	温	zh-CN
wfdw	汶	zh-CN
wfh	稳	zh-CN
wfhw	炆	zh-CN
wfi	蚊	zh-CN
wfim	辒	zh-CN
wfiw	蚊	zh-CN
wfk	吻	zh-CN
wfkw	吻	zh-CN
wfm	闻	zh-CN
wfme	闻	zh-CN
wfmm	榅	zh-CN
wfmw	𫘜	zh-CN
wfmy	阌	zh-CN
wfp	璺	zh-CN
wfpy	璺	zh-CN
wfs	纹	zh-CN
wfsw	纹	zh-CN
wfw	文	zh-CN
wfwd	刎	zh-CN
wfww	玟	zh-CN
wfwx	紊	zh-CN
wfy	雯	zh-CN
wfyw	雯	zh-CN
wgb	瓮	zh-CN
wgbn	鹟	zh-CN
wgbw	瓮	zh-CN
wgbx	翁	zh-CN
wgc	蓊	zh-CN
wgcf	蕹	zh-CN
wgcx	蓊	zh-CN
wgdx	滃	zh-CN
wgjx	𬭩	zh-CN
wgk	嗡	zh-CN
wgkx	嗡	zh-CN
wha	王	zh-CN
what	王	zh-CN
whd	汪	zh-CN
whdw	汪	zh-CN
whg	魍	zh-CN
whgw	魍	zh-CN
whi	往	zh-CN
whiv	往	zh-CN
whiw	辋	zh-CN
whk	网	zh-CN
whkw	罔	zh-CN
whkx	网	zh-CN
whm	枉	zh-CN
whmw	枉	zh-CN
who	旺	zh-CN
whow	旺	zh-CN
whuw	尪	zh-CN
whw	望	zh-CN
whwn	妄	zh-CN
whwv	亡	zh-CN
whwx	忘	zh-CN
whx	惘	zh-CN
whxw	惘	zh-CN
whyw	尪	zh-CN
wja	万	zh-CN
wjap	万	zh-CN
wjav	豌	zh-CN
wjb	皖	zh-CN
wjbd	剜	zh-CN
wjbe	皖	zh-CN
wjbv	宛	zh-CN
wjc	莞	zh-CN
wjce	莞	zh-CN
wjcv	菀	zh-CN
wjcw	芄	zh-CN
wjcy	蔓	zh-CN
wjd	湾	zh-CN
wjdg	湾	zh-CN
wjdw	𬇕	zh-CN
wje	顽	zh-CN
wjf	挽	zh-CN
wjfv	挽	zh-CN
wjh	烷	zh-CN
wjhe	烷	zh-CN
wji	蜿	zh-CN
wjiv	蜿	zh-CN
wjmv	椀	zh-CN
wjn	婉	zh-CN
wjne	妧	zh-CN
wjnk	婠	zh-CN
wjnv	婉	zh-CN
wjo	晚	zh-CN
wjoe	脘	zh-CN
wjov	腕	zh-CN
wjp	丸	zh-CN
wjs	纨	zh-CN
wjsk	绾	zh-CN
wjsw	纨	zh-CN
wjt	畹	zh-CN
wjtg	塆	zh-CN
wjtv	畹	zh-CN
wju	碗	zh-CN
wjw	玩	zh-CN
wjwe	玩	zh-CN
wjwg	弯	zh-CN
wjwv	琬	zh-CN
wjx	惋	zh-CN
wjxv	惋	zh-CN
wob	窝	zh-CN
wobn	窝	zh-CN
woc	莴	zh-CN
wocn	莴	zh-CN
wod	沃	zh-CN
wodn	涡	zh-CN
wodt	渥	zh-CN
wodv	涴	zh-CN
wody	沃	zh-CN
wof	挝	zh-CN
woft	握	zh-CN
wofz	挝	zh-CN
woi	卧	zh-CN
woib	卧	zh-CN
woin	蜗	zh-CN
woj	幄	zh-CN
wojt	幄	zh-CN
wok	喔	zh-CN
wokt	喔	zh-CN
woo	肟	zh-CN
wook	肟	zh-CN
wop	我	zh-CN
wopd	我	zh-CN
wor	倭	zh-CN
worn	倭	zh-CN
wort	偓	zh-CN
wou	斡	zh-CN
wouu	斡	zh-CN
wouw	硪	zh-CN
wov	龌	zh-CN
wovt	龌	zh-CN
woz	踒	zh-CN
wozn	踒	zh-CN
wua	五	zh-CN
wuaa	五	zh-CN
wuad	戊	zh-CN
wuae	兀	zh-CN
wuan	鹉	zh-CN
wuav	武	zh-CN
wuay	无	zh-CN
wub	勿	zh-CN
wubk	寤	zh-CN
wubp	勿	zh-CN
wuc	芜	zh-CN
wucw	芴	zh-CN
wud	污	zh-CN
wudw	𣲘	zh-CN
wue	屼	zh-CN
wuek	峿	zh-CN
wuew	屼	zh-CN
wuf	捂	zh-CN
wufd	於	zh-CN
wufk	捂	zh-CN
wug	巫	zh-CN
wugn	鹀	zh-CN
wugp	戊	zh-CN
wugw	庑	zh-CN
wuh	焐	zh-CN
wuhk	焐	zh-CN
wui	蜈	zh-CN
wuit	蜈	zh-CN
wuj	钨	zh-CN
wujw	钨	zh-CN
wuk	吴	zh-CN
wukk	唔	zh-CN
wukt	吴	zh-CN
wukw	呜	zh-CN
wum	梧	zh-CN
wun	物	zh-CN
wunk	牾	zh-CN
wunw	妩	zh-CN
wuo	晤	zh-CN
wuok	晤	zh-CN
wuow	旿	zh-CN
wup	舞	zh-CN
wupa	乌	zh-CN
wupg	午	zh-CN
wupl	舞	zh-CN
wur	伍	zh-CN
wurm	侮	zh-CN
wurw	仵	zh-CN
wus	婺	zh-CN
wusm	骛	zh-CN
wusn	鹜	zh-CN
wut	圬	zh-CN
wutw	坞	zh-CN
wuu	屋	zh-CN
wuut	屋	zh-CN
wuv	毋	zh-CN
wuva	毋	zh-CN
wuw	务	zh-CN
wuwe	邬	zh-CN
wuwk	吾	zh-CN
wuwl	务	zh-CN
wuwv	珷	zh-CN
wux	悟	zh-CN
wuxw	忤	zh-CN
wuy	误	zh-CN
wuyl	雾	zh-CN
wuyx	恶	zh-CN
wuz	迕	zh-CN
wwa	未	zh-CN
wwac	鳚	zh-CN
wwad	威	zh-CN
wwal	韦	zh-CN
wwao	鲔	zh-CN
wwav	𬶏	zh-CN
wwb	痿	zh-CN
wwbn	痿	zh-CN
wwc	薇	zh-CN
wwcc	蔚	zh-CN
wwcn	萎	zh-CN
wwcw	苇	zh-CN
wwcz	薳	zh-CN
wwd	危	zh-CN
wwdf	潍	zh-CN
wwdo	渭	zh-CN
wwdr	𬱟	zh-CN
wwdv	洈	zh-CN
wwdw	涠	zh-CN
wwe	巍	zh-CN
wwea	卫	zh-CN
wweg	隗	zh-CN
wwen	崴	zh-CN
wwfw	㧑	zh-CN
wwgg	廆	zh-CN
wwh	委	zh-CN
wwhg	魏	zh-CN
wwhn	煨	zh-CN
wwhw	炜	zh-CN
wwi	微	zh-CN
wwiw	微	zh-CN
wwj	帷	zh-CN
wwje	𬭬	zh-CN
wwjf	帷	zh-CN
wwjw	帏	zh-CN
wwk	味	zh-CN
wwkf	唯	zh-CN
wwkn	喂	zh-CN
wwkw	围	zh-CN
wwm	闱	zh-CN
wwmv	桅	zh-CN
wwn	娓	zh-CN
wwo	韪	zh-CN
wwow	𬀩	zh-CN
wwq	猥	zh-CN
wwqo	猬	zh-CN
wwr	伟	zh-CN
wwrl	位	zh-CN
wwrn	偎	zh-CN
wwrw	伪	zh-CN
wws	维	zh-CN
wwsf	维	zh-CN
wwsw	纬	zh-CN
wwt	胃	zh-CN
wwty	圩	zh-CN
wwu	尾	zh-CN
wwuc	尉	zh-CN
wwuj	硙	zh-CN
wwum	尾	zh-CN
wwun	碨	zh-CN
wwux	慰	zh-CN
wwv	卫	zh-CN
wwva	卫	zh-CN
wwvm	艉	zh-CN
www	威	zh-CN
wwwn	威	zh-CN
wwww	玮	zh-CN
wwx	威	zh-CN
wwxf	惟	zh-CN
wwy	谓	zh-CN
wwyc	霨	zh-CN
wwyn	诿	zh-CN
wwyo	谓	zh-CN
wwz	违	zh-CN
wwzn	逶	zh-CN
wwzw	违	zh-CN
x	小	zh-CN
xbc	芯	zh-CN
xbcj	薪	zh-CN
xbcu	莘	zh-CN
xbcx	芯	zh-CN
xbd	心	zh-CN
xbgr	𫷷	zh-CN
xbh	炘	zh-CN
xbj	锌	zh-CN
xbjj	鑫	zh-CN
xbjr	欣	zh-CN
xbl	辛	zh-CN
xblj	新	zh-CN
xblr	歆	zh-CN
xbo	昕	zh-CN
xboj	昕	zh-CN
xbp	囟	zh-CN
xbpx	囟	zh-CN
xbr	信	zh-CN
xbrk	信	zh-CN
xbrx	伈	zh-CN
xbu	馨	zh-CN
xbx	衅	zh-CN
xbxj	忻	zh-CN
xby	䜣	zh-CN
xia	西	zh-CN
xiaa	西	zh-CN
xiab	鳛	zh-CN
xiak	𬶮	zh-CN
xib	兮	zh-CN
xibe	郤	zh-CN
xibv	兮	zh-CN
xibx	窸	zh-CN
xic	昔	zh-CN
xico	昔	zh-CN
xicr	蓰	zh-CN
xicx	茜	zh-CN
xid	洗	zh-CN
xidd	溪	zh-CN
xidh	潟	zh-CN
xidj	淅	zh-CN
xidk	觿	zh-CN
xidx	汐	zh-CN
xidy	玺	zh-CN
xie	隙	zh-CN
xieb	嶍	zh-CN
xieg	巇	zh-CN
xieh	隰	zh-CN
xiev	嶲	zh-CN
xiex	隙	zh-CN
xig	席	zh-CN
xige	觋	zh-CN
xih	稀	zh-CN
xihd	爔	zh-CN
xii	熙	zh-CN
xiij	蜥	zh-CN
xiir	徙	zh-CN
xiix	蟋	zh-CN
xij	锡	zh-CN
xijd	鼷	zh-CN
xije	铣	zh-CN
xijw	锡	zh-CN
xik	吸	zh-CN
xikh	熙	zh-CN
xikj	唏	zh-CN
xikk	嘻	zh-CN
xil	袭	zh-CN
xily	袭	zh-CN
xim	析	zh-CN
ximb	皙	zh-CN
ximd	𫘬	zh-CN
xime	阋	zh-CN
ximj	析	zh-CN
ximn	樨	zh-CN
ximw	檄	zh-CN
ximx	栖	zh-CN
xin	媳	zh-CN
xinx	牺	zh-CN
xio	膝	zh-CN
xiod	曦	zh-CN
xioj	晰	zh-CN
xiok	暿	zh-CN
xioo	腊	zh-CN
xip	夕	zh-CN
xipk	禧	zh-CN
xipw	裼	zh-CN
xipx	悉	zh-CN
xir	翕	zh-CN
xird	傒	zh-CN
xirk	僖	zh-CN
xis	细	zh-CN
xisk	绤	zh-CN
xism	枲	zh-CN
xist	细	zh-CN
xiu	喜	zh-CN
xiuh	熹	zh-CN
xiun	犀	zh-CN
xiuq	饩	zh-CN
xiur	屣	zh-CN
xiv	习	zh-CN
xivd	习	zh-CN
xivx	舾	zh-CN
xiwl	釐	zh-CN
xiwx	𠅤	zh-CN
xix	希	zh-CN
xixe	郗	zh-CN
xixj	希	zh-CN
xixo	惜	zh-CN
xiy	戏	zh-CN
xiyd	羲	zh-CN
xiyg	戏	zh-CN
xiym	醯	zh-CN
xiz	息	zh-CN
xizd	蹊	zh-CN
xizx	息	zh-CN
xkc	荇	zh-CN
xkcu	荥	zh-CN
xke	陉	zh-CN
xkeg	陉	zh-CN
xkf	擤	zh-CN
xkfl	擤	zh-CN
xkhu	煋	zh-CN
xkii	行	zh-CN
xkjd	铏	zh-CN
xkk	形	zh-CN
xkkd	刑	zh-CN
xkke	邢	zh-CN
xkkp	形	zh-CN
xkkt	型	zh-CN
xkm	杏	zh-CN
xkn	姓	zh-CN
xknu	姓	zh-CN
xko	星	zh-CN
xkou	腥	zh-CN
xkq	猩	zh-CN
xkt	幸	zh-CN
xktg	幸	zh-CN
xku	省	zh-CN
xkud	硎	zh-CN
xkuo	省	zh-CN
xkup	饧	zh-CN
xkx	性	zh-CN
xkxb	兴	zh-CN
xkxg	悻	zh-CN
xkx	惺	zh-CN
xky	醒	zh-CN
xlc	巷	zh-CN
xlco	葙	zh-CN
xlcx	芗	zh-CN
xld	象	zh-CN
xldn	象	zh-CN
xldo	湘	zh-CN
xle	降	zh-CN
xlel	降	zh-CN
xlg	项	zh-CN
xlg	项	zh-CN
xlh	香	zh-CN
xli	厢	zh-CN
xlio	厢	zh-CN
xlj	镶	zh-CN
xlja	鲞	zh-CN
xljy	镶	zh-CN
xlk	响	zh-CN
xlkk	响	zh-CN
xlm	相	zh-CN
xlmn	橡	zh-CN
xlmx	想	zh-CN
xlmy	骧	zh-CN
xlp	向	zh-CN
xlpk	向	zh-CN
xlpy	祥	zh-CN
xlr	像	zh-CN
xlrn	像	zh-CN
xlso	缃	zh-CN
xlsy	𬙋	zh-CN
xlu	饷	zh-CN
xluk	饷	zh-CN
xlv	乡	zh-CN
xlvo	箱	zh-CN
xlvp	乡	zh-CN
xlw	享	zh-CN
xlwk	珦	zh-CN
xlwy	襄	zh-CN
xlwz	享	zh-CN
xlx	飨	zh-CN
xly	详	zh-CN
xlyx	翔	zh-CN
xma	鲜	zh-CN
xmad	咸	zh-CN
xmay	鲜	zh-CN
xmb	宪	zh-CN
xmbe	宪	zh-CN
xmbm	痫	zh-CN
xmbn	𬸣	zh-CN
xmc	藓	zh-CN
xmca	莶	zh-CN
xmce	苋	zh-CN
xmd	冼	zh-CN
xmdz	涎	zh-CN
xme	限	zh-CN
xmea	险	zh-CN
xmeg	限	zh-CN
xmej	陷	zh-CN
xmf	掀	zh-CN
xmfc	挦	zh-CN
xmfr	掀	zh-CN
xmg	弦	zh-CN
xmgy	弦	zh-CN
xmi	衔	zh-CN
xmj	铣	zh-CN
xmje	铣	zh-CN
xmjr	锨	zh-CN
xmk	见	zh-CN
xml	贤	zh-CN
xmlr	贤	zh-CN
xmm	闲	zh-CN
xmme	籼	zh-CN
xmmm	闲	zh-CN
xmmn	鹇	zh-CN
xmn	嫌	zh-CN
xmne	先	zh-CN
xmnj	孅	zh-CN
xmnn	嫌	zh-CN
xmo	显	zh-CN
xmoe	𪾢	zh-CN
xmoh	㬎	zh-CN
xmou	腺	zh-CN
xmoy	显	zh-CN
xmp	祆	zh-CN
xmpt	祆	zh-CN
xmpu	禒	zh-CN
xmq	县	zh-CN
xmqa	猃	zh-CN
xmqe	氙	zh-CN
xmqs	县	zh-CN
xmqx	狝	zh-CN
xmr	仙	zh-CN
xmre	仙	zh-CN
xmry	伭	zh-CN
xms	线	zh-CN
xmsq	纤	zh-CN
xmu	献	zh-CN
xmuj	馅	zh-CN
xmuq	献	zh-CN
xmv	舷	zh-CN
xmvy	舷	zh-CN
xmw	现	zh-CN
xmwe	现	zh-CN
xmwk	咸	zh-CN
xmwy	玹	zh-CN
xmx	咸	zh-CN
xmxr	忺	zh-CN
xmy	羡	zh-CN
xmye	酰	zh-CN
xmyk	𫍯	zh-CN
xmyr	羡	zh-CN
xmyw	霰	zh-CN
xmz	跹	zh-CN
xmze	跣	zh-CN
xmzf	暹	zh-CN
xnb	宵	zh-CN
xnbb	皛	zh-CN
xnbo	宵	zh-CN
xnc	萧	zh-CN
xnd	消	zh-CN
xndo	淆	zh-CN
xnds	潇	zh-CN
xndx	洨	zh-CN
xndz	涍	zh-CN
xne	崤	zh-CN
xneo	崤	zh-CN
xng	魈	zh-CN
xni	蛸	zh-CN
xnio	蛸	zh-CN
xnis	蟏	zh-CN
xnj	销	zh-CN
xnjj	虓	zh-CN
xnjo	销	zh-CN
xnk	啸	zh-CN
xnkk	嚣	zh-CN
xnkn	鸮	zh-CN
xnkw	哓	zh-CN
xnkz	哮	zh-CN
xnl	孝	zh-CN
xnld	小	zh-CN
xnm	校	zh-CN
xnmv	枵	zh-CN
xnmx	校	zh-CN
xno	晓	zh-CN
xnow	晓	zh-CN
xnp	枭	zh-CN
xnq	猇	zh-CN
xnqj	猇	zh-CN
xnrx	翛	zh-CN
xns	绡	zh-CN
xnu	硝	zh-CN
xnv	箫	zh-CN
xnvw	筱	zh-CN
xnvy	笑	zh-CN
xnw	效	zh-CN
xnx	肖	zh-CN
xnxd	削	zh-CN
xnxo	肖	zh-CN
xnxw	敩	zh-CN
xnxx	恔	zh-CN
xny	霄	zh-CN
xnyo	霄	zh-CN
xnyy	𫍲	zh-CN
xnz	逍	zh-CN
xnzo	逍	zh-CN
xpa	鲑	zh-CN
xpat	鲑	zh-CN
xpb	写	zh-CN
xpby	写	zh-CN
xpc	薤	zh-CN
xpcj	薤	zh-CN
xpcn	薢	zh-CN
xpd	泄	zh-CN
xpdj	瀣	zh-CN
xpdy	泻	zh-CN
xpf	携	zh-CN
xpfd	契	zh-CN
xpfj	挟	zh-CN
xpfn	携	zh-CN
xpfr	撷	zh-CN
xpfx	絜	zh-CN
xpg	鞋	zh-CN
xpgn	廨	zh-CN
xpgt	鞋	zh-CN
xph	燮	zh-CN
xphy	燮	zh-CN
xpi	蝎	zh-CN
xpiv	蝎	zh-CN
xpk	叶	zh-CN
xpku	叶	zh-CN
xplx	勰	zh-CN
xpm	械	zh-CN
xpmd	楔	zh-CN
xpo	歇	zh-CN
xpob	胁	zh-CN
xpor	歇	zh-CN
xpp	血	zh-CN
xppe	卸	zh-CN
xppm	血	zh-CN
xpq	獬	zh-CN
xpqn	獬	zh-CN
xpr	斜	zh-CN
xprb	偕	zh-CN
xprd	偰	zh-CN
xprt	㙦	zh-CN
xps	绁	zh-CN
xpsr	缬	zh-CN
xpu	协	zh-CN
xpub	协	zh-CN
xpuo	屑	zh-CN
xpur	颉	zh-CN
xpw	卸	zh-CN
xpwe	卸	zh-CN
xpwy	亵	zh-CN
xpx	懈	zh-CN
xpxn	懈	zh-CN
xpy	谢	zh-CN
xpye	邪	zh-CN
xpz	邂	zh-CN
xpzn	邂	zh-CN
xpzy	躞	zh-CN
xqa	髹	zh-CN
xqam	髹	zh-CN
xqb	宿	zh-CN
xqbb	宿	zh-CN
xqd	溴	zh-CN
xqdo	滫	zh-CN
xqdq	溴	zh-CN
xqe	岫	zh-CN
xqey	岫	zh-CN
xqg	庥	zh-CN
xqgm	庥	zh-CN
xqh	秀	zh-CN
xqhn	秀	zh-CN
xqio	䗛	zh-CN
xqj	锈	zh-CN
xqjn	锈	zh-CN
xqk	嗅	zh-CN
xqkm	咻	zh-CN
xqkq	嗅	zh-CN
xqm	朽	zh-CN
xqmv	朽	zh-CN
xqp	袖	zh-CN
xqpy	袖	zh-CN
xqr	休	zh-CN
xqrm	休	zh-CN
xqrn	鸺	zh-CN
xqro	脩	zh-CN
xqrp	修	zh-CN
xqs	绣	zh-CN
xqsn	绣	zh-CN
xqu	馐	zh-CN
xqv	貅	zh-CN
xqvm	貅	zh-CN
xqw	琇	zh-CN
xqwn	琇	zh-CN
xqwo	珛	zh-CN
xqy	羞	zh-CN
xqz	臭	zh-CN
xqzq	臭	zh-CN
xrb	宣	zh-CN
xrby	癣	zh-CN
xrc	萱	zh-CN
xrd	渲	zh-CN
xrdr	漩	zh-CN
xrdy	泫	zh-CN
xrf	旋	zh-CN
xrfr	旋	zh-CN
xrh	炫	zh-CN
xrha	煊	zh-CN
xrhy	炫	zh-CN
xri	轩	zh-CN
xrii	衒	zh-CN
xrj	铉	zh-CN
xrjd	券	zh-CN
xrjo	𫓶	zh-CN
xrjy	铉	zh-CN
xrk	喧	zh-CN
xrm	楦	zh-CN
xrmy	𫠊	zh-CN
xro	眩	zh-CN
xror	暶	zh-CN
xroy	昡	zh-CN
xrp	禤	zh-CN
xrpx	禤	zh-CN
xrq	悬	zh-CN
xrqx	悬	zh-CN
xrr	儇	zh-CN
xrry	伭	zh-CN
xrs	绚	zh-CN
xrso	绚	zh-CN
xrsx	翾	zh-CN
xru	碹	zh-CN
xrua	碹	zh-CN
xrw	玄	zh-CN
xrwa	瑄	zh-CN
xrwr	璇	zh-CN
xrwy	玹	zh-CN
xrx	愃	zh-CN
xry	𫍽	zh-CN
xsb	匈	zh-CN
xsc	芎	zh-CN
xscg	芎	zh-CN
xsd	汹	zh-CN
xsdk	汹	zh-CN
xsdw	夐	zh-CN
xsk	兄	zh-CN
xske	兄	zh-CN
xso	胸	zh-CN
xsok	胸	zh-CN
xss	熊	zh-CN
xssh	熊	zh-CN
xsu	雄	zh-CN
xsx	凶	zh-CN
xsy	讻	zh-CN
xta	鳕	zh-CN
xtae	鳕	zh-CN
xtb	穴	zh-CN
xtbb	穴	zh-CN
xtc	薛	zh-CN
xtcb	茓	zh-CN
xtcu	薛	zh-CN
xtf	踅	zh-CN
xtfr	踅	zh-CN
xtg	靴	zh-CN
xtgb	靴	zh-CN
xtk	噱	zh-CN
xtp	血	zh-CN
xtx	削	zh-CN
xtxe	峃	zh-CN
xtxw	敩	zh-CN
xtxz	学	zh-CN
xty	雪	zh-CN
xua	戌	zh-CN
xuad	戌	zh-CN
xuc	蓄	zh-CN
xucb	蓿	zh-CN
xuct	蓄	zh-CN
xud	溆	zh-CN
xudw	浒	zh-CN
xudx	洫	zh-CN
xudy	溆	zh-CN
xuf	砉	zh-CN
xug	序	zh-CN
xugl	序	zh-CN
xugv	魆	zh-CN
xuh	虚	zh-CN
xuhy	虚	zh-CN
xui	徐	zh-CN
xuj	旭	zh-CN
xujo	旭	zh-CN
xuk	嘘	zh-CN
xukl	勖	zh-CN
xuky	吁	zh-CN
xum	栩	zh-CN
xumo	糈	zh-CN
xumx	栩	zh-CN
xun	婿	zh-CN
xunx	絮	zh-CN
xuo	煦	zh-CN
xuoh	煦	zh-CN
xuok	昫	zh-CN
xuoy	盱	zh-CN
xup	须	zh-CN
xupn	媭	zh-CN
xur	叙	zh-CN
xury	叙	zh-CN
xus	续	zh-CN
xusd	续	zh-CN
xuse	𦈡	zh-CN
xuso	绪	zh-CN
xut	墟	zh-CN
xutl	垿	zh-CN
xuty	圩	zh-CN
xuv	胥	zh-CN
xuvo	胥	zh-CN
xuw	畜	zh-CN
xuwa	戌	zh-CN
xuwr	顼	zh-CN
xuwx	珝	zh-CN
xux	恤	zh-CN
xuy	许	zh-CN
xuye	需	zh-CN
xuyk	酗	zh-CN
xuyo	谞	zh-CN
xuyw	许	zh-CN
xuyx	诩	zh-CN
xxa	夏	zh-CN
xxab	下	zh-CN
xxaw	夏	zh-CN
xxb	瘕	zh-CN
xxe	峡	zh-CN
xxej	峡	zh-CN
xxf	罅	zh-CN
xxh	黠	zh-CN
xxi	虾	zh-CN
xxik	辖	zh-CN
xxiw	厦	zh-CN
xxix	虾	zh-CN
xxk	吓	zh-CN
xxkj	匣	zh-CN
xxkx	吓	zh-CN
xxmj	柙	zh-CN
xxo	瞎	zh-CN
xxok	瞎	zh-CN
xxoy	暇	zh-CN
xxq	狭	zh-CN
xxqj	狎	zh-CN
xxr	侠	zh-CN
xxrj	侠	zh-CN
xxu	硖	zh-CN
xxv	叚	zh-CN
xxw	瑕	zh-CN
xxwy	瑕	zh-CN
xxy	霞	zh-CN
xxz	遐	zh-CN
xxzy	遐	zh-CN
xya	鲟	zh-CN
xyac	鲟	zh-CN
xyb	旬	zh-CN
xybe	郇	zh-CN
xybo	窨	zh-CN
xyc	薰	zh-CN
xycc	荨	zh-CN
xych	薰	zh-CN
xyco	荀	zh-CN
xycu	蕈	zh-CN
xyd	殉	zh-CN
xydc	浔	zh-CN
xydo	洵	zh-CN
xydu	汛	zh-CN
xydw	浚	zh-CN
xye	寻	zh-CN
xyec	寻	zh-CN
xyee	𬩽	zh-CN
xyeo	峋	zh-CN
xyi	循	zh-CN
xyio	徇	zh-CN
xyk	勋	zh-CN
xykb	噀	zh-CN
xykl	勋	zh-CN
xym	驯	zh-CN
xymo	栒	zh-CN
xyo	曛	zh-CN
xyoh	曛	zh-CN
xyp	熏	zh-CN
xyph	熏	zh-CN
xyq	獯	zh-CN
xyqh	獯	zh-CN
xys	巽	zh-CN
xysb	巽	zh-CN
xysh	𫄸	zh-CN
xyt	埙	zh-CN
xytr	埙	zh-CN
xyw	珣	zh-CN
xywc	𬍤	zh-CN
xywo	珣	zh-CN
xyxo	恂	zh-CN
xyy	讯	zh-CN
xyyi	训	zh-CN
xyyo	询	zh-CN
xyyu	讯	zh-CN
xyz	迅	zh-CN
xyzv	巡	zh-CN
xyzx	逊	zh-CN
y	一	zh-CN
yaa	牙	zh-CN
yaap	牙	zh-CN
yaay	亚	zh-CN
yab	丫	zh-CN
yabl	丫	zh-CN
yac	芽	zh-CN
yacy	芽	zh-CN
yad	涯	zh-CN
yadt	涯	zh-CN
yae	崖	zh-CN
yaet	崖	zh-CN
yaey	岈	zh-CN
yaf	押	zh-CN
yafj	押	zh-CN
yafn	揠	zh-CN
yai	压	zh-CN
yaid	压	zh-CN
yaiv	轧	zh-CN
yaiy	蚜	zh-CN
yaj	鸭	zh-CN
yajn	鸭	zh-CN
yak	呀	zh-CN
yaky	哑	zh-CN
yam	桠	zh-CN
yamy	桠	zh-CN
yan	娅	zh-CN
yany	娅	zh-CN
yao	睚	zh-CN
yaot	睚	zh-CN
yaq	氩	zh-CN
yaqd	猰	zh-CN
yaqy	氩	zh-CN
yar	伢	zh-CN
yary	伢	zh-CN
yat	垭	zh-CN
yatt	堐	zh-CN
yaty	垭	zh-CN
yau	砑	zh-CN
yauy	砑	zh-CN
yaw	琊	zh-CN
yawe	琊	zh-CN
yawy	玡	zh-CN
yay	雅	zh-CN
yayf	雅	zh-CN
yayn	鸦	zh-CN
yaz	迓	zh-CN
yazy	迓	zh-CN
ybae	䲟	zh-CN
ybb	瘾	zh-CN
ybbb	寅	zh-CN
ybbo	窨	zh-CN
ybbx	瘾	zh-CN
ybc	荫	zh-CN
ybcd	茵	zh-CN
ybce	茚	zh-CN
ybd	淫	zh-CN
ybdd	洇	zh-CN
ybdr	淫	zh-CN
ybdy	溵	zh-CN
ybe	阴	zh-CN
ybej	崟	zh-CN
ybeo	阴	zh-CN
ybex	隐	zh-CN
ybg	引	zh-CN
ybi	蚓	zh-CN
ybj	银	zh-CN
ybjd	铟	zh-CN
ybjg	银	zh-CN
ybk	吟	zh-CN
ybkk	嚚	zh-CN
ybkl	吲	zh-CN
ybko	喑	zh-CN
ybl	音	zh-CN
yblo	音	zh-CN
yblx	慭	zh-CN
ybm	訚	zh-CN
ybmk	訚	zh-CN
ybmt	𬮱	zh-CN
ybn	姻	zh-CN
ybnd	姻	zh-CN
ybne	鄞	zh-CN
ybp	印	zh-CN
ybpe	印	zh-CN
ybpt	禋	zh-CN
ybpv	胤	zh-CN
ybpy	殷	zh-CN
ybq	狺	zh-CN
ybqd	氤	zh-CN
ybsd	𬘡	zh-CN
ybt	垠	zh-CN
ybtg	垠	zh-CN
ybtj	圻	zh-CN
ybu	饮	zh-CN
ybug	硍	zh-CN
ybur	饮	zh-CN
ybv	尹	zh-CN
ybvp	尹	zh-CN
ybw	珢	zh-CN
ybwg	珢	zh-CN
ybx	夤	zh-CN
ybxo	愔	zh-CN
ybxr	歅	zh-CN
yby	霪	zh-CN
yca	尧	zh-CN
ycaf	鳐	zh-CN
ycaw	尧	zh-CN
ycb	窑	zh-CN
ycba	疟	zh-CN
ycbf	窑	zh-CN
ycbl	窈	zh-CN
ycbo	窅	zh-CN
ycc	药	zh-CN
yccu	药	zh-CN
ycdw	滧	zh-CN
yce	崾	zh-CN
ycen	崾	zh-CN
ycew	峣	zh-CN
ycf	摇	zh-CN
ycg	靿	zh-CN
ycgl	靿	zh-CN
yci	徭	zh-CN
ycif	徭	zh-CN
ycik	轺	zh-CN
ycj	钥	zh-CN
ycjd	铫	zh-CN
ycjo	钥	zh-CN
yck	咬	zh-CN
yckx	咬	zh-CN
ycky	吆	zh-CN
ycm	杳	zh-CN
ycn	妖	zh-CN
ycnd	姚	zh-CN
ycnf	媱	zh-CN
ycny	妖	zh-CN
yco	腰	zh-CN
ycof	曜	zh-CN
ycon	腰	zh-CN
ycp	夭	zh-CN
ycpd	乐	zh-CN
ycpj	舀	zh-CN
ycpn	鹞	zh-CN
ycpx	繇	zh-CN
ycqf	猺	zh-CN
ycr	侥	zh-CN
ycrw	侥	zh-CN
ycs	约	zh-CN
yctt	垚	zh-CN
ycv	幺	zh-CN
ycvs	幺	zh-CN
ycw	瑶	zh-CN
ycwd	珧	zh-CN
ycx	耀	zh-CN
ycxf	耀	zh-CN
ycxo	肴	zh-CN
ycxx	爻	zh-CN
ycy	谣	zh-CN
ycyf	谣	zh-CN
ycz	邀	zh-CN
yczf	遥	zh-CN
yczw	邀	zh-CN
yea	页	zh-CN
year	页	zh-CN
yeb	爷	zh-CN
yebe	爷	zh-CN
yed	液	zh-CN
yedk	冶	zh-CN
yedn	液	zh-CN
yee	耶	zh-CN
yeee	耶	zh-CN
yef	揶	zh-CN
yefe	揶	zh-CN
yefn	掖	zh-CN
yeh	烨	zh-CN
yei	靥	zh-CN
yeim	靥	zh-CN
yej	铘	zh-CN
yeje	铘	zh-CN
yek	叶	zh-CN
yeka	噎	zh-CN
yekd	咽	zh-CN
yeku	叶	zh-CN
yel	业	zh-CN
yela	业	zh-CN
yell	野	zh-CN
yelp	曳	zh-CN
yem	椰	zh-CN
yeme	椰	zh-CN
yeo	腋	zh-CN
yeon	腋	zh-CN
yeou	晔	zh-CN
yere	倻	zh-CN
yeu	馌	zh-CN
yeum	馌	zh-CN
yev	也	zh-CN
yevv	也	zh-CN
yew	夜	zh-CN
yewn	夜	zh-CN
yey	邺	zh-CN
yeyv	谒	zh-CN
yhb	痒	zh-CN
yhbl	羊	zh-CN
yhbp	疡	zh-CN
yhd	洋	zh-CN
yhdy	泱	zh-CN
yhe	阳	zh-CN
yheo	阳	zh-CN
yhf	扬	zh-CN
yhfp	扬	zh-CN
yhg	鞅	zh-CN
yhgy	鞅	zh-CN
yhh	秧	zh-CN
yhhp	炀	zh-CN
yhhy	烊	zh-CN
yhi	徉	zh-CN
yhj	飏	zh-CN
yhjp	钖	zh-CN
yhk	咉	zh-CN
yhky	咉	zh-CN
yhl	央	zh-CN
yhm	杨	zh-CN
yhmy	样	zh-CN
yho	旸	zh-CN
yhop	旸	zh-CN
yhq	氧	zh-CN
yhr	仰	zh-CN
yhre	仰	zh-CN
yhry	佯	zh-CN
yhty	垟	zh-CN
yhw	玚	zh-CN
yhwp	玚	zh-CN
yhx	怏	zh-CN
yhxy	怏	zh-CN
yhy	养	zh-CN
yhyl	养	zh-CN
yhyn	鸯	zh-CN
yhyx	恙	zh-CN
yhyy	羕	zh-CN
yia	夷	zh-CN
yiaa	一	zh-CN
yiad	弋	zh-CN
yib	益	zh-CN
yibl	宧	zh-CN
yibq	宜	zh-CN
yibr	疑	zh-CN
yibt	瘗	zh-CN
yibx	癔	zh-CN
yiby	疫	zh-CN
yic	艺	zh-CN
yicn	𬟁	zh-CN
yicr	苡	zh-CN
yicv	艺	zh-CN
yicx	薏	zh-CN
yicy	荑	zh-CN
yid	溢	zh-CN
yida	殪	zh-CN
yidb	浥	zh-CN
yidk	漪	zh-CN
yidx	义	zh-CN
yie	屹	zh-CN
yiel	峄	zh-CN
yier	嶷	zh-CN
yif	抑	zh-CN
yifb	挹	zh-CN
yife	揖	zh-CN
yifk	旖	zh-CN
yigb	廙	zh-CN
yih	移	zh-CN
yihb	熠	zh-CN
yihx	黟	zh-CN
yii	役	zh-CN
yiib	蛇	zh-CN
yiim	螠	zh-CN
yiiu	轶	zh-CN
yiiw	蜴	zh-CN
yiiy	蚁	zh-CN
yij	镒	zh-CN
yijv	钇	zh-CN
yijy	铱	zh-CN
yik	咦	zh-CN
yikb	邑	zh-CN
yikm	嗌	zh-CN
yiku	医	zh-CN
yikv	呓	zh-CN
yikx	噫	zh-CN
yiky	咿	zh-CN
yil	毅	zh-CN
yilx	意	zh-CN
yim	椅	zh-CN
yiml	驿	zh-CN
yimy	杙	zh-CN
yin	姨	zh-CN
yinx	嫕	zh-CN
yiny	姨	zh-CN
yio	易	zh-CN
yiok	眙	zh-CN
yiou	昳	zh-CN
yiow	易	zh-CN
yiox	臆	zh-CN
yioy	胰	zh-CN
yip	祎	zh-CN
yipn	乂	zh-CN
yipw	祎	zh-CN
yiq	猗	zh-CN
yir	依	zh-CN
yird	㑊	zh-CN
yirk	倚	zh-CN
yirl	食	zh-CN
yiro	佾	zh-CN
yirq	仡	zh-CN
yiru	佚	zh-CN
yirv	亿	zh-CN
yiry	仪	zh-CN
yis	异	zh-CN
yisc	异	zh-CN
yisl	绎	zh-CN
yism	缢	zh-CN
yisu	矣	zh-CN
yisx	𫄷	zh-CN
yit	圯	zh-CN
yitw	埸	zh-CN
yiu	壹	zh-CN
yiuk	饴	zh-CN
yium	尾	zh-CN
yiux	懿	zh-CN
yiv	已	zh-CN
yivk	𬺈	zh-CN
yivr	以	zh-CN
yivv	乙	zh-CN
yivx	簃	zh-CN
yivy	舣	zh-CN
yiw	亦	zh-CN
yiwc	弈	zh-CN
yiwk	裔	zh-CN
yiwy	衣	zh-CN
yix	翼	zh-CN
yixc	羿	zh-CN
yixd	刈	zh-CN
yixv	忆	zh-CN
yiy	议	zh-CN
yiyk	诒	zh-CN
yiyl	译	zh-CN
yiyo	诣	zh-CN
yiyq	谊	zh-CN
yiz	遗	zh-CN
yizd	逸	zh-CN
yizr	遗	zh-CN
yizy	迤	zh-CN
yjb	宴	zh-CN
yjbg	戭	zh-CN
yjbn	宴	zh-CN
yjc	芫	zh-CN
yjce	芫	zh-CN
yjd	演	zh-CN
yjdb	滟	zh-CN
yjdc	渰	zh-CN
yjde	沇	zh-CN
yjdh	漹	zh-CN
yjdk	沿	zh-CN
yjdt	湮	zh-CN
yje	岩	zh-CN
yjed	崦	zh-CN
yjeq	𪩘	zh-CN
yjeu	岩	zh-CN
yjf	艳	zh-CN
yjfb	艳	zh-CN
yjfd	掩	zh-CN
yjh	烟	zh-CN
yjhh	炎	zh-CN
yjhw	甗	zh-CN
yji	颜	zh-CN
yjif	雁	zh-CN
yjil	餍	zh-CN
yjin	蝘	zh-CN
yjip	彦	zh-CN
yjiq	厌	zh-CN
yjir	赝	zh-CN
yjiz	蜒	zh-CN
yjj	鼹	zh-CN
yjk	咽	zh-CN
yjkd	咽	zh-CN
yjkk	唁	zh-CN
yjkn	𬸘	zh-CN
yjkz	觃	zh-CN
yjlt	䶮	zh-CN
yjm	验	zh-CN
yjmd	阉	zh-CN
yjmh	棪	zh-CN
yjmj	阎	zh-CN
yjms	闫	zh-CN
yjn	燕	zh-CN
yja	燕	zh-CN
yjnh	嫣	zh-CN
yjnk	妍	zh-CN
yjo	腌	zh-CN
yjod	胭	zh-CN
yjog	眼	zh-CN
yjon	晏	zh-CN
yjp	殷	zh-CN
yjpy	殷	zh-CN
yjr	俨	zh-CN
yjrc	弇	zh-CN
yjrn	偃	zh-CN
yjs	罨	zh-CN
yjsd	罨	zh-CN
yjt	盐	zh-CN
yjth	墕	zh-CN
yjtm	盐	zh-CN
yjtn	堰	zh-CN
yju	研	zh-CN
yjue	砚	zh-CN
yjv	筵	zh-CN
yjvh	焉	zh-CN
yjw	言	zh-CN
yjwe	兖	zh-CN
yjwk	言	zh-CN
yjx	恹	zh-CN
yjy	严	zh-CN
yjyp	谚	zh-CN
yjz	延	zh-CN
ykb	颖	zh-CN
ykbn	瘿	zh-CN
ykbr	颍	zh-CN
ykc	英	zh-CN
ykcf	䓨	zh-CN
ykch	荧	zh-CN
ykci	萤	zh-CN
ykcj	蓥	zh-CN
ykck	营	zh-CN
ykcn	莺	zh-CN
ykct	茔	zh-CN
ykcu	荥	zh-CN
ykcx	萦	zh-CN
ykd	瀛	zh-CN
ykdf	瀛	zh-CN
ykdm	溁	zh-CN
ykdy	滢	zh-CN
ykf	撄	zh-CN
ykfn	撄	zh-CN
ykg	鹰	zh-CN
ykga	应	zh-CN
ykgn	鹰	zh-CN
yki	蝇	zh-CN
ykid	蝇	zh-CN
ykk	婴	zh-CN
ykke	郢	zh-CN
ykkf	罂	zh-CN
ykkn	嘤	zh-CN
ykm	樱	zh-CN
ykn	盈	zh-CN
yknm	盈	zh-CN
yko	影	zh-CN
ykon	媵	zh-CN
ykop	影	zh-CN
ykoy	映	zh-CN
yks	缨	zh-CN
yksn	缨	zh-CN
yku	硬	zh-CN
ykw	赢	zh-CN
ykwn	璎	zh-CN
ykwy	瑛	zh-CN
ykz	迎	zh-CN
ykze	迎	zh-CN
yok	哟	zh-CN
yoko	唷	zh-CN
yoku	哟	zh-CN
yrb	冤	zh-CN
yrc	苑	zh-CN
yrce	芫	zh-CN
yrcv	苑	zh-CN
yrd	源	zh-CN
yrdl	渊	zh-CN
yrdx	源	zh-CN
yrdy	湲	zh-CN
yre	院	zh-CN
yred	鼋	zh-CN
yree	元	zh-CN
yrf	援	zh-CN
yrfu	掾	zh-CN
yrfy	援	zh-CN
yri	原	zh-CN
yrio	蜎	zh-CN
yrix	愿	zh-CN
yriy	辕	zh-CN
yrk	员	zh-CN
yrke	园	zh-CN
yrkr	圆	zh-CN
yrky	圜	zh-CN
yrm	橼	zh-CN
yrmu	橼	zh-CN
yrmx	𫘪	zh-CN
yrn	媛	zh-CN
yrne	妧	zh-CN
yrnx	嫄	zh-CN
yrny	媛	zh-CN
yrp	爰	zh-CN
yrpy	爰	zh-CN
yrq	猿	zh-CN
yrqy	猿	zh-CN
yrs	缘	zh-CN
yrt	袁	zh-CN
yrte	垸	zh-CN
yrta	垣	zh-CN
yrtx	塬	zh-CN
yrty	袁	zh-CN
yrv	箢	zh-CN
yrw	瑗	zh-CN
yrx	怨	zh-CN
yrxo	眢	zh-CN
yrxx	怨	zh-CN
yry	鸢	zh-CN
yryn	鸢	zh-CN
yrz	远	zh-CN
ysa	鳙	zh-CN
ysal	鳙	zh-CN
ysay	鲬	zh-CN
ysb	痈	zh-CN
ysby	痈	zh-CN
ysd	永	zh-CN
ysdf	澭	zh-CN
ysdy	涌	zh-CN
ysf	拥	zh-CN
ysfy	拥	zh-CN
ysg	庸	zh-CN
ysge	鄘	zh-CN
yshy	㶲	zh-CN
ysi	蛹	zh-CN
ysj	镛	zh-CN
ysjl	镛	zh-CN
ysk	咏	zh-CN
yskl	用	zh-CN
ysky	喁	zh-CN
ysm	栐	zh-CN
ysmy	栐	zh-CN
yso	臃	zh-CN
ysof	臃	zh-CN
ysr	佣	zh-CN
ysry	俑	zh-CN
yss	勇	zh-CN
yssl	勇	zh-CN
yssx	恿	zh-CN
yssy	甬	zh-CN
yst	墉	zh-CN
ystl	墉	zh-CN
ysty	埇	zh-CN
ysv	邕	zh-CN
ysvb	邕	zh-CN
ysw	雍	zh-CN
yswl	饔	zh-CN
yswt	壅	zh-CN
ysx	慵	zh-CN
ysy	颙	zh-CN
ysz	踊	zh-CN
yszy	踊	zh-CN
ytd	瀹	zh-CN
ytdc	瀹	zh-CN
yth	爚	zh-CN
ytiw	𫐄	zh-CN
ytj	钺	zh-CN
ytjo	钥	zh-CN
ytk	曰	zh-CN
ytka	月	zh-CN
ytkx	哕	zh-CN
ytm	阅	zh-CN
ytme	阅	zh-CN
ytml	栎	zh-CN
ytmv	樾	zh-CN
yto	刖	zh-CN
ytod	刖	zh-CN
ytp	乐	zh-CN
ytpd	乐	zh-CN
ytpv	粤	zh-CN
ytq	岳	zh-CN
ytqe	岳	zh-CN
ytqn	𬸚	zh-CN
ytr	龠	zh-CN
ytrc	龠	zh-CN
yts	约	zh-CN
ytt	越	zh-CN
yttv	越	zh-CN
ytvc	籥	zh-CN
ytw	玥	zh-CN
ytwo	玥	zh-CN
ytx	悦	zh-CN
ytxe	悦	zh-CN
yty	说	zh-CN
ytz	跃	zh-CN
ytzy	跃	zh-CN
yua	于	zh-CN
yuaa	与	zh-CN
yuad	雨	zh-CN
yual	于	zh-CN
yub	宇	zh-CN
yubd	瘀	zh-CN
yubg	窳	zh-CN
yubn	鹆	zh-CN
yubr	欲	zh-CN
yuby	寓	zh-CN
yuc	芋	zh-CN
yucc	蔚	zh-CN
yucd	薁	zh-CN
yucr	蓣	zh-CN
yud	鱼	zh-CN
yuda	渔	zh-CN
yudd	渝	zh-CN
yudo	淯	zh-CN
yudr	滪	zh-CN
yue	屿	zh-CN
yued	嵛	zh-CN
yuek	峪	zh-CN
yuey	隅	zh-CN
yuf	揄	zh-CN
yufd	於	zh-CN
yug	庾	zh-CN
yuhl	煜	zh-CN
yuhk	燏	zh-CN
yuhl	煜	zh-CN
yuh	虞	zh-CN
yui	御	zh-CN
yuia	蜮	zh-CN
yuie	御	zh-CN
yujc	舁	zh-CN
yujy	钰	zh-CN
yuk	喻	zh-CN
yukd	喻	zh-CN
yukg	圉	zh-CN
yuky	吁	zh-CN
yul	禺	zh-CN
yum	驭	zh-CN
yuma	阈	zh-CN
yumd	榆	zh-CN
yumy	驭	zh-CN
yun	娱	zh-CN
yunl	妤	zh-CN
yunt	娱	zh-CN
yunx	妪	zh-CN
yuo	昱	zh-CN
yuol	昱	zh-CN
yuoy	腴	zh-CN
yup	禹	zh-CN
yupb	舆	zh-CN
yupd	褕	zh-CN
yupk	裕	zh-CN
yupn	臾	zh-CN
yupv	毓	zh-CN
yuq	狱	zh-CN
yuqd	㺄	zh-CN
yuqh	狳	zh-CN
yur	余	zh-CN
yurd	俞	zh-CN
yurh	余	zh-CN
yurt	俣	zh-CN
yurx	愈	zh-CN
yus	预	zh-CN
yusl	予	zh-CN
yusn	豫	zh-CN
yut	域	zh-CN
yuta	域	zh-CN
yuto	堉	zh-CN
yutq	圫	zh-CN
yuu	郁	zh-CN
yuuc	尉	zh-CN
yuuy	饫	zh-CN
yuv	聿	zh-CN
yuvk	龉	zh-CN
yuvy	竽	zh-CN
yuw	玉	zh-CN
yuwd	瑜	zh-CN
yuwo	育	zh-CN
yuwy	玙	zh-CN
yux	羽	zh-CN
yuxd	愉	zh-CN
yuxk	誉	zh-CN
yuy	语	zh-CN
yuyd	谕	zh-CN
yuyk	雩	zh-CN
yuym	盂	zh-CN
yuyr	欤	zh-CN
yuyx	愚	zh-CN
yuz	遇	zh-CN
yuzd	逾	zh-CN
yuzk	遹	zh-CN
yuzy	迂	zh-CN
yyb	匀	zh-CN
yybe	郓	zh-CN
yyc	芸	zh-CN
yycm	蕴	zh-CN
yycs	芸	zh-CN
yucv	菀	zh-CN
yyd	殒	zh-CN
yye	陨	zh-CN
yyes	云	zh-CN
yyhm	煴	zh-CN
yyk	郧	zh-CN
yyke	郧	zh-CN
yyl	韵	zh-CN
yyld	韵	zh-CN
yyls	耘	zh-CN
yyn	孕	zh-CN
yyns	妘	zh-CN
yynz	孕	zh-CN
yyo	晕	zh-CN
yyod	昀	zh-CN
yyoi	晕	zh-CN
yyq	氲	zh-CN
yyqe	狁	zh-CN
yyqm	氲	zh-CN
yys	允	zh-CN
yysm	缊	zh-CN
yytj	鋆	zh-CN
yyu	熨	zh-CN
yyv	筠	zh-CN
yyw	韫	zh-CN
yywr	赟	zh-CN
yyxi	恽	zh-CN
yyxm	愠	zh-CN
yyy	酝	zh-CN
yyz	运	zh-CN
yyzs	运	zh-CN
yza	鱿	zh-CN
yzaa	酉	zh-CN
yzay	鲉	zh-CN
yzb	疣	zh-CN
yzbo	宥	zh-CN
yzbq	猷	zh-CN
yzby	疣	zh-CN
yzc	莜	zh-CN
yzcn	莠	zh-CN
yzcw	莜	zh-CN
yzcy	莸	zh-CN
yzd	游	zh-CN
yzdy	油	zh-CN
yzdz	游	zh-CN
yze	幽	zh-CN
yzey	幽	zh-CN
yzgb	麀	zh-CN
yzh	黝	zh-CN
yzhl	黝	zh-CN
yzi	蝣	zh-CN
yzil	蚴	zh-CN
yzj	铀	zh-CN
yzjo	铕	zh-CN
yzjy	鼬	zh-CN
yzk	呦	zh-CN
yzkl	呦	zh-CN
yzko	囿	zh-CN
yzl	由	zh-CN
yzla	卣	zh-CN
yzlw	耰	zh-CN
yzm	柚	zh-CN
yzmh	槱	zh-CN
yzmy	柚	zh-CN
yzp	祐	zh-CN
yzpf	牖	zh-CN
yzpx	繇	zh-CN
yzpy	釉	zh-CN
yzq	犹	zh-CN
yzqy	犹	zh-CN
yzr	优	zh-CN
yzrk	佑	zh-CN
yzro	侑	zh-CN
yzrw	攸	zh-CN
yzrx	悠	zh-CN
yzry	优	zh-CN
yzu	右	zh-CN
yzud	尤	zh-CN
yzuk	右	zh-CN
yzuy	友	zh-CN
yzv	又	zh-CN
yzvn	又	zh-CN
yzx	忧	zh-CN
yzxa	酉	zh-CN
yzxy	忧	zh-CN
yzy	邮	zh-CN
yzyd	尤	zh-CN
yzye	邮	zh-CN
yzyl	幼	zh-CN
yzyn	诱	zh-CN
z	在	zh-CN
zaf	扎	zh-CN
zafv	扎	zh-CN
zafx	拶	zh-CN
zaj	杂	zh-CN
zajm	杂	zh-CN
zak	咂	zh-CN
zakj	匝	zh-CN
zakv	咋	zh-CN
zakz	咱	zh-CN
zao	臜	zh-CN
zaor	臜	zh-CN
zau	砸	zh-CN
zauj	砸	zh-CN
zca	枣	zh-CN
zcad	枣	zh-CN
zcb	皂	zh-CN
zcbq	皂	zh-CN
zcc	藻	zh-CN
zccm	藻	zh-CN
zcd	澡	zh-CN
zch	灶	zh-CN
zchm	燥	zh-CN
zcht	灶	zh-CN
zci	蚤	zh-CN
zcii	蚤	zh-CN
zck	噪	zh-CN
zckm	噪	zh-CN
zckq	唣	zh-CN
zcm	糟	zh-CN
zcmo	糟	zh-CN
zco	早	zh-CN
zcou	早	zh-CN
zcum	𥖨	zh-CN
zcvz	簉	zh-CN
zcw	璪	zh-CN
zcwm	璪	zh-CN
zcxz	慥	zh-CN
zcy	凿	zh-CN
zcz	造	zh-CN
zczk	造	zh-CN
zczm	躁	zh-CN
zczo	遭	zh-CN
zda	再	zh-CN
zdar	再	zh-CN
zdb	灾	zh-CN
zdbh	灾	zh-CN
zdbu	宰	zh-CN
zde	崽	zh-CN
zdex	崽	zh-CN
zdr	仔	zh-CN
zdrz	仔	zh-CN
zdu	载	zh-CN
zduk	哉	zh-CN
zdum	栽	zh-CN
zdut	在	zh-CN
zdv	甾	zh-CN
zdvt	甾	zh-CN
zed	泽	zh-CN
zedl	泽	zh-CN
zef	责	zh-CN
zefl	择	zh-CN
zefr	责	zh-CN
zei	仄	zh-CN
zeir	赜	zh-CN
zej	帻	zh-CN
zejr	帻	zh-CN
zek	啧	zh-CN
zekd	则	zh-CN
zekr	赜	zh-CN
zekv	咋	zh-CN
zeo	昃	zh-CN
zeor	昃	zh-CN
zev	笮	zh-CN
zevr	箦	zh-CN
zevv	舴	zh-CN
zez	迮	zh-CN
zezv	迮	zh-CN
zfv	怎	zh-CN
zfvx	怎	zh-CN
zfy	谮	zh-CN
zfyo	谮	zh-CN
zgb	曾	zh-CN
zgbe	鄫	zh-CN
zgbo	曾	zh-CN
zgbw	甑	zh-CN
zgj	锃	zh-CN
zgjw	锃	zh-CN
zgk	赠	zh-CN
zgko	赠	zh-CN
zgs	缯	zh-CN
zgso	罾	zh-CN
zgsx	综	zh-CN
zgto	增	zh-CN
zguo	矰	zh-CN
zgx	憎	zh-CN
zgxo	憎	zh-CN
zha	臧	zh-CN
zhad	臧	zh-CN
zhc	葬	zh-CN
zhcc	葬	zh-CN
zhci	藏	zh-CN
zhk	赃	zh-CN
zhkt	赃	zh-CN
zhm	驵	zh-CN
zhmq	驵	zh-CN
zho	脏	zh-CN
zhot	脏	zh-CN
zhp	奘	zh-CN
zhpd	奘	zh-CN
zhpy	牂	zh-CN
zhv	奘	zh-CN
zhvd	奘	zh-CN
zhw	臧	zh-CN
zhwi	臧	zh-CN
zia	鲻	zh-CN
ziab	髭	zh-CN
ziat	鲻	zh-CN
zib	兹	zh-CN
ziby	兹	zh-CN
zibz	孳	zh-CN
zic	茈	zh-CN
zicb	茈	zh-CN
zicv	鼒	zh-CN
zid	资	zh-CN
zidk	咨	zh-CN
zidn	姿	zh-CN
zidt	淄	zh-CN
zidu	滓	zh-CN
zidx	恣	zh-CN
zidy	滋	zh-CN
zie	嵫	zh-CN
ziey	嵫	zh-CN
zih	秭	zh-CN
zihp	秭	zh-CN
zii	辎	zh-CN
ziit	辎	zh-CN
zij	锱	zh-CN
zijy	镃	zh-CN
zik	吱	zh-CN
zikb	呲	zh-CN
ziky	嗞	zh-CN
zil	耔	zh-CN
zilz	耔	zh-CN
zim	梓	zh-CN
zimz	籽	zh-CN
zin	姊	zh-CN
zinp	姊	zh-CN
zio	眦	zh-CN
ziob	眦	zh-CN
zip	自	zh-CN
zipo	自	zh-CN
zir	仔	zh-CN
zirz	仔	zh-CN
zis	缁	zh-CN
zist	缁	zh-CN
zit	趑	zh-CN
zitr	趑	zh-CN
ziv	子	zh-CN
ziva	子	zh-CN
zivb	龇	zh-CN
zivk	訾	zh-CN
zivp	笫	zh-CN
zivx	紫	zh-CN
zivy	觜	zh-CN
ziy	鄑	zh-CN
ziz	孜	zh-CN
zizw	孜	zh-CN
zjbr	寁	zh-CN
zjf	攒	zh-CN
zjfr	攒	zh-CN
zjfx	拶	zh-CN
zji	暂	zh-CN
zjij	錾	zh-CN
zjio	暂	zh-CN
zjk	咱	zh-CN
zjm	糌	zh-CN
zjmo	糌	zh-CN
zjn	赞	zh-CN
zjne	酂	zh-CN
zjnr	赞	zh-CN
zjt	趱	zh-CN
zjtr	趱	zh-CN
zjv	簪	zh-CN
zjvo	簪	zh-CN
zjw	瓒	zh-CN
zjwo	昝	zh-CN
zjwr	瓒	zh-CN
zoe	阼	zh-CN
zoev	岞	zh-CN
zof	撮	zh-CN
zofu	捽	zh-CN
zofy	撮	zh-CN
zog	座	zh-CN
zogt	座	zh-CN
zok	嘬	zh-CN
zokt	唑	zh-CN
zoky	嘬	zh-CN
zom	柞	zh-CN
zomv	柞	zh-CN
zoo	昨	zh-CN
zoov	胙	zh-CN
zop	祚	zh-CN
zopv	祚	zh-CN
zor	作	zh-CN
zorg	佐	zh-CN
zort	坐	zh-CN
zorv	作	zh-CN
zorw	做	zh-CN
zou	左	zh-CN
zov	笮	zh-CN
zovv	笮	zh-CN
zow	琢	zh-CN
zown	琢	zh-CN
zox	怍	zh-CN
zoxv	怍	zh-CN
zoy	酢	zh-CN
zoyv	酢	zh-CN
zrf	攥	zh-CN
zrfx	攥	zh-CN
zrj	钻	zh-CN
zrk	赚	zh-CN
zrs	缵	zh-CN
zrsr	缵	zh-CN
zrv	纂	zh-CN
zrvx	纂	zh-CN
zrz	躜	zh-CN
zrzr	躜	zh-CN
zsa	鬃	zh-CN
zsaw	鬷	zh-CN
zsax	鬃	zh-CN
zsb	宗	zh-CN
zsbr	疭	zh-CN
zsm	棕	zh-CN
zsmr	枞	zh-CN
zsmx	粽	zh-CN
zso	腙	zh-CN
zsox	腙	zh-CN
zsr	偬	zh-CN
zsrx	倧	zh-CN
zss	纵	zh-CN
zssx	综	zh-CN
zsz	踪	zh-CN
zszx	踪	zh-CN
zuc	菹	zh-CN
zucq	菹	zh-CN
zue	阻	zh-CN
zueq	阻	zh-CN
zueu	崒	zh-CN
zuf	族	zh-CN
zuh	租	zh-CN
zuhq	租	zh-CN
zuk	足	zh-CN
zukr	足	zh-CN
zup	祖	zh-CN
zupq	祖	zh-CN
zur	俎	zh-CN
zurq	俎	zh-CN
zus	组	zh-CN
zusq	组	zh-CN
zuw	卒	zh-CN
zuwq	珇	zh-CN
zuy	诅	zh-CN
zuyq	诅	zh-CN
zvc	蕞	zh-CN
zvcy	蕞	zh-CN
zvk	嘴	zh-CN
zvky	嘴	zh-CN
zvmn	槜	zh-CN
zvo	最	zh-CN
zvoy	最	zh-CN
zvs	罪	zh-CN
zvsf	罪	zh-CN
zvv	觜	zh-CN
zvvy	觜	zh-CN
zvy	醉	zh-CN
zvyu	醉	zh-CN
zwa	鲗	zh-CN
zwad	鲗	zh-CN
zwk	贼	zh-CN
zwku	贼	zh-CN
zya	鳟	zh-CN
zyac	鳟	zh-CN
zyb	尊	zh-CN
zybc	尊	zh-CN
zye	嶟	zh-CN
zyec	嶟	zh-CN
zyf	撙	zh-CN
zyjc	𨱔	zh-CN
zyk	噂	zh-CN
zykc	噂	zh-CN
zym	樽	zh-CN
zymc	樽	zh-CN
zyrc	僔	zh-CN
zyz	遵	zh-CN
zyzc	遵	zh-CN
zza	鲰	zh-CN
zzay	鲰	zh-CN
zzd	邹	zh-CN
zze	陬	zh-CN
zzee	鄹	zh-CN
zzey	陬	zh-CN
zzf	奏	zh-CN
zzft	揍	zh-CN
zzm	驺	zh-CN
zzme	驺	zh-CN
zztr	走	zh-CN
zzy	诹	zh-CN
bcb	鸨	zh-CN
bcv	龅	zh-CN
biu	璧	zh-CN
biuu	辟	zh-CN
bkm	槟	zh-CN
bmh	煸	zh-CN
bml	辨	zh-CN
djo	膻	zh-CN
dmv	簟	zh-CN
ffd	汾	zh-CN
fjct	蕃	zh-CN
fjj	钒	zh-CN
fjm	梵	zh-CN
fju	矾	zh-CN
fuf	敷	zh-CN
fuff	麸	zh-CN
fufw	抚	zh-CN
fui	蜉	zh-CN
fuit	蝠	zh-CN
fukc	赙	zh-CN
fuo	脯	zh-CN
fur	俯	zh-CN
furf	佛	zh-CN
fuv	弗	zh-CN
gcm	槁	zh-CN
gem	阁	zh-CN
gsg	汞	zh-CN
gzm	枸	zh-CN
hcd	濠	zh-CN
hed	涸	zh-CN
hek	嗬	zh-CN
hey	𬌗	zh-CN
hlx	恍	zh-CN
hrd	奂	zh-CN
hsd	泓	zh-CN
hud	斛	zh-CN
hvh	烩	zh-CN
hxm	骅	zh-CN
iau	馇	zh-CN
iiv	蚩	zh-CN
iui	蜍	zh-CN
jbl	巾	zh-CN
jbs	矜	zh-CN
jic	蓟	zh-CN
jid	奇	zh-CN
jidj	汲	zh-CN
jie	觊	zh-CN
jih	嵇	zh-CN
jim	骥	zh-CN
jip	系	zh-CN
jis	继	zh-CN
jiu	戟	zh-CN
jiuj	矶	zh-CN
jiv	笈	zh-CN
jiw	玑	zh-CN
jiy	计	zh-CN
jkl	靖	zh-CN
jko	腈	zh-CN
jkx	憬	zh-CN
jmb	煎	zh-CN
jmd	溅	zh-CN
jml	监	zh-CN
jmm	槛	zh-CN
jmv	笕	zh-CN
jmy	戬	zh-CN
jny	醮	zh-CN
jpy	诘	zh-CN
jqb	疚	zh-CN
juc	苣	zh-CN
juj	飓	zh-CN
jum	驹	zh-CN
jux	惧	zh-CN
juz	遽	zh-CN
jxj	镓	zh-CN
kak	咯	zh-CN
klk	贶	zh-CN
lak	喇	zh-CN
lic	荔	zh-CN
lii	厘	zh-CN
liiw	蛎	zh-CN
lil	鹂	zh-CN
lim	骊	zh-CN
liml	栎	zh-CN
lir	俚	zh-CN
lia	吏	zh-CN
liv	蠡	zh-CN
liw	璃	zh-CN
lkd	泠	zh-CN
lkk	囹	zh-CN
lky	羚	zh-CN
lld	粱	zh-CN
lpdd	洌	zh-CN
lqm	骝	zh-CN
lvmk	闾	zh-CN
mig	麋	zh-CN
mkob	暝	zh-CN
mmd	沔	zh-CN
mmdm	湎	zh-CN
moc	蘑	zh-CN
mocm	茉	zh-CN
mog	摩	zh-CN
muc	苜	zh-CN
mwn	媒	zh-CN
pcd	匏	zh-CN
pibk	否	zh-CN
qic	芑	zh-CN
qid	漆	zh-CN
qidd	沏	zh-CN
qim	棋	zh-CN
qimb	骐	zh-CN
qip	祈	zh-CN
qiq	憩	zh-CN
qmb	骞	zh-CN
qmj	铅	zh-CN
qmjq	钎	zh-CN
qryw	醛	zh-CN
sud	觫	zh-CN
svh	燧	zh-CN
taz	遢	zh-CN
tik	嚏	zh-CN
tof	拓	zh-CN
tom	椭	zh-CN
tsm	桐	zh-CN
uei	厍	zh-CN
ufr	伸	zh-CN
ufs	绅	zh-CN
uhx	裳	zh-CN
uiq	舐	zh-CN
uiru	什	zh-CN
uiv	虱	zh-CN
ujd	潸	zh-CN
uun	姝	zh-CN
uur	倏	zh-CN
vam	楂	zh-CN
vgf	拯	zh-CN
vgv	筝	zh-CN
vid	汁	zh-CN
vif	执	zh-CN
vifu	挚	zh-CN
vij	帙	zh-CN
vim	枳	zh-CN
viu	智	zh-CN
vjd	湛	zh-CN
vud	渚	zh-CN
vum	株	zh-CN
wuy	诬	zh-CN
wwc	葳	zh-CN
wwt	畏	zh-CN
xih	熄	zh-CN
xihj	烯	zh-CN
xin	嬉	zh-CN
xio	晞	zh-CN
xip	奚	zh-CN
xiu	硒	zh-CN
xme	岘	zh-CN
xmi	蚬	zh-CN
xmn	娴	zh-CN
xnm	骁	zh-CN
xpd	蟹	zh-CN
xpdn	解	zh-CN
xpm	榭	zh-CN
xpy	谐	zh-CN
xty	谑	zh-CN
xxkj	呷	zh-CN
xyy	醺	zh-CN
yai	衙	zh-CN
yay	讶	zh-CN
ybv	龈	zh-CN
yhd	漾	zh-CN
yhdy	殃	zh-CN
yib	肄	zh-CN
yiby	痍	zh-CN
yicx	艾	zh-CN
yid	沂	zh-CN
yidk	漪	zh-CN
yii	颐	zh-CN
yik	贻	zh-CN
yikr	颐	zh-CN
yikx	翳	zh-CN
yil	翊	zh-CN
yir	伊	zh-CN
yiv	彝	zh-CN
yiw	奕	zh-CN
yix	怡	zh-CN
yixl	翌	zh-CN
yjd	淹	zh-CN
yjdd	奄	zh-CN
yjhh	焱	zh-CN
yjhj	焰	zh-CN
yji	衍	zh-CN
yjig	魇	zh-CN
yjm	檐	zh-CN
yjv	鄢	zh-CN
yjw	琰	zh-CN
ykc	莹	zh-CN
ykg	膺	zh-CN
ykk	鹦	zh-CN
ykm	楹	zh-CN
ykw	嬴	zh-CN
yrd	沅	zh-CN
yrx	鸳	zh-CN
ysd	泳	zh-CN
yua	彧	zh-CN
yuc	萸	zh-CN
yud	浴	zh-CN
yudd	淤	zh-CN
yuk	圄	zh-CN
yur	觎	zh-CN
yus	鹬	zh-CN
yys	纭	zh-CN
zid	渍	zh-CN
a	按	zh-CN
b	吧	zh-CN
c	此	zh-CN
d	打	zh-CN
e	嗯	zh-CN
f	发	zh-CN
g	管	zh-CN
h	化	zh-CN
j	见	zh-CN
k	块	zh-CN
l	立	zh-CN
m	嘛	zh-CN
n	哪	zh-CN
q	期	zh-CN
r	入	zh-CN
s	随	zh-CN
t	它	zh-CN
u	时	zh-CN
v	之	zh-CN
w	位	zh-CN
x	性	zh-CN
y	又	zh-CN
z	子	zh-CN
#小字、部件、偏旁
oba	一	zh-CN
obl	丨	zh-CN
obp	丿	zh-CN
obd	丶	zh-CN
obv	乛	zh-CN
obn	乀	zh-CN
oba	鱼	zh-CN
obb	冖	zh-CN
obb	宀	zh-CN
obb	丷	zh-CN
obb	疒	zh-CN
obb	勹	zh-CN
obb	比左部	zh-CN
obc	艹	zh-CN
obc	廾	zh-CN
obd	冫	zh-CN
obd	氵	zh-CN
obd	⺈	zh-CN
obd	刂	zh-CN
obe	阝	zh-CN
obe	卩	zh-CN
obe	彐	zh-CN
obe	山	zh-CN
obe	见下部	zh-CN
obf	扌	zh-CN
obf	寿带上部	zh-CN
obf	龶	zh-CN
obf	缶	zh-CN
obg	既左部	zh-CN
obg	艮	zh-CN
obg	鬼	zh-CN
obg	革	zh-CN
obg	骨	zh-CN
obh	灬	zh-CN
obh	虍	zh-CN
obh	黑	zh-CN
obh	余下部	zh-CN
obi	彳	zh-CN
obi	亍	zh-CN
obi	虫	zh-CN
obj	钅	zh-CN
obj	金	zh-CN
obj	龹	zh-CN
obk	匚	zh-CN
obk	冂	zh-CN
obk	凵	zh-CN
obk	囗	zh-CN
obk	㠯	zh-CN
obl	耂	zh-CN
obl	立	zh-CN
obl	龙	zh-CN
obm	朩	zh-CN
obn	⺧	zh-CN
obn	牜	zh-CN
obo	日	zh-CN
obo	月	zh-CN
obo	目	zh-CN
obp	礻	zh-CN
obp	衤	zh-CN
obq	犭	zh-CN
obq	求	zh-CN
obq	具其上部	zh-CN
obr	亻	zh-CN
obs	纟	zh-CN
obs	厶	zh-CN
obs	龴	zh-CN
obs	罒	zh-CN
obt	田	zh-CN
obu	饣	zh-CN
obu	龵	zh-CN
obu	𠂇	zh-CN
obu	氺	zh-CN
obu	石	zh-CN
obv	⺮	zh-CN
obv	豸	zh-CN
obw	亠	zh-CN
obw	夂	zh-CN
obw	攵	zh-CN
obw	文	zh-CN
obx	忄	zh-CN
obx	乂	zh-CN
obx	⺌	zh-CN
obx	ッ	zh-CN
obx	⺗	zh-CN
oby	⺷	zh-CN
oby	⺶	zh-CN
oby	讠	zh-CN
oby	𧘇	zh-CN
oby	羊	zh-CN
obz	⻊	zh-CN
obz	廴	zh-CN
obz	辶	zh-CN
ofpp	勹	zh-CN
ofpp	灬	zh-CN
ofpp	冫	zh-CN
ofpp	艹	zh-CN
ofpp	屮	zh-CN
ofpp	辶	zh-CN
ofpp	刂	zh-CN
ofpp	匚	zh-CN
ofpp	阝	zh-CN
ofpp	廾	zh-CN
ofpp	丨	zh-CN
ofpp	虍	zh-CN
ofpp	彐	zh-CN
ofpp	卩	zh-CN
ofpp	钅	zh-CN
ofpp	冂	zh-CN
ofpp	冖	zh-CN
ofpp	宀	zh-CN
ofpp	疒	zh-CN
ofpp	肀	zh-CN
ofpp	丿	zh-CN
ofpp	攵	zh-CN
ofpp	凵	zh-CN
ofpp	犭	zh-CN
ofpp	亻	zh-CN
ofpp	彡	zh-CN
ofpp	饣	zh-CN
ofpp	礻	zh-CN
ofpp	扌	zh-CN
ofpp	氵	zh-CN
ofpp	纟	zh-CN
ofpp	亠	zh-CN
ofpp	囗	zh-CN
ofpp	忄	zh-CN
ofpp	讠	zh-CN
ofpp	衤	zh-CN
ofpp	廴	zh-CN
ofpp	尢	zh-CN
ofpp	夂	zh-CN
ofpp	丶	zh-CN
ofpp	丬	zh-CN
oxa	凹	zh-CN
oxb	百	zh-CN
oxb	白	zh-CN
oxb	八	zh-CN
oxb	卜	zh-CN
oxb	匕	zh-CN
oxb	卞	zh-CN
oxb	不	zh-CN
oxb	巴	zh-CN
oxb	本	zh-CN
oxb	必	zh-CN
oxb	丙	zh-CN
oxb	半	zh-CN
oxb	办	zh-CN
oxc	寸	zh-CN
oxc	才	zh-CN
oxc	匆	zh-CN
oxc	册	zh-CN
oxd	大	zh-CN
oxd	丁	zh-CN
oxd	刀	zh-CN
oxd	歹	zh-CN
oxd	刁	zh-CN
oxd	东	zh-CN
oxd	丹	zh-CN
oxd	电	zh-CN
oxd	氐	zh-CN
oxe	二	zh-CN
oxe	耳	zh-CN
oxe	儿	zh-CN
oxe	而	zh-CN
oxf	非	zh-CN
oxf	方	zh-CN
oxf	飞	zh-CN
oxf	夫	zh-CN
oxf	凡	zh-CN
oxf	甫	zh-CN
oxf	弗	zh-CN
oxf	乏	zh-CN
oxf	丰	zh-CN
oxg	广	zh-CN
oxg	弓	zh-CN
oxg	戈	zh-CN
oxg	工	zh-CN
oxg	瓜	zh-CN
oxg	干	zh-CN
oxg	个	zh-CN
oxg	甘	zh-CN
oxg	丐	zh-CN
oxg	果	zh-CN
oxg	更	zh-CN
oxg	夬	zh-CN
oxh	禾	zh-CN
oxh	户	zh-CN
oxh	互	zh-CN
oxh	乎	zh-CN
oxh	火	zh-CN
oxi	川	zh-CN
oxi	厂	zh-CN
oxi	车	zh-CN
oxi	长	zh-CN
oxi	叉	zh-CN
oxi	尺	zh-CN
oxi	丑	zh-CN
oxi	臣	zh-CN
oxi	成	zh-CN
oxi	垂	zh-CN
oxi	斥	zh-CN
oxi	串	zh-CN
oxi	产	zh-CN
oxi	出	zh-CN
oxj	巾	zh-CN
oxj	几	zh-CN
oxj	九	zh-CN
oxj	斤	zh-CN
oxj	久	zh-CN
oxj	巨	zh-CN
oxj	己	zh-CN
oxj	井	zh-CN
oxj	及	zh-CN
oxj	夹	zh-CN
oxj	甲	zh-CN
oxj	臼	zh-CN
oxj	韭	zh-CN
oxj	戋	zh-CN
oxj	柬	zh-CN
oxj	击	zh-CN
oxk	口	zh-CN
oxk	开	zh-CN
oxk	亏	zh-CN
oxl	了	zh-CN
oxl	力	zh-CN
oxl	乐	zh-CN
oxl	来	zh-CN
oxl	良	zh-CN
oxl	两	zh-CN
oxl	里	zh-CN
oxl	吏	zh-CN
oxl	耒	zh-CN
oxl	卵	zh-CN
oxl	丽	zh-CN
oxm	木	zh-CN
oxm	毛	zh-CN
oxm	米	zh-CN
oxm	门	zh-CN
oxm	马	zh-CN
oxm	皿	zh-CN
oxm	末	zh-CN
oxm	灭	zh-CN
oxm	母	zh-CN
oxm	民	zh-CN
oxm	么	zh-CN
oxm	面	zh-CN
oxn	廿	zh-CN
oxn	女	zh-CN
oxn	牛	zh-CN
oxn	鸟	zh-CN
oxn	乃	zh-CN
oxn	内	zh-CN
oxn	农	zh-CN
oxn	年	zh-CN
oxp	片	zh-CN
oxp	平	zh-CN
oxp	爿	zh-CN
oxq	七	zh-CN
oxq	千	zh-CN
oxq	犬	zh-CN
oxq	且	zh-CN
oxq	丘	zh-CN
oxq	曲	zh-CN
oxq	气	zh-CN
oxq	乞	zh-CN
oxr	人	zh-CN
oxr	入	zh-CN
oxr	冉	zh-CN
oxr	壬	zh-CN
oxr	刃	zh-CN
oxs	三	zh-CN
oxs	巳	zh-CN
oxs	肃	zh-CN
oxt	土	zh-CN
oxt	天	zh-CN
oxt	太	zh-CN
oxt	屯	zh-CN
oxu	十	zh-CN
oxu	尸	zh-CN
oxu	士	zh-CN
oxu	手	zh-CN
oxu	身	zh-CN
oxu	水	zh-CN
oxu	上	zh-CN
oxu	少	zh-CN
oxu	术	zh-CN
oxu	失	zh-CN
oxu	生	zh-CN
oxu	世	zh-CN
oxu	申	zh-CN
oxu	史	zh-CN
oxu	升	zh-CN
oxu	事	zh-CN
oxu	书	zh-CN
oxu	束	zh-CN
oxu	勺	zh-CN
oxu	戍	zh-CN
oxu	豕	zh-CN
oxu	氏	zh-CN
oxu	矢	zh-CN
oxv	止	zh-CN
oxv	爪	zh-CN
oxv	主	zh-CN
oxv	舟	zh-CN
oxv	之	zh-CN
oxv	正	zh-CN
oxv	丈	zh-CN
oxv	中	zh-CN
oxv	专	zh-CN
oxv	朱	zh-CN
oxv	州	zh-CN
oxv	重	zh-CN
oxv	乍	zh-CN
oxw	王	zh-CN
oxw	瓦	zh-CN
oxw	五	zh-CN
oxw	无	zh-CN
oxw	万	zh-CN
oxw	午	zh-CN
oxw	亡	zh-CN
oxw	未	zh-CN
oxw	乌	zh-CN
oxw	韦	zh-CN
oxw	勿	zh-CN
oxw	为	zh-CN
oxw	戊	zh-CN
oxw	我	zh-CN
oxw	丸	zh-CN
oxw	兀	zh-CN
oxx	小	zh-CN
oxx	西	zh-CN
oxx	心	zh-CN
oxx	血	zh-CN
oxx	下	zh-CN
oxx	夕	zh-CN
oxx	乡	zh-CN
oxx	习	zh-CN
oxx	戌	zh-CN
oxy	又	zh-CN
oxy	酉	zh-CN
oxy	已	zh-CN
oxy	于	zh-CN
oxy	义	zh-CN
oxy	与	zh-CN
oxy	夭	zh-CN
oxy	玉	zh-CN
oxy	牙	zh-CN
oxy	丫	zh-CN
oxy	永	zh-CN
oxy	尤	zh-CN
oxy	也	zh-CN
oxy	业	zh-CN
oxy	由	zh-CN
oxy	央	zh-CN
oxy	亚	zh-CN
oxy	严	zh-CN
oxy	用	zh-CN
oxy	幺	zh-CN
oxy	禺	zh-CN
oxy	臾	zh-CN
oxy	尹	zh-CN
oxy	禹	zh-CN
oxy	夷	zh-CN
oxy	弋	zh-CN
oxy	聿	zh-CN
oxy	雨	zh-CN
oxz	再	zh-CN
oxz	自	zh-CN
oxz	子	zh-CN