# Gboard Dictionary version:1
aadb	嗷嗷待哺	zh-CN
aajj	安安静静	zh-CN
aapp	矮矮胖胖	zh-CN
aaqq	安安全全	zh-CN
aaww	安安稳稳	zh-CN
aaxx	安安心心	zh-CN
abbd	按兵不动	zh-CN
abbu	哀兵必胜	zh-CN
abdg	安邦定国	zh-CN
abdi	安步当车	zh-CN
abdy	阿鼻地狱	zh-CN
abhz	阿布哈兹	zh-CN
abjb	按部就班	zh-CN
ablk	爱别离苦	zh-CN
ablm	鞍不离马	zh-CN
abuu	爱不释手	zh-CN
abvb	阿布扎比	zh-CN
acrk	爱才若渴	zh-CN
acrm	爱财如命	zh-CN
acuj	暗藏杀机	zh-CN
acxj	暗藏玄机	zh-CN
adic	暗渡陈仓	zh-CN
adly	澳大利亚	zh-CN
adwg	暗淡无光	zh-CN
adwn	安度晚年	zh-CN
aeje	阿尔及尔	zh-CN
afuj	安分守己	zh-CN
agjy	爱岗敬业	zh-CN
aguy	熬更守夜	zh-CN
agvy	爱国主义	zh-CN
ahby	哀鸿遍野	zh-CN
ahri	安好如初	zh-CN
aixy	暗潮汹涌	zh-CN
ajah	挨家挨户	zh-CN
ajcb	挨肩擦背	zh-CN
ajlh	安家落户	zh-CN
ajly	安居乐业	zh-CN
ajmd	阿基米德	zh-CN
ajnf	暗箭难防	zh-CN
ajur	暗箭伤人	zh-CN
akbk	爱看不看	zh-CN
albb	阿里巴巴	zh-CN
albl	爱理不理	zh-CN
alfp	按劳分配	zh-CN
alpk	奥林匹克	zh-CN
alqi	按劳取酬	zh-CN
amag	阿猫阿狗	zh-CN
amld	鞍马劳顿	zh-CN
amnv	爱莫能助	zh-CN
amrz	爱民如子	zh-CN
amvx	爱美之心	zh-CN
amwq	奥妙无穷	zh-CN
anbv	按捺不住	zh-CN
anby	懊恼不已	zh-CN
apld	安贫乐道	zh-CN
aqbv	哀其不争	zh-CN
aqdy	安全第一	zh-CN
aqmh	鞍前马后	zh-CN
aqrm	爱钱如命	zh-CN
artl	傲然挺立	zh-CN
artu	安如泰山	zh-CN
arus	黯然失色	zh-CN
aruu	黯然神伤	zh-CN
arwy	安然无恙	zh-CN
arxh	黯然销魂	zh-CN
aryl	傲然屹立	zh-CN
asbj	阿塞拜疆	zh-CN
asjm	爱斯基摩	zh-CN
aspl	阿司匹林	zh-CN
asqb	暗送秋波	zh-CN
atbp	凹凸不平	zh-CN
atkq	暗通款曲	zh-CN
atsj	按图索骥	zh-CN
atyj	哀痛欲绝	zh-CN
auaj	碍手碍脚	zh-CN
aubu	爱说不说	zh-CN
aukb	昂首阔步	zh-CN
aulm	安身立命	zh-CN
auny	爱沙尼亚	zh-CN
auqx	傲视群雄	zh-CN
autq	唉声叹气	zh-CN
autx	昂首挺胸	zh-CN
auvd	安身之地	zh-CN
auvi	安身之处	zh-CN
auvl	安史之乱	zh-CN
avew	安枕而卧	zh-CN
avff	安知非福	zh-CN
avms	暗中摸索	zh-CN
avrs	安之若素	zh-CN
avwy	安枕无忧	zh-CN
awjw	爱屋及乌	zh-CN
awtr	暗无天日	zh-CN
axbx	爱信不信	zh-CN
axcz	暗箱操作	zh-CN
axfp	按需分配	zh-CN
axjl	爱新觉罗	zh-CN
axuy	暗香疏影	zh-CN
axym	爱惜羽毛	zh-CN
ayst	爱因斯坦	zh-CN
ayvv	安营扎寨	zh-CN
ayxv	安于现状	zh-CN
azfm	爱憎分明	zh-CN
azpc	腌臜泼才	zh-CN
bael	北爱尔兰	zh-CN
bahx	不安好心	zh-CN
bbbk	不卑不亢	zh-CN
bbdn	百般刁难	zh-CN
bbds	巴巴多斯	zh-CN
bbdv	不必当真	zh-CN
bbdy	逼不得已	zh-CN
bbiy	百步穿杨	zh-CN
bbjb	步步紧逼	zh-CN
bbju	比比皆是	zh-CN
bbjx	步步惊心	zh-CN
bbku	必不可少	zh-CN
bbll	斑驳陆离	zh-CN
bbmm	爸爸妈妈	zh-CN
bbpp	白白胖胖	zh-CN
bbtt	蹦蹦跳跳	zh-CN
bbum	帮不上忙	zh-CN
bbuu	并不是说	zh-CN
bbvd	并不知道	zh-CN
bbvj	八拜之交	zh-CN
bbvw	不辨真伪	zh-CN
bbvy	不白之冤	zh-CN
bbwn	被逼无奈	zh-CN
bbwx	白璧微瑕	zh-CN
bbwy	步步为营	zh-CN
bbxr	兵不血刃	zh-CN
bbxy	并不需要	zh-CN
bbyd	并不一定	zh-CN
bbyl	彬彬有礼	zh-CN
bbyv	兵不厌诈	zh-CN
bbzy	不必在意	zh-CN
bceb	不辞而别	zh-CN
bcfy	不测风云	zh-CN
bcgm	本草纲目	zh-CN
bchx	包藏祸心	zh-CN
bcjd	不存芥蒂	zh-CN
bckr	病从口入	zh-CN
bclk	不辞劳苦	zh-CN
bcmb	百辞莫辩	zh-CN
bcuq	抱残守缺	zh-CN
bcwn	博茨瓦纳	zh-CN
bdbl	宝刀不老	zh-CN
bdbq	百毒不侵	zh-CN
bdbx	不大不小	zh-CN
bdby	百读不厌	zh-CN
bdei	背道而驰	zh-CN
bdeq	拔地而起	zh-CN
bdev	不得而知	zh-CN
bdhs	不得好死	zh-CN
bdjg	兵多将广	zh-CN
bdjw	不懂就问	zh-CN
bdkh	遍地开花	zh-CN
bdkn	不大可能	zh-CN
bdlg	布达拉宫	zh-CN
bdll	不得了了	zh-CN
bdmd	不达目的	zh-CN
bdnl	表达能力	zh-CN
bdqf	不得其法	zh-CN
bdqs	不得其所	zh-CN
bdqx	北斗七星	zh-CN
bdru	不动如山	zh-CN
bdrx	不得人心	zh-CN
bdsi	冰冻三尺	zh-CN
bdtg	不断提高	zh-CN
bdti	拔得头筹	zh-CN
bdus	不动声色	zh-CN
bduv	不得善终	zh-CN
bdvd	不懂装懂	zh-CN
bdwl	不得无礼	zh-CN
bdwu	不断完善	zh-CN
bdxv	拔刀相助	zh-CN
bdyl	弊大于利	zh-CN
bdyv	步调一致	zh-CN
bdzv	不打自招	zh-CN
beb	博而不精	zh-CN
bebj	避而不见	zh-CN
bebt	避而不谈	zh-CN
befm	不二法门	zh-CN
bels	白俄罗斯	zh-CN
bevk	巴尔扎克	zh-CN
bevx	不二之选	zh-CN
bfbv	百发百中	zh-CN
bfcc	白发苍苍	zh-CN
bfcu	不负此生	zh-CN
bfcz	不复存在	zh-CN
bfdx	百废待兴	zh-CN
bfku	白费口舌	zh-CN
bflq	白费力气	zh-CN
bfqr	不乏其人	zh-CN
bfst	不负所托	zh-CN
bfty	悲愤填膺	zh-CN
bfuh	不负韶华	zh-CN
bfvb	百分之百	zh-CN
bfvt	不法之徒	zh-CN
bfvw	不负众望	zh-CN
bfvy	百分之一	zh-CN
bfxj	白费心机	zh-CN
bfxv	不分轩轾	zh-CN
bfxw	不法行为	zh-CN
bfzr	不负责任	zh-CN
bgbd	半工半读	zh-CN
bgbg	不管不顾	zh-CN
bgbi	笔耕不辍	zh-CN
bgbj	不干不净	zh-CN
bgbl	包工包料	zh-CN
bgdt	不共戴天	zh-CN
bgee	不过尔尔	zh-CN
bggt	不敢苟同	zh-CN
bgjj	百感交集	zh-CN
bgjm	不甘寂寞	zh-CN
bglh	不甘落后	zh-CN
bglj	八国联军	zh-CN
bgll	波光粼粼	zh-CN
bglm	不敢掠美	zh-CN
bgqx	卑躬屈膝	zh-CN
bgrc	不过如此	zh-CN
bgsg	闭关锁国	zh-CN
bgtj	博古通今	zh-CN
bgty	不关痛痒	zh-CN
bguj	半个世纪	zh-CN
bgur	不甘示弱	zh-CN
bgus	兵贵神速	zh-CN
bguy	杯弓蛇影	zh-CN
bgvf	秉公执法	zh-CN
bgvt	半个钟头	zh-CN
bgws	秉公无私	zh-CN
bgwu	别跟我说	zh-CN
bgwx	报告文学	zh-CN
bgxq	不感兴趣	zh-CN
bgxu	半个小时	zh-CN
bgxx	不敢相信	zh-CN
bgyq	不顾一切	zh-CN
bgys	不够意思	zh-CN
bgyx	不苟言笑	zh-CN
bgzp	不攻自破	zh-CN
bgzu	闭关自守	zh-CN
bhbm	不慌不忙	zh-CN
bhdd	变化多端	zh-CN
bhdr	不遑多让	zh-CN
bhel	不寒而栗	zh-CN
bhes	不欢而散	zh-CN
bhgl	别鹤孤鸾	zh-CN
bhgx	北回归线	zh-CN
bhhy	不怀好意	zh-CN
bhil	不合常理	zh-CN
bhlh	悲欢离合	zh-CN
bhli	白鹤亮翅	zh-CN
bhmc	变幻莫测	zh-CN
bhml	兵荒马乱	zh-CN
bhqf	百花齐放	zh-CN
bhuy	不合时宜	zh-CN
bhvn	不惑之年	zh-CN
bhvt	抱恨终天	zh-CN
bhvy	百花争艳	zh-CN
bhwi	变幻无常	zh-CN
bhwq	变化无穷	zh-CN
bhxp	冰魂雪魄	zh-CN
bhys	不好意思	zh-CN
bibj	罢黜百家	zh-CN
bibn	不吵不闹	zh-CN
bibv	把持不住	zh-CN
biby	百吃不厌	zh-CN
bify	不成方圆	zh-CN
bigh	百川归海	zh-CN
bigt	百尺竿头	zh-CN
bihl	不差毫厘	zh-CN
bijv	别出机杼	zh-CN
bijx	备尝艰辛	zh-CN
bijy	不成敬意	zh-CN
bimj	鞭长莫及	zh-CN
biqw	不成其为	zh-CN
bisl	不出所料	zh-CN
bitt	不成体统	zh-CN
biwt	不成问题	zh-CN
bixc	别出心裁	zh-CN
bixh	报仇雪恨	zh-CN
bixw	不耻下问	zh-CN
biyr	不齿于人	zh-CN
bjbl	半斤八两	zh-CN
bjbs	不见不散	zh-CN
bjbx	不疾不徐	zh-CN
bjbz	不骄不躁	zh-CN
bjcs	饱经沧桑	zh-CN
bjdj	不计代价	zh-CN
bjdl	不记得了	zh-CN
bjdn	不减当年	zh-CN
bjdx	北京大学	zh-CN
bjel	比肩而立	zh-CN
bjev	不教而诛	zh-CN
bjey	比较而言	zh-CN
bjez	不胫而走	zh-CN
bjfq	不解风情	zh-CN
bjfu	饱经风霜	zh-CN
bjgx	白驹过隙	zh-CN
bjhh	保驾护航	zh-CN
bjjv	不见经传	zh-CN
bjlx	背井离乡	zh-CN
bjly	保加利亚	zh-CN
bjmz	不讲面子	zh-CN
bjqq	并驾齐驱	zh-CN
bjqu	不计其数	zh-CN
bjqx	不计前嫌	zh-CN
bjrc	不仅如此	zh-CN
bjrq	不近人情	zh-CN
bjru	不久人世	zh-CN
bjry	不尽人意	zh-CN
bjsc	悲剧色彩	zh-CN
bjsl	不见森林	zh-CN
bjss	不假思索	zh-CN
bjst	巴基斯坦	zh-CN
bjtr	不见天日	zh-CN
bjvd	必经之地	zh-CN
bjvj	败军之将	zh-CN
bjvl	必经之路	zh-CN
bjvm	百家争鸣	zh-CN
bjvt	不经之谈	zh-CN
bjvy	不解之缘	zh-CN
bjwg	保家卫国	zh-CN
bjwm	不尽完美	zh-CN
bjxj	不拘小节	zh-CN
bjxt	不尽相同	zh-CN
bjyd	败局已定	zh-CN
bjyg	别具一格	zh-CN
bjyh	不久以后	zh-CN
bjyq	不讲义气	zh-CN
bjzt	不进则退	zh-CN
bkby	百看不厌	zh-CN
bkdd	不可多得	zh-CN
bkev	不可遏制	zh-CN
bkfr	不可否认	zh-CN
bkgl	不可估量	zh-CN
bkgr	不可告人	zh-CN
bkhq	不可或缺	zh-CN
bkhu	不堪回首	zh-CN
bkjd	不可兼得	zh-CN
bkkj	不可开交	zh-CN
bkly	不可理喻	zh-CN
bkmb	百口莫辩	zh-CN
bkmm	不可磨灭	zh-CN
bkmv	不可名状	zh-CN
bknb	不可能吧	zh-CN
bknd	不可能的	zh-CN
bkpf	不可偏废	zh-CN
bkqj	不可企及	zh-CN
bkqu	百科全书	zh-CN
bkre	不堪入耳	zh-CN
bkrm	不堪入目	zh-CN
bkry	宾客如云	zh-CN
bksy	不可思议	zh-CN
bkum	别开生面	zh-CN
bkux	不堪设想	zh-CN
bkvf	不堪重负	zh-CN
bkvm	不可捉摸	zh-CN
bkxx	不可想象	zh-CN
bkyd	不可以的	zh-CN
bkyi	不可言传	zh-CN
bkyj	不堪一击	zh-CN
bkym	不可以吗	zh-CN
bkyv	不可言状	zh-CN
bkyy	不可言喻	zh-CN
bkzc	不可造次	zh-CN
blbj	波澜不惊	zh-CN
blbl	不伦不类	zh-CN
blbq	不离不弃	zh-CN
blbr	不冷不热	zh-CN
blbx	奔流不息	zh-CN
blby	表里不一	zh-CN
blcj	不吝赐教	zh-CN
bldh	波罗的海	zh-CN
bldx	薄利多销	zh-CN
bleh	不劳而获	zh-CN
blfl	别浪费了	zh-CN
blfm	不露锋芒	zh-CN
blfv	拨乱反正	zh-CN
blfy	不良反应	zh-CN
blig	百炼成钢	zh-CN
blih	鬓乱钗横	zh-CN
blij	半路出家	zh-CN
blix	兵临城下	zh-CN
bljd	兵来将挡	zh-CN
bljj	濒临绝境	zh-CN
bljl	不良记录	zh-CN
blju	本来就是	zh-CN
blkf	暴力抗法	zh-CN
blkj	不落窠臼	zh-CN
blll	筚路蓝缕	zh-CN
bllv	不了了之	zh-CN
blmm	本来面目	zh-CN
blpu	步履蹒跚	zh-CN
blqm	不留情面	zh-CN
blqr	壁立千仞	zh-CN
blqu	博览群书	zh-CN
blry	表里如一	zh-CN
blse	布鲁塞尔	zh-CN
blst	巴勒斯坦	zh-CN
blsy	壁垒森严	zh-CN
blth	白里透红	zh-CN
blty	百里挑一	zh-CN
blus	不露声色	zh-CN
blvj	不吝指教	zh-CN
blvk	波澜壮阔	zh-CN
blwi	逼良为娼	zh-CN
blwj	步履维艰	zh-CN
blwx	包罗万象	zh-CN
blwy	别来无恙	zh-CN
blxn	半老徐娘	zh-CN
blyd	不留余地	zh-CN
blyw	本来以为	zh-CN
blzi	不良资产	zh-CN
bmbb	不明不白	zh-CN
bmeh	不谋而合	zh-CN
bmlf	八面来风	zh-CN
bmnf	班门弄斧	zh-CN
bmnu	不瞒你说	zh-CN
bmqv	不谋其政	zh-CN
bmsg	闭门思过	zh-CN
bmuk	表面上看	zh-CN
bmvd	不毛之地	zh-CN
bmvv	百忙之中	zh-CN
bmvx	不明真相	zh-CN
bmvy	笔墨纸砚	zh-CN
bmwf	八面威风	zh-CN
bmwv	表面文章	zh-CN
bmwz	白马王子	zh-CN
bmxi	宝马香车	zh-CN
bmxx	表面现象	zh-CN
bmyq	不名一钱	zh-CN
bmyw	不名一文	zh-CN
bmzy	不鸣则已	zh-CN
bnbn	不男不女	zh-CN
bnby	百年不遇	zh-CN
bnhh	百年好合	zh-CN
bnif	百鸟朝凤	zh-CN
bnje	不念旧恶	zh-CN
bnki	不难看出	zh-CN
bnny	百年难遇	zh-CN
bnxf	笨鸟先飞	zh-CN
bnxx	不难想象	zh-CN
bnzb	不能自拔	zh-CN
bnzy	不能自已	zh-CN
bpby	不偏不倚	zh-CN
bplj	杯盘狼藉	zh-CN
bpyt	白跑一趟	zh-CN
bpyw	不怕一万	zh-CN
bqau	不欺暗室	zh-CN
bqbi	不清不楚	zh-CN
bqbn	不屈不挠	zh-CN
bqdx	不确定性	zh-CN
bqev	不期而至	zh-CN
bqey	不期而遇	zh-CN
bqlv	鼻青脸肿	zh-CN
bqmv	兵强马壮	zh-CN
bqnu	屏气凝神	zh-CN
bqrq	避其锐气	zh-CN
bqsy	版权所有	zh-CN
bqu	不求甚解	zh-CN
bquj	不切实际	zh-CN
bqut	搬起石头	zh-CN
bqvq	不情之请	zh-CN
bqyg	不求有功	zh-CN
bqyj	冰清玉洁	zh-CN
bqzl	不请自来	zh-CN
bqzy	不起作用	zh-CN
brbs	勃然变色	zh-CN
brby	不仁不义	zh-CN
brdh	不然的话	zh-CN
brdn	勃然大怒	zh-CN
brf	白日飞升	zh-CN
brfu	不容分说	zh-CN
brgh	病入膏肓	zh-CN
brhi	步人后尘	zh-CN
brhu	不容忽视	zh-CN
brhx	不入虎穴	zh-CN
brlg	不容乐观	zh-CN
brum	不辱使命	zh-CN
brvg	步入正轨	zh-CN
brvh	不容置喙	zh-CN
brvu	不忍直视	zh-CN
brvy	不容置疑	zh-CN
brxj	兵戎相见	zh-CN
brxq	不容小觑	zh-CN
bryu	不容有失	zh-CN
brzd	不忍卒读	zh-CN
brzm	白日做梦	zh-CN
bsbh	半死不活	zh-CN
bsbj	百思不解	zh-CN
bsbs	不三不四	zh-CN
bsbx	不死不休	zh-CN
bshg	不思悔改	zh-CN
bsjq	不思进取	zh-CN
bskb	白色恐怖	zh-CN
bsln	巴塞罗那	zh-CN
bsny	波斯尼亚	zh-CN
bsvk	不速之客	zh-CN
bswy	必死无疑	zh-CN
btbj	半推半就	zh-CN
btbk	不吐不快	zh-CN
btbn	笨头笨脑	zh-CN
btby	不痛不痒	zh-CN
btdj	八抬大轿	zh-CN
btdl	白头到老	zh-CN
btdr	不同的人	zh-CN
btdu	不停的说	zh-CN
btef	半途而废	zh-CN
btfs	不同凡俗	zh-CN
btfx	不同凡响	zh-CN
bthl	冰糖葫芦	zh-CN
bthy	白天黑夜	zh-CN
btid	不同程度	zh-CN
btkn	不太可能	zh-CN
btlj	不太了解	zh-CN
btlu	遍体鳞伤	zh-CN
btlx	不太理想	zh-CN
btmb	不太明白	zh-CN
btmr	悲天悯人	zh-CN
btqi	不太清楚	zh-CN
btrl	暴跳如雷	zh-CN
bttk	抱头痛哭	zh-CN
bttw	暴殄天物	zh-CN
btuc	抱头鼠窜	zh-CN
btuh	遍体生寒	zh-CN
btvi	不同之处	zh-CN
btvj	不同政见	zh-CN
btxd	冰天雪地	zh-CN
btxi	不同寻常	zh-CN
btxl	白头偕老	zh-CN
btxy	波涛汹涌	zh-CN
btyb	不提也罢	zh-CN
btyj	悲痛欲绝	zh-CN
btyy	不太一样	zh-CN
bubl	百试百灵	zh-CN
bubs	半身不遂	zh-CN
bubu	半生不熟	zh-CN
bubx	不声不响	zh-CN
bubz	比上不足	zh-CN
bufy	饱受非议	zh-CN
buhd	不识好歹	zh-CN
buhi	班师回朝	zh-CN
buhu	白山黑水	zh-CN
buix	杯水车薪	zh-CN
buja	备受煎熬	zh-CN
bujl	不胜酒力	zh-CN
bujx	避实就虚	zh-CN
bukh	宝山空回	zh-CN
bukl	百事可乐	zh-CN
bulu	逼上梁山	zh-CN
buml	不甚明了	zh-CN
buqf	不胜其烦	zh-CN
buqj	白手起家	zh-CN
buqx	冰释前嫌	zh-CN
burx	不胜荣幸	zh-CN
butj	不识抬举	zh-CN
buuj	不失时机	zh-CN
buuw	不识时务	zh-CN
buvr	饱食终日	zh-CN
buvx	不时之需	zh-CN
buwm	榜上无名	zh-CN
buwt	不是问题	zh-CN
buwy	必输无疑	zh-CN
buxw	博士学位	zh-CN
buyb	不说也罢	zh-CN
buyg	不是一个	zh-CN
buyj	冰山一角	zh-CN
buym	榜上有名	zh-CN
buyv	背水一战	zh-CN
buyy	败事有余	zh-CN
bvb	不着边际	zh-CN
bvbb	包治百病	zh-CN
bvbd	百战不殆	zh-CN
bvbh	百折不回	zh-CN
bvbj	不知不觉	zh-CN
bvbk	不折不扣	zh-CN
bvbl	保质保量	zh-CN
bvbn	百折不挠	zh-CN
bvbu	百战百胜	zh-CN
bvby	半遮半掩	zh-CN
bvdl	不知道了	zh-CN
bveu	不战而胜	zh-CN
bvgz	本职工作	zh-CN
bvhd	不知好歹	zh-CN
bvhj	不着痕迹	zh-CN
bvhx	屏住呼吸	zh-CN
bvhz	白纸黑字	zh-CN
bvjl	不知就里	zh-CN
bvjq	避重就轻	zh-CN
bvjt	不知进退	zh-CN
bvkf	不置可否	zh-CN
bvli	不知廉耻	zh-CN
bvqe	不知其二	zh-CN
bvqv	不知轻重	zh-CN
bvqx	不知去向	zh-CN
bvrg	宾至如归	zh-CN
bvrw	不知肉味	zh-CN
bvsc	不知所措	zh-CN
bvsv	不知所终	zh-CN
bvsy	不知所云	zh-CN
bvuq	不知深浅	zh-CN
bvus	不知生死	zh-CN
bvvd	必争之地	zh-CN
bvvf	不正之风	zh-CN
bvvj	伯仲之间	zh-CN
bvvv	不治之症	zh-CN
bvwh	不知为何	zh-CN
bvxi	不知羞耻	zh-CN
bvyb	不至于吧	zh-CN
bvyc	不止一次	zh-CN
bvyl	报之以李	zh-CN
bvyt	不值一提	zh-CN
bvyu	不值一哂	zh-CN
bvyv	白纸一张	zh-CN
bvyw	不值一文	zh-CN
bvyy	秉烛夜游	zh-CN
bvzv	敝帚自珍	zh-CN
bwbh	不温不火	zh-CN
bwbw	不闻不问	zh-CN
bwcx	不枉此行	zh-CN
bwgx	不无关系	zh-CN
bwiw	别无长物	zh-CN
bwjj	百无禁忌	zh-CN
bwjy	保外就医	zh-CN
bwkv	不问可知	zh-CN
bwqb	不畏强暴	zh-CN
bwqj	博闻强记	zh-CN
bwqu	不畏权势	zh-CN
bwqv	博闻强识	zh-CN
bwrv	不为人知	zh-CN
bwsd	不为所动	zh-CN
bwsq	别无所求	zh-CN
bwtf	别无他法	zh-CN
bwtt	别无他途	zh-CN
bwtw	别无他物	zh-CN
bwvq	比武招亲	zh-CN
bwvy	不务正业	zh-CN
bwwq	不为瓦全	zh-CN
bwxz	别无选择	zh-CN
bwyy	百无一用	zh-CN
bxaa	白雪皑皑	zh-CN
bxbf	不修边幅	zh-CN
bxbj	不徐不疾	zh-CN
bxbt	本乡本土	zh-CN
bxby	半信半疑	zh-CN
bxcm	冰雪聪明	zh-CN
bxcx	不虚此行	zh-CN
bxdc	博学多才	zh-CN
bxdh	彪形大汉	zh-CN
bxdu	不想多说	zh-CN
bxdx	碧血丹心	zh-CN
bxeg	败兴而归	zh-CN
bxgb	不惜工本	zh-CN
bxgd	兵行诡道	zh-CN
bxgh	八仙过海	zh-CN
bxgv	白雪公主	zh-CN
bxiu	笔下超生	zh-CN
bxjh	抱薪救火	zh-CN
bxjj	悲喜交集	zh-CN
bxlw	本小利微	zh-CN
bxly	标新立异	zh-CN
bxnu	屏息凝神	zh-CN
bxny	本性难移	zh-CN
bxqj	保险起见	zh-CN
bxqv	败絮其中	zh-CN
bxqy	背信弃义	zh-CN
bxru	不省人事	zh-CN
bxsq	不徇私情	zh-CN
bxux	不相上下	zh-CN
bxvv	不祥之兆	zh-CN
bxwj	冰消瓦解	zh-CN
bxwm	不相为谋	zh-CN
bxwu	不学无术	zh-CN
bxyg	不屑一顾	zh-CN
bxyv	不幸言中	zh-CN
bxyy	比下有余	zh-CN
bxzs	不肖子孙	zh-CN
bybr	不依不饶	zh-CN
bybu	百依百顺	zh-CN
byby	不阴不阳	zh-CN
bydh	必要的话	zh-CN
bydt	别有洞天	zh-CN
bydu	不用多说	zh-CN
bydv	不要当真	zh-CN
byef	不翼而飞	zh-CN
byet	不约而同	zh-CN
byey	不言而喻	zh-CN
byez	不一而足	zh-CN
byfu	不由分说	zh-CN
byfw	别有风味	zh-CN
byhf	必有后福	zh-CN
byhx	必有回响	zh-CN
byjl	不宜久留	zh-CN
byjr	拨云见日	zh-CN
bykq	不用客气	zh-CN
bylc	不予理睬	zh-CN
bylh	不亦乐乎	zh-CN
bylq	饱以老拳	zh-CN
bylv	比翼连枝	zh-CN
byqf	不厌其烦	zh-CN
bysg	半夜三更	zh-CN
bytd	别有天地	zh-CN
bytu	白衣天使	zh-CN
byuf	比翼双飞	zh-CN
byuu	布衣蔬食	zh-CN
byvc	不义之财	zh-CN
byvj	布衣之交	zh-CN
byvl	必由之路	zh-CN
byvp	不予置评	zh-CN
bywi	不以为耻	zh-CN
bywl	不远万里	zh-CN
bywr	不以为然	zh-CN
bywx	白玉无瑕	zh-CN
bywy	不以为意	zh-CN
byxh	闭月羞花	zh-CN
byxu	便宜行事	zh-CN
byyd	不一样的	zh-CN
byyh	不亦说乎	zh-CN
byyl	不遗余力	zh-CN
byyx	别有用心	zh-CN
byzv	不由自主	zh-CN
bzbw	不早不晚	zh-CN
bzcl	不在此列	zh-CN
bzgi	不足挂齿	zh-CN
bzhx	不在话下	zh-CN
bzlj	憋足了劲	zh-CN
bzll	不自量力	zh-CN
bzlu	笔走龙蛇	zh-CN
bzmi	败走麦城	zh-CN
bzmq	摆在面前	zh-CN
bzmy	不怎么样	zh-CN
bzns	抱子弄孙	zh-CN
bzqw	不在其位	zh-CN
bzud	不择手段	zh-CN
bzvi	百足之虫	zh-CN
bzwg	不足为怪	zh-CN
bzwj	不足为据	zh-CN
bzwl	不足为虑	zh-CN
bzwp	不足为凭	zh-CN
bzwq	不足为奇	zh-CN
bzwx	不足为训	zh-CN
bzxg	奔走相告	zh-CN
bzym	不足与谋	zh-CN
cbbj	残兵败将	zh-CN
cbbl	寸步不离	zh-CN
cbbr	残暴不仁	zh-CN
cbdj	残编断简	zh-CN
cbdy	词不达意	zh-CN
cbjf	猝不及防	zh-CN
cblv	残杯冷炙	zh-CN
cbnx	寸步难行	zh-CN
cbrd	惨不忍睹	zh-CN
cbwh	慈悲为怀	zh-CN
ccbd	措辞不当	zh-CN
ccbl	寸草不留	zh-CN
ccbq	参差不齐	zh-CN
ccbu	寸草不生	zh-CN
cccl	参差错落	zh-CN
ccdm	璀璨夺目	zh-CN
cclu	草草了事	zh-CN
ccmm	匆匆忙忙	zh-CN
ccrn	凑凑热闹	zh-CN
ccui	草草收场	zh-CN
ccuw	草草收尾	zh-CN
ccyh	从此以后	zh-CN
cddx	从大到小	zh-CN
cdqc	财大气粗	zh-CN
cdwy	此地无银	zh-CN
cfsl	餐风宿露	zh-CN
cfyl	餐风饮露	zh-CN
cgbd	才高八斗	zh-CN
cgdj	从古到今	zh-CN
cglv	残羹冷炙	zh-CN
cguf	残羹剩饭	zh-CN
cgvj	从古至今	zh-CN
cgww	菜过五味	zh-CN
cgyh	挫骨扬灰	zh-CN
chbl	残花败柳	zh-CN
chdd	采花大盗	zh-CN
chel	从何而来	zh-CN
chgr	聪慧过人	zh-CN
chhy	才华横溢	zh-CN
chit	仓皇出逃	zh-CN
chiv	才华出众	zh-CN
chnf	错恨难返	zh-CN
chst	沧海桑田	zh-CN
chuc	仓皇失措	zh-CN
chuq	从何说起	zh-CN
chys	沧海一粟	zh-CN
chyv	沧海遗珠	zh-CN
chyx	存乎一心	zh-CN
chzj	此话怎讲	zh-CN
cibh	此唱彼和	zh-CN
cibq	层出不穷	zh-CN
cidf	粗茶淡饭	zh-CN
cijj	草船借箭	zh-CN
cijy	从长计议	zh-CN
ciyk	从长远看	zh-CN
cjch	曾经沧海	zh-CN
cjeg	擦肩而过	zh-CN
cjhu	曾几何时	zh-CN
cjrh	惨绝人寰	zh-CN
cjrl	从谏如流	zh-CN
cjrm	草菅人命	zh-CN
cjtq	从今天起	zh-CN
cjwh	从今往后	zh-CN
cjyh	从今以后	zh-CN
cjyx	辞旧迎新	zh-CN
cjzy	促进作用	zh-CN
cklx	摧枯拉朽	zh-CN
clbi	错漏百出	zh-CN
clbt	此路不通	zh-CN
clby	从来不用	zh-CN
cldm	灿烂夺目	zh-CN
clhh	灿烂辉煌	zh-CN
clku	从零开始	zh-CN
clmy	从来没有	zh-CN
clwh	藏龙卧虎	zh-CN
clyv	错落有致	zh-CN
cmcv	聪明才智	zh-CN
cmeu	侧目而视	zh-CN
cmjb	草木皆兵	zh-CN
cmjd	聪明绝顶	zh-CN
cmll	聪明伶俐	zh-CN
cmtq	从明天起	zh-CN
cmum	慈眉善目	zh-CN
cmuq	才貌双全	zh-CN
cmvy	摧眉折腰	zh-CN
cmxl	猜枚行令	zh-CN
cmxq	财迷心窍	zh-CN
cmyb	策马扬鞭	zh-CN
cmyg	从没有过	zh-CN
cmyu	聪明一世	zh-CN
cmyx	草莽英雄	zh-CN
cnyh	从那以后	zh-CN
cpdj	残篇断简	zh-CN
cqbf	此起彼伏	zh-CN
cqbq	残缺不全	zh-CN
cqgr	才气过人	zh-CN
cqxl	猜拳行令	zh-CN
cqyv	藏巧于拙	zh-CN
cqzh	擦枪走火	zh-CN
crbp	从容不迫	zh-CN
crfj	催人奋进	zh-CN
crfx	灿若繁星	zh-CN
crjy	从容就义	zh-CN
crlx	催人泪下	zh-CN
cryd	从容应对	zh-CN
cscb	苍松翠柏	zh-CN
csju	财色兼收	zh-CN
cskk	沧桑坎坷	zh-CN
csmj	才思敏捷	zh-CN
ctbr	寸土不让	zh-CN
ctbv	寸土必争	zh-CN
ctdw	从头到尾	zh-CN
ctej	从天而降	zh-CN
ctku	从头开始	zh-CN
ctlg	从头来过	zh-CN
ctlw	藏头露尾	zh-CN
ctsy	蹉跎岁月	zh-CN
ctwm	粗通文墨	zh-CN
ctzl	从头再来	zh-CN
ctzu	苍天在上	zh-CN
cubj	措手不及	zh-CN
cucd	此时此地	zh-CN
cuck	此时此刻	zh-CN
cucu	草率从事	zh-CN
cudx	从上到下	zh-CN
cugr	才识过人	zh-CN
cujc	错上加错	zh-CN
cujt	蚕食鲸吞	zh-CN
culj	错失良机	zh-CN
cuqj	厕身其间	zh-CN
curl	从善如流	zh-CN
cuvd	藏身之地	zh-CN
cuvv	从始至终	zh-CN
cuxq	才疏学浅	zh-CN
cuzh	次生灾害	zh-CN
cvdy	粗枝大叶	zh-CN
cvgj	操之过急	zh-CN
cvlz	粗制滥造	zh-CN
cvyl	从中渔利	zh-CN
cvyn	残渣余孽	zh-CN
cvyv	藏着掖着	zh-CN
cvyx	粗中有细	zh-CN
cvzg	从中作梗	zh-CN
cwbi	错误百出	zh-CN
cwdy	从无到有	zh-CN
cwjg	从未见过	zh-CN
cwjx	存亡绝续	zh-CN
cwng	藏污纳垢	zh-CN
cwrd	惨无人道	zh-CN
cwyg	从未有过	zh-CN
cxdd	从小到大	zh-CN
cxdy	粗心大意	zh-CN
cxny	藏形匿影	zh-CN
cxql	才想起来	zh-CN
cxtx	促膝谈心	zh-CN
cyby	采阴补阳	zh-CN
cydb	残垣断壁	zh-CN
cyev	从一而终	zh-CN
cygg	财源滚滚	zh-CN
cygj	财源广进	zh-CN
cyht	财运亨通	zh-CN
cyiy	此言差矣	zh-CN
cykn	才有可能	zh-CN
cyku	从一开始	zh-CN
cylz	呲牙咧嘴	zh-CN
cypf	村野匹夫	zh-CN
cyvx	恻隐之心	zh-CN
czdw	从早到晚	zh-CN
czfz	错综复杂	zh-CN
czjr	才子佳人	zh-CN
czjx	踩在脚下	zh-CN
czlp	错字连篇	zh-CN
cznj	藏踪蹑迹	zh-CN
czqj	厕足其间	zh-CN
cztl	惨遭屠戮	zh-CN
czxt	操作系统	zh-CN
dbbp	打抱不平	zh-CN
dbcy	断壁残垣	zh-CN
dbdd	得不到的	zh-CN
dbdl	大包大揽	zh-CN
dbfr	大部分人	zh-CN
dbgt	对簿公堂	zh-CN
dbil	打不出来	zh-CN
dbiu	得不偿失	zh-CN
dbiy	大病初愈	zh-CN
dbku	大败亏输	zh-CN
dbld	大不列颠	zh-CN
dblx	大步流星	zh-CN
dbml	淡泊名利	zh-CN
dbmv	淡泊明志	zh-CN
dbqj	调兵遣将	zh-CN
dbrl	倒背如流	zh-CN
dbrq	大不如前	zh-CN
dbrw	代表人物	zh-CN
dbtx	独步天下	zh-CN
dbuh	对不上号	zh-CN
dbuu	多不胜数	zh-CN
dbux	待办事项	zh-CN
dbvd	都不知道	zh-CN
dbxj	短兵相接	zh-CN
dbxp	东奔西跑	zh-CN
dbxz	东奔西走	zh-CN
dbyd	倒不一定	zh-CN
dbyf	大饱眼福	zh-CN
dbyi	大病一场	zh-CN
dbyu	独步一时	zh-CN
dbyy	都不一样	zh-CN
dcdb	大慈大悲	zh-CN
dcdy	多才多艺	zh-CN
dcjb	德才兼备	zh-CN
dcji	得寸进尺	zh-CN
dctc	大错特错	zh-CN
dcwv	到此为止	zh-CN
dcxy	大材小用	zh-CN
ddbd	当断不断	zh-CN
ddbh	多多包涵	zh-CN
ddbr	咄咄逼人	zh-CN
ddbt	胆大包天	zh-CN
ddbv	多多保重	zh-CN
ddbx	喋喋不休	zh-CN
ddcc	躲躲藏藏	zh-CN
dddd	点点滴滴	zh-CN
dddq	大敌当前	zh-CN
dddx	独断独行	zh-CN
ddff	大大方方	zh-CN
ddfh	单刀赴会	zh-CN
ddgg	大动干戈	zh-CN
ddgu	咄咄怪事	zh-CN
ddgv	多多关照	zh-CN
ddhb	颠倒黑白	zh-CN
ddhf	打道回府	zh-CN
ddhr	打得火热	zh-CN
ddix	得道成仙	zh-CN
ddjv	点到即止	zh-CN
ddkf	大刀阔斧	zh-CN
ddll	大大咧咧	zh-CN
ddls	道德沦丧	zh-CN
ddmm	弟弟妹妹	zh-CN
ddqf	跌宕起伏	zh-CN
ddqk	颠倒乾坤	zh-CN
ddqq	的的确确	zh-CN
ddrl	对答如流	zh-CN
ddss	哆哆嗦嗦	zh-CN
dduf	颠倒是非	zh-CN
ddur	大多数人	zh-CN
dduy	地动山摇	zh-CN
ddvf	当地政府	zh-CN
ddvj	多多指教	zh-CN
ddvk	大打折扣	zh-CN
ddvr	单刀直入	zh-CN
ddvv	兜兜转转	zh-CN
ddvx	独断专行	zh-CN
ddwb	地大物博	zh-CN
ddwv	点到为止	zh-CN
ddwx	当代文学	zh-CN
ddxc	东躲西藏	zh-CN
ddxi	代代相传	zh-CN
ddxw	东倒西歪	zh-CN
ddxx	断断续续	zh-CN
ddym	独当一面	zh-CN
ddyp	倒打一耙	zh-CN
ddyy	颠倒阴阳	zh-CN
debf	当耳边风	zh-CN
dedd	大恩大德	zh-CN
dehv	大而化之	zh-CN
deld	吊儿郎当	zh-CN
depf	当耳旁风	zh-CN
deww	淡而无味	zh-CN
dfcb	大发慈悲	zh-CN
dfdg	大富大贵	zh-CN
dfdj	巅峰对决	zh-CN
dfdl	大风大浪	zh-CN
dfhv	洞房花烛	zh-CN
dfjc	大放厥词	zh-CN
dflt	大发雷霆	zh-CN
dfpp	大腹便便	zh-CN
dfsw	答非所问	zh-CN
dfuj	打发时间	zh-CN
dfuu	大幅上升	zh-CN
dfuv	大幅上涨	zh-CN
dfuy	大幅上扬	zh-CN
dfvf	地方政府	zh-CN
dfvj	大方之家	zh-CN
dfvv	大费周章	zh-CN
dfxc	大幅下挫	zh-CN
dfxd	大幅下跌	zh-CN
dfxj	大幅下降	zh-CN
dfyc	大放异彩	zh-CN
dfyw	荡妇淫娃	zh-CN
dfzj	登峰造极	zh-CN
dfzr	道法自然	zh-CN
dfzy	毒副作用	zh-CN
dgbf	打个比方	zh-CN
dgbv	丢官罢职	zh-CN
dgdh	打个电话	zh-CN
dggi	大功告成	zh-CN
dghu	电光火石	zh-CN
dgjy	刀光剑影	zh-CN
dgng	渡过难关	zh-CN
dgqg	得过且过	zh-CN
dgrx	地广人稀	zh-CN
dgvm	达观知命	zh-CN
dgvy	帝国主义	zh-CN
dgws	大公无私	zh-CN
dgwv	德高望重	zh-CN
dgxg	达官显贵	zh-CN
dgxu	多管闲事	zh-CN
dgyh	登高一呼	zh-CN
dgyi	道高一尺	zh-CN
dgzy	打躬作揖	zh-CN
dhbj	大惑不解	zh-CN
dhdj	大喊大叫	zh-CN
dhdl	大红大绿	zh-CN
dhdz	大红大紫	zh-CN
dhhh	灯火辉煌	zh-CN
dhhm	电话号码	zh-CN
dhhu	大好河山	zh-CN
dhhy	电话会议	zh-CN
dhie	打黑除恶	zh-CN
dhjl	灯红酒绿	zh-CN
dhjv	刁滑奸诈	zh-CN
dhll	大汗淋漓	zh-CN
dhlt	大祸临头	zh-CN
dhlv	大海捞针	zh-CN
dhqu	大获全胜	zh-CN
dhrz	对号入座	zh-CN
dhug	大好时光	zh-CN
dhuv	定海神针	zh-CN
dhxj	大呼小叫	zh-CN
didl	大吹大擂	zh-CN
didw	大彻大悟	zh-CN
difj	大乘佛教	zh-CN
difl	大吹法螺	zh-CN
dikx	东床快婿	zh-CN
diqj	洞察其奸	zh-CN
disy	得偿所愿	zh-CN
diuf	东窗事发	zh-CN
dixc	冬虫夏草	zh-CN
dixj	雕虫小技	zh-CN
diyp	打成一片	zh-CN
diyv	达成一致	zh-CN
djbf	打击报复	zh-CN
djcw	低级错误	zh-CN
djdg	对酒当歌	zh-CN
djdq	大江东去	zh-CN
djdx	东京大学	zh-CN
djeg	待价而沽	zh-CN
djff	大家风范	zh-CN
djfy	刀锯斧钺	zh-CN
djgl	大驾光临	zh-CN
djgx	大家闺秀	zh-CN
djhy	独具慧眼	zh-CN
djjl	殚精竭虑	zh-CN
djld	当机立断	zh-CN
djlj	弹尽粮绝	zh-CN
djnb	大江南北	zh-CN
djqw	低级趣味	zh-CN
djru	堆积如山	zh-CN
djti	地久天长	zh-CN
djup	担惊受怕	zh-CN
djus	大惊失色	zh-CN
djvb	点睛之笔	zh-CN
djvm	当局者迷	zh-CN
djwv	大局为重	zh-CN
djxg	大惊小怪	zh-CN
djxx	大街小巷	zh-CN
djyd	大局已定	zh-CN
djyg	独具一格	zh-CN
djzv	当家做主	zh-CN
dkbb	大可不必	zh-CN
dkdy	大快朵颐	zh-CN
dkhu	多快好省	zh-CN
dkld	大开绿灯	zh-CN
dknh	豆蔻年华	zh-CN
dkqj	丢盔弃甲	zh-CN
dkrx	大快人心	zh-CN
dktx	刀口舔血	zh-CN
dkuj	大开杀戒	zh-CN
dkvd	待客之道	zh-CN
dkwv	大块文章	zh-CN
dkxj	丢盔卸甲	zh-CN
dkyj	大开眼界	zh-CN
dlbl	的黎波里	zh-CN
dlby	得来不易	zh-CN
dldd	多劳多得	zh-CN
dldf	颠鸾倒凤	zh-CN
dldq	颠来倒去	zh-CN
dldw	独来独往	zh-CN
dlet	夺路而逃	zh-CN
dlfs	独领风骚	zh-CN
dlhd	雕梁画栋	zh-CN
dljx	打了鸡血	zh-CN
dlmb	顶礼膜拜	zh-CN
dlqg	等量齐观	zh-CN
dlql	多了去了	zh-CN
dlrh	地利人和	zh-CN
dlth	地老天荒	zh-CN
dltu	大浪淘沙	zh-CN
dlvc	栋梁之材	zh-CN
dlvi	大力支持	zh-CN
dlwu	得陇望蜀	zh-CN
dlxi	东拉西扯	zh-CN
dlxv	鼎力相助	zh-CN
dlym	大老爷们	zh-CN
dlzv	独立自主	zh-CN
dmar	道貌岸然	zh-CN
dmdd	大名鼎鼎	zh-CN
dmdy	大模大样	zh-CN
dmei	夺门而出	zh-CN
dmix	大梦初醒	zh-CN
dmnj	多米尼加	zh-CN
dmnk	多米尼克	zh-CN
dmnv	独木难支	zh-CN
dmud	多谋善断	zh-CN
dmuy	低眉顺眼	zh-CN
dmvy	低眉折腰	zh-CN
dmxg	等米下锅	zh-CN
dnbd	大逆不道	zh-CN
dnbs	大难不死	zh-CN
dnck	顿涅茨克	zh-CN
dndx	东南大学	zh-CN
dniy	大年初一	zh-CN
dnlt	大难临头	zh-CN
dnlu	对你来说	zh-CN
dntq	对牛弹琴	zh-CN
dnxb	东南西北	zh-CN
dnyl	多年以来	zh-CN
dnzm	当牛做马	zh-CN
dpbp	颠扑不破	zh-CN
dpll	颠沛流离	zh-CN
dpxc	东拼西凑	zh-CN
dpxj	独辟蹊径	zh-CN
dpxu	短篇小说	zh-CN
dpyj	跌破眼镜	zh-CN
dqbr	刀枪不入	zh-CN
dqbz	底气不足	zh-CN
dqdl	大起大落	zh-CN
dqhi	荡气回肠	zh-CN
dqjj	刀枪剑戟	zh-CN
dqmq	打情骂俏	zh-CN
dqpb	大气磅礴	zh-CN
dqpl	大权旁落	zh-CN
dqpm	单枪匹马	zh-CN
dqrc	的确如此	zh-CN
dqrk	刀枪入库	zh-CN
dqrv	大巧若拙	zh-CN
dqsz	得其所哉	zh-CN
dquj	大千世界	zh-CN
dquz	底气十足	zh-CN
dqwg	但求无过	zh-CN
dqwi	大器晚成	zh-CN
dqwr	敌强我弱	zh-CN
dqxk	东瞧西看	zh-CN
dqzw	大权在握	zh-CN
drbr	当仁不让	zh-CN
drdy	大仁大义	zh-CN
drgh	洞若观火	zh-CN
driv	淡然处之	zh-CN
drjw	待人接物	zh-CN
drkm	遁入空门	zh-CN
drmj	呆若木鸡	zh-CN
drnm	多如牛毛	zh-CN
drrn	度日如年	zh-CN
drsa	夺人所爱	zh-CN
drsh	夺人所好	zh-CN
drtt	动如脱兔	zh-CN
drug	代人受过	zh-CN
drvm	达人知命	zh-CN
drwc	荡然无存	zh-CN
drxp	动人心魄	zh-CN
drxx	动人心弦	zh-CN
drxy	丢人现眼	zh-CN
dryd	低人一等	zh-CN
dryx	淡然一笑	zh-CN
dsls	丢三落四	zh-CN
dsxs	低三下四	zh-CN
dtbd	动弹不得	zh-CN
dtbh	当头棒喝	zh-CN
dtby	低头不语	zh-CN
dtdh	得天独厚	zh-CN
dtdn	呆头呆脑	zh-CN
dtfd	洞天福地	zh-CN
dtfy	党同伐异	zh-CN
dtgv	大庭广众	zh-CN
dthy	点头哈腰	zh-CN
dtir	打铁趁热	zh-CN
dtld	顶天立地	zh-CN
dtlu	对他来说	zh-CN
dtru	登堂入室	zh-CN
dttg	打退堂鼓	zh-CN
dttu	道听途说	zh-CN
dttx	刀头舔血	zh-CN
dtus	顶头上司	zh-CN
dtxd	大体相当	zh-CN
dtxm	东涂西抹	zh-CN
dtxy	大同小异	zh-CN
dtxz	大题小作	zh-CN
dtyb	当头一棒	zh-CN
dubl	滴水不漏	zh-CN
ducb	得失参半	zh-CN
dudf	大是大非	zh-CN
dudj	大手大脚	zh-CN
dudq	嗲声嗲气	zh-CN
dufj	大煞风景	zh-CN
duhh	刀山火海	zh-CN
duhx	大事化小	zh-CN
duhy	大受欢迎	zh-CN
duij	点石成金	zh-CN
dujh	大声疾呼	zh-CN
dukf	独守空房	zh-CN
dulm	电闪雷鸣	zh-CN
dunl	多少年来	zh-CN
dunq	多少年前	zh-CN
dupv	大事铺张	zh-CN
dusq	大势所趋	zh-CN
dusw	大失所望	zh-CN
dutx	大赦天下	zh-CN
duvq	多事之秋	zh-CN
duwf	但说无妨	zh-CN
duwy	多说无益	zh-CN
duxq	低声下气	zh-CN
duyd	多少有点	zh-CN
duyq	大势已去	zh-CN
duyv	独树一帜	zh-CN
duyx	多少有些	zh-CN
duzn	独生子女	zh-CN
duzq	东山再起	zh-CN
dvat	独占鳌头	zh-CN
dvay	斗志昂扬	zh-CN
dvdh	大智大慧	zh-CN
dvdj	动辄得咎	zh-CN
dvdy	斗智斗勇	zh-CN
dvfv	大政方针	zh-CN
dvht	大展宏图	zh-CN
dvjg	党政机关	zh-CN
dvqg	大张旗鼓	zh-CN
dvqj	洞烛其奸	zh-CN
dvqy	断章取义	zh-CN
dvry	大智若愚	zh-CN
dvux	斗折蛇行	zh-CN
dvwg	敌众我寡	zh-CN
dvwk	当之无愧	zh-CN
dvwx	得之我幸	zh-CN
dvxj	胆战心惊	zh-CN
dvxt	东征西讨	zh-CN
dvxw	东张西望	zh-CN
dvxy	对症下药	zh-CN
dvyq	动之以情	zh-CN
dvyx	大专院校	zh-CN
dwbt	大为不同	zh-CN
dwcl	断无此理	zh-CN
dwdl	独往独来	zh-CN
dwez	达斡尔族	zh-CN
dwju	读万卷书	zh-CN
dwjx	帝王将相	zh-CN
dwlu	对我来说	zh-CN
dwsr	睹物思人	zh-CN
dwuj	党委书记	zh-CN
dwvd	弹丸之地	zh-CN
dwvj	当务之急	zh-CN
dwxf	弹无虚发	zh-CN
dxal	大兴安岭	zh-CN
dxbg	打小报告	zh-CN
dxbk	大卸八块	zh-CN
dxby	大学毕业	zh-CN
dxdb	大喜大悲	zh-CN
dxdh	涤瑕荡秽	zh-CN
dxfv	断线风筝	zh-CN
dxgw	大喜过望	zh-CN
dxhf	旦夕祸福	zh-CN
dxjh	短小精悍	zh-CN
dxjn	妒贤嫉能	zh-CN
dxjt	大相径庭	zh-CN
dxnb	东西南北	zh-CN
dxnu	倒行逆施	zh-CN
dxpu	胆小怕事	zh-CN
dxqd	大行其道	zh-CN
dxqj	大学期间	zh-CN
dxqu	独行其是	zh-CN
dxqy	大型企业	zh-CN
dxru	胆小如鼠	zh-CN
dxsd	大写锁定	zh-CN
dxtm	大兴土木	zh-CN
dxut	大显神通	zh-CN
dxuu	大显身手	zh-CN
dxuv	等闲视之	zh-CN
dxvb	等闲之辈	zh-CN
dxvj	旦夕之间	zh-CN
dxvp	断袖之癖	zh-CN
dxxj	带薪休假	zh-CN
dxxy	大学校园	zh-CN
dxyu	得心应手	zh-CN
dyba	大洋彼岸	zh-CN
dybc	大言不惭	zh-CN
dybf	东亚病夫	zh-CN
dybl	倒也罢了	zh-CN
dyby	大有裨益	zh-CN
dycb	断垣残壁	zh-CN
dydb	大摇大摆	zh-CN
dydr	大鱼大肉	zh-CN
dydz	多有得罪	zh-CN
dyfv	打预防针	zh-CN
dyhe	等一会儿	zh-CN
dyjh	答疑解惑	zh-CN
dyju	第一件事	zh-CN
dykw	大有可为	zh-CN
dylr	大义凛然	zh-CN
dymq	大义灭亲	zh-CN
dymu	得意门生	zh-CN
dypp	大雨瓢泼	zh-CN
dypt	大雨滂沱	zh-CN
dyqi	低吟浅唱	zh-CN
dyqq	大异其趣	zh-CN
dyqx	掉以轻心	zh-CN
dyrc	但愿如此	zh-CN
dyrz	大有人在	zh-CN
dytj	第一桶金	zh-CN
dyux	德艺双馨	zh-CN
dyvt	大雅之堂	zh-CN
dyvv	地缘政治	zh-CN
dyvy	多云转阴	zh-CN
dyvz	得意之作	zh-CN
dywe	独一无二	zh-CN
dywx	得意忘形	zh-CN
dyxb	东摇西摆	zh-CN
dyyd	盗亦有道	zh-CN
dyyy	得意洋洋	zh-CN
dyzw	大有作为	zh-CN
dzbx	胆子不小	zh-CN
dzdc	多姿多彩	zh-CN
dzdn	多灾多难	zh-CN
dzdu	多嘴多舌	zh-CN
dzem	抵足而眠	zh-CN
dzgg	刁钻古怪	zh-CN
dzgv	待字闺中	zh-CN
dzjs	断子绝孙	zh-CN
dzkb	刁钻刻薄	zh-CN
dzlg	戴罪立功	zh-CN
dzsf	鼎足三分	zh-CN
dzuw	电子商务	zh-CN
dzvu	鼎足之势	zh-CN
dzwv	大做文章	zh-CN
dzyr	独自一人	zh-CN
dzyx	电子邮箱	zh-CN
ebhk	耳鼻喉科	zh-CN
ebjr	二八佳人	zh-CN
ebsm	耳鬓厮磨	zh-CN
ecmm	耳聪目明	zh-CN
edyj	恩断义绝	zh-CN
eeaa	恩恩爱爱	zh-CN
eeds	鄂尔多斯	zh-CN
eenn	厄尔尼诺	zh-CN
efvy	二分之一	zh-CN
egbd	峨冠博带	zh-CN
egde	厄瓜多尔	zh-CN
egmy	恶贯满盈	zh-CN
egqj	耳根清净	zh-CN
ehbu	二话不说	zh-CN
ehmu	二话没说	zh-CN
ehpu	饿虎扑食	zh-CN
ejib	恩将仇报	zh-CN
eliz	鄂伦春族	zh-CN
elvn	而立之年	zh-CN
elxv	二龙戏珠	zh-CN
emdx	鹅毛大雪	zh-CN
emtf	阿弥陀佛	zh-CN
emvv	恶名昭彰	zh-CN
emyx	耳目一新	zh-CN
endz	婀娜多姿	zh-CN
eniq	儿女成群	zh-CN
enqi	儿女情长	zh-CN
ermr	耳濡目染	zh-CN
esmt	儿孙满堂	zh-CN
esux	饿死事小	zh-CN
etbf	耳听八方	zh-CN
etby	儿童不宜	zh-CN
etmm	耳提面命	zh-CN
etwx	儿童文学	zh-CN
etzz	恩同再造	zh-CN
eueq	恶声恶气	zh-CN
euiq	额手称庆	zh-CN
eunx	耳熟能详	zh-CN
euuj	二十世纪	zh-CN
evru	恩重如山	zh-CN
ewbu	恩威并施	zh-CN
ewbv	恩威并重	zh-CN
ewit	扼腕长叹	zh-CN
ewkz	鄂温克族	zh-CN
ewmd	耳闻目睹	zh-CN
ewux	耳闻是虚	zh-CN
exxh	恶性循环	zh-CN
eyeb	恶有恶报	zh-CN
eyfi	阿谀奉承	zh-CN
eyfm	恩怨分明	zh-CN
eyfy	阿谀逢迎	zh-CN
eyht	二氧化碳	zh-CN
eyqi	恩怨情仇	zh-CN
eyur	恶语伤人	zh-CN
eyvu	恶语中伤	zh-CN
eywv	尔虞我诈	zh-CN
eyxj	恶语相加	zh-CN
fbcv	风必摧之	zh-CN
fbdz	罚不当罪	zh-CN
fbgu	奋不顾身	zh-CN
fblx	分崩离析	zh-CN
fbud	腹背受敌	zh-CN
fbuf	防不胜防	zh-CN
fbvm	方便之门	zh-CN
fbwu	反败为胜	zh-CN
fbxi	非比寻常	zh-CN
fbzv	法不责众	zh-CN
fcbl	方寸不乱	zh-CN
fcjb	非此即彼	zh-CN
fcls	风餐露宿	zh-CN
fcml	服从命令	zh-CN
fcvd	方寸之地	zh-CN
fcvv	凡此种种	zh-CN
fcyl	方寸已乱	zh-CN
fczx	父慈子孝	zh-CN
fdbj	放荡不羁	zh-CN
fddt	福地洞天	zh-CN
fddx	复旦大学	zh-CN
fdgj	发达国家	zh-CN
fdix	釜底抽薪	zh-CN
fdli	蜚短流长	zh-CN
fdmb	奋斗目标	zh-CN
fdpp	风度翩翩	zh-CN
fdyb	分道扬镳	zh-CN
fdyv	粉雕玉琢	zh-CN
fefh	飞蛾赴火	zh-CN
feml	福尔马林	zh-CN
fems	福尔摩斯	zh-CN
feph	飞蛾扑火	zh-CN
fevv	分而治之	zh-CN
ffbb	缝缝补补	zh-CN
ffdc	丰富多彩	zh-CN
ffdd	疯疯癫癫	zh-CN
ffet	泛泛而谈	zh-CN
fffy	芬芳馥郁	zh-CN
fffz	纷繁复杂	zh-CN
ffgg	风风光光	zh-CN
ffhq	夫复何求	zh-CN
ffii	浮浮沉沉	zh-CN
ffil	反腐倡廉	zh-CN
ffrr	纷纷扰扰	zh-CN
ffsd	非法所得	zh-CN
ffsz	凡夫俗子	zh-CN
fftq	奋发图强	zh-CN
fftt	服服帖帖	zh-CN
ffvx	非分之想	zh-CN
ffvy	肺腑之言	zh-CN
ffwi	反复无常	zh-CN
ffxu	奋发向上	zh-CN
ffyy	风风雨雨	zh-CN
ffzz	贩夫走卒	zh-CN
fgak	富贵安康	zh-CN
fgbr	富贵逼人	zh-CN
fgfl	发光发亮	zh-CN
fgiu	飞鸽传书	zh-CN
fgly	浮光掠影	zh-CN
fgrh	富贵荣华	zh-CN
fgwj	丰功伟绩	zh-CN
fgwt	法国梧桐	zh-CN
fgwx	风光无限	zh-CN
fgxx	反戈相向	zh-CN
fgxy	封官许愿	zh-CN
fgyn	风光旖旎	zh-CN
fgzj	放歌纵酒	zh-CN
fgzt	富贵在天	zh-CN
fgzw	反躬自问	zh-CN
fgzx	反躬自省	zh-CN
fhgu	放虎归山	zh-CN
fhjd	风华绝代	zh-CN
fhlj	繁华落尽	zh-CN
fhlp	废话连篇	zh-CN
fhlv	峰回路转	zh-CN
fhly	凤凰来仪	zh-CN
fhrl	风和日丽	zh-CN
fhsj	繁花似锦	zh-CN
fhtd	飞黄腾达	zh-CN
fhul	发号施令	zh-CN
fhvm	风华正茂	zh-CN
fhwj	分化瓦解	zh-CN
fhwr	防患未然	zh-CN
fhxy	风花雪月	zh-CN
fhyf	凤凰于飞	zh-CN
fhzy	发挥作用	zh-CN
fibq	非常抱歉	zh-CN
fiby	非常必要	zh-CN
ficd	风吹草动	zh-CN
fidi	风驰电掣	zh-CN
fidj	付出代价	zh-CN
fifi	非常非常	zh-CN
fifs	夫唱妇随	zh-CN
fify	非处方药	zh-CN
figj	非常关键	zh-CN
figx	非常感谢	zh-CN
fijd	非常简单	zh-CN
fijm	非常紧密	zh-CN
fiju	非常及时	zh-CN
fikn	非常困难	zh-CN
fikx	非常可惜	zh-CN
fild	风吹浪打	zh-CN
filj	非常理解	zh-CN
fill	风尘碌碌	zh-CN
fimq	非常密切	zh-CN
fimx	非常明显	zh-CN
fing	非常难过	zh-CN
fipb	非常普遍	zh-CN
fipp	风尘仆仆	zh-CN
fipt	非常普通	zh-CN
fiqi	非常清楚	zh-CN
firv	非常认真	zh-CN
firy	非常容易	zh-CN
fiuk	非常深刻	zh-CN
fium	浮出水面	zh-CN
fiuq	非常时期	zh-CN
fiur	非常深入	zh-CN
fivu	非常重视	zh-CN
fivw	非池中物	zh-CN
fivy	非常重要	zh-CN
fiwr	非诚勿扰	zh-CN
fixh	非常喜欢	zh-CN
fixj	反唇相讥	zh-CN
fixw	非常希望	zh-CN
fiyd	风吹雨打	zh-CN
fiyg	非常严格	zh-CN
fiys	风吹云散	zh-CN
fiyv	非常严重	zh-CN
fiyx	非常有限	zh-CN
fizx	逢场作戏	zh-CN
fjcy	风卷残云	zh-CN
fjdh	翻江倒海	zh-CN
fjdi	非机动车	zh-CN
fjjd	非奸即盗	zh-CN
fjku	费尽口舌	zh-CN
fjqz	负荆请罪	zh-CN
fjvf	发家致富	zh-CN
fjvj	反间之计	zh-CN
fjvl	缚鸡之力	zh-CN
fjvx	抚今追昔	zh-CN
fjxj	费尽心机	zh-CN
fjxs	费尽心思	zh-CN
fjyf	富甲一方	zh-CN
fkdg	富可敌国	zh-CN
fklj	风口浪尖	zh-CN
fkwv	反客为主	zh-CN
flcz	风流才子	zh-CN
flel	焚林而猎	zh-CN
flfm	非驴非马	zh-CN
flfq	翻来覆去	zh-CN
flhh	飞来横祸	zh-CN
flht	返老还童	zh-CN
fliv	法轮常转	zh-CN
fliz	泛滥成灾	zh-CN
flkf	法兰克福	zh-CN
flkh	风流快活	zh-CN
flrm	纷乱如麻	zh-CN
flrw	风流人物	zh-CN
flry	风流儒雅	zh-CN
flth	富丽堂皇	zh-CN
fltt	风流倜傥	zh-CN
fluq	福禄双全	zh-CN
flvk	饭来张口	zh-CN
flwb	法力无边	zh-CN
flwd	非礼勿动	zh-CN
flwt	非礼勿听	zh-CN
flwu	非礼勿视	zh-CN
flwy	非礼勿言	zh-CN
flxd	父老兄弟	zh-CN
flxh	放浪形骸	zh-CN
flxq	父老乡亲	zh-CN
flxs	风流潇洒	zh-CN
flxy	扶老携幼	zh-CN
flyd	弗洛伊德	zh-CN
flyu	风流韵事	zh-CN
flzt	飞龙在天	zh-CN
fmb	分门别类	zh-CN
fmbl	锋芒毕露	zh-CN
fmbr	锋芒逼人	zh-CN
fmbv	分秒必争	zh-CN
fmdi	粉墨登场	zh-CN
fmii	反目成仇	zh-CN
fmlj	凤毛麟角	zh-CN
fmsx	锋芒所向	zh-CN
fmvk	防民之口	zh-CN
fmxs	伐毛洗髓	zh-CN
fmys	负面因素	zh-CN
fmyu	风靡一时	zh-CN
fmzy	负面作用	zh-CN
fngj	逢年过节	zh-CN
fnmu	非你莫属	zh-CN
fnvu	分内之事	zh-CN
fpgv	返璞归真	zh-CN
fplj	风平浪静	zh-CN
fqfg	非亲非故	zh-CN
fqfk	分期付款	zh-CN
fqvh	焚琴煮鹤	zh-CN
fqvv	奋起直追	zh-CN
fqvx	风气之先	zh-CN
fqwh	房前屋后	zh-CN
fqwu	废寝忘食	zh-CN
fqwv	风情万种	zh-CN
fqyd	风轻云淡	zh-CN
fqyy	风起云涌	zh-CN
fqyz	封妻荫子	zh-CN
fqzu	飞禽走兽	zh-CN
frby	怫然不悦	zh-CN
frdh	福如东海	zh-CN
frdx	辅仁大学	zh-CN
frfq	繁荣富强	zh-CN
frhw	翻然悔悟	zh-CN
friu	繁荣昌盛	zh-CN
frjv	妇孺皆知	zh-CN
frnv	肤如凝脂	zh-CN
frqg	夫荣妻贵	zh-CN
frum	奉若神明	zh-CN
frus	发人深思	zh-CN
frux	发人深省	zh-CN
frvr	妇人之仁	zh-CN
frzl	放任自流	zh-CN
frzs	怫然作色	zh-CN
fsbk	非死不可	zh-CN
fssw	发散思维	zh-CN
ftde	肥头大耳	zh-CN
ftdh	赴汤蹈火	zh-CN
ftex	非同儿戏	zh-CN
ftfd	翻天覆地	zh-CN
ftfx	非同凡响	zh-CN
ftiy	奉天承运	zh-CN
ftkl	分庭抗礼	zh-CN
ftrq	风土人情	zh-CN
ftxi	非同寻常	zh-CN
ftxk	非同小可	zh-CN
ftyb	非同一般	zh-CN
ftyu	风调雨顺	zh-CN
fufj	缚手缚脚	zh-CN
fugx	发生关系	zh-CN
fuhl	风声鹤唳	zh-CN
fujs	愤世嫉俗	zh-CN
fuju	俯拾皆是	zh-CN
fuki	乏善可陈	zh-CN
funu	覆水难收	zh-CN
fuqt	福寿齐天	zh-CN
furm	浮生若梦	zh-CN
fusg	粉身碎骨	zh-CN
fute	俯首帖耳	zh-CN
fuuq	风生水起	zh-CN
fuvt	飞上枝头	zh-CN
fuwj	福寿无疆	zh-CN
fuyl	翻山越岭	zh-CN
fuzl	犯上作乱	zh-CN
fvcn	风烛残年	zh-CN
fvdl	付诸东流	zh-CN
fvqu	反治其身	zh-CN
fvtl	纷至沓来	zh-CN
fvvt	复制粘贴	zh-CN
fvxd	付诸行动	zh-CN
fvxl	福至心灵	zh-CN
fvyj	付之一炬	zh-CN
fvyq	粉妆玉砌	zh-CN
fvyr	反之亦然	zh-CN
fvyv	粉妆玉琢	zh-CN
fvzh	父债子还	zh-CN
fvzx	飞针走线	zh-CN
fwbq	分文不取	zh-CN
fwbv	分文不值	zh-CN
fwgn	奉为圭臬	zh-CN
fwhh	法网恢恢	zh-CN
fwke	法外开恩	zh-CN
fwrj	繁文缛节	zh-CN
fwzl	非我族类	zh-CN
fxbx	放心不下	zh-CN
fxdd	繁星点点	zh-CN
fxdg	翻箱倒柜	zh-CN
fxeq	拂袖而去	zh-CN
fxgv	福星高照	zh-CN
fxhj	逢凶化吉	zh-CN
fxjh	负薪救火	zh-CN
fxlb	焚香礼拜	zh-CN
fxlp	浮想联翩	zh-CN
fxmy	焚香沐浴	zh-CN
fxry	赴险如夷	zh-CN
fxtd	放下屠刀	zh-CN
fxtz	风险投资	zh-CN
fxwa	方兴未艾	zh-CN
fxwt	发现问题	zh-CN
fxyu	风行一时	zh-CN
fxzw	抚心自问	zh-CN
fyb	飞扬跋扈	zh-CN
fybg	分一杯羹	zh-CN
fybh	风云变幻	zh-CN
fybr	浮云蔽日	zh-CN
fydb	浮一大白	zh-CN
fydx	奋勇当先	zh-CN
fyel	蜂拥而来	zh-CN
fyev	蜂拥而至	zh-CN
fyf	风言风语	zh-CN
fyfy	翻云覆雨	zh-CN
fygd	发扬光大	zh-CN
fyjh	风云际会	zh-CN
fyji	风雨兼程	zh-CN
fyjj	风雨交加	zh-CN
fyjv	佛要金装	zh-CN
fylk	幅员辽阔	zh-CN
fylu	敷衍了事	zh-CN
fypy	风雨飘摇	zh-CN
fyrw	风云人物	zh-CN
fyss	匪夷所思	zh-CN
fytb	风云突变	zh-CN
fytv	风雨同舟	zh-CN
fyux	繁衍生息	zh-CN
fyvj	俯仰之间	zh-CN
fyvu	扶摇直上	zh-CN
fywb	风月无边	zh-CN
fywk	负隅顽抗	zh-CN
fywl	扶摇万里	zh-CN
fywz	风雨无阻	zh-CN
fyxc	浮语虚辞	zh-CN
fyyk	反咬一口	zh-CN
fyzb	飞檐走壁	zh-CN
fyzu	丰衣足食	zh-CN
fzba	烦躁不安	zh-CN
fzbj	放纵不羁	zh-CN
fzdh	否则的话	zh-CN
fzih	奉子成婚	zh-CN
fziy	风姿绰约	zh-CN
fzxu	放在心上	zh-CN
fzyl	放在眼里	zh-CN
gafj	公安分局	zh-CN
gagh	隔岸观火	zh-CN
gatm	各安天命	zh-CN
gayy	苟安一隅	zh-CN
gazd	高傲自大	zh-CN
gbbl	古巴比伦	zh-CN
gbdt	广播电台	zh-CN
gbdv	寡不敌众	zh-CN
gbdx	各奔东西	zh-CN
gbfz	概不负责	zh-CN
gbhg	哥本哈根	zh-CN
gbii	功败垂成	zh-CN
gbkm	功不可没	zh-CN
gbkn	更不可能	zh-CN
gbkp	高不可攀	zh-CN
gbmf	官逼民反	zh-CN
gbqi	搞不清楚	zh-CN
gbqr	果不其然	zh-CN
gbsi	公报私仇	zh-CN
gbvx	官卑职小	zh-CN
gbxf	甘拜下风	zh-CN
gbxr	各不相让	zh-CN
gbxt	各不相同	zh-CN
gbxv	改变现状	zh-CN
gbyq	供不应求	zh-CN
gbyu	更不用说	zh-CN
gbyy	根本原因	zh-CN
gbzf	故步自封	zh-CN
gbzy	刚愎自用	zh-CN
gcub	顾此失彼	zh-CN
gcum	过从甚密	zh-CN
gcvr	光彩照人	zh-CN
gdhu	更待何时	zh-CN
gdhz	该当何罪	zh-CN
gdii	割地称臣	zh-CN
gdiy	故地重游	zh-CN
gdpk	割地赔款	zh-CN
gdqf	高低起伏	zh-CN
gdqs	各得其所	zh-CN
gdwl	功德无量	zh-CN
gdwx	古典文学	zh-CN
gdxv	肝胆相照	zh-CN
gdym	功德圆满	zh-CN
gdyq	供大于求	zh-CN
gdyx	高等院校	zh-CN
gdzj	广电总局	zh-CN
gecu	改恶从善	zh-CN
gedd	感恩戴德	zh-CN
gegf	孤儿寡妇	zh-CN
gegm	孤儿寡母	zh-CN
gegv	广而告之	zh-CN
geng	过而能改	zh-CN
getb	感恩图报	zh-CN
gews	公而忘私	zh-CN
gexu	改恶向善	zh-CN
geyl	恭而有礼	zh-CN
gfbl	高分辨率	zh-CN
gfdx	国防大学	zh-CN
gfgs	股份公司	zh-CN
gflj	高风亮节	zh-CN
gfmq	国富民强	zh-CN
gfug	鬼斧神工	zh-CN
gfxy	刮风下雨	zh-CN
gfyv	官复原职	zh-CN
gfzu	孤芳自赏	zh-CN
ggaq	公共安全	zh-CN
ggbb	亘古不变	zh-CN
ggbf	各个部分	zh-CN
ggbm	亘古不灭	zh-CN
ggbr	格格不入	zh-CN
ggdd	归根到底	zh-CN
ggdl	盖棺定论	zh-CN
ggel	滚滚而来	zh-CN
gggq	高高挂起	zh-CN
gggu	功高盖世	zh-CN
gggx	公共关系	zh-CN
gghi	滚滚红尘	zh-CN
gghl	高官厚禄	zh-CN
ggj	恭恭敬敬	zh-CN
ggjd	归根结底	zh-CN
ggjg	公共机构	zh-CN
ggjj	干干净净	zh-CN
ggjp	各个击破	zh-CN
ggkf	改革开放	zh-CN
ggld	刮骨疗毒	zh-CN
ggll	光怪陆离	zh-CN
gglu	滚瓜烂熟	zh-CN
ggly	各个领域	zh-CN
ggnn	鼓鼓囊囊	zh-CN
ggsd	歌功颂德	zh-CN
ggsl	光杆司令	zh-CN
ggss	鬼鬼祟祟	zh-CN
gguw	公共事务	zh-CN
gguy	公共事业	zh-CN
ggvj	过关斩将	zh-CN
ggvv	功高震主	zh-CN
ggwu	公共卫生	zh-CN
ggwy	亘古未有	zh-CN
ggxh	官官相护	zh-CN
ggxj	高官显爵	zh-CN
ggxx	高高兴兴	zh-CN
ggyh	耿耿于怀	zh-CN
ggyq	供过于求	zh-CN
ggzd	高干子弟	zh-CN
ggzh	骨鲠在喉	zh-CN
ggzu	高高在上	zh-CN
ggzx	改过自新	zh-CN
ghbl	干活不累	zh-CN
ghbv	关怀备至	zh-CN
ghcl	光辉灿烂	zh-CN
ghgt	各怀鬼胎	zh-CN
ghgy	各行各业	zh-CN
ghiq	过河拆桥	zh-CN
ghku	更何况是	zh-CN
ghmt	改换门庭	zh-CN
ghrx	蛊惑人心	zh-CN
ghup	勾魂摄魄	zh-CN
ghxx	恭贺新禧	zh-CN
ghyg	孤魂野鬼	zh-CN
ghzy	光合作用	zh-CN
gibv	攻城拔寨	zh-CN
gicd	肝肠寸断	zh-CN
gidq	高潮迭起	zh-CN
gidy	共产党员	zh-CN
gihd	改朝换代	zh-CN
gijc	觥筹交错	zh-CN
gijh	国仇家恨	zh-CN
gijj	各持己见	zh-CN
gild	攻城略地	zh-CN
gilh	干柴烈火	zh-CN
gilu	贯彻落实	zh-CN
gimj	功成名就	zh-CN
ginu	鼓唇弄舌	zh-CN
giut	功成身退	zh-CN
givy	共产主义	zh-CN
giyi	高出一筹	zh-CN
gjbc	感觉不错	zh-CN
gjbd	感觉不到	zh-CN
gjbg	国将不国	zh-CN
gjbj	感激不尽	zh-CN
gjbv	国家标准	zh-CN
gjdb	勾肩搭背	zh-CN
gjdd	诡计多端	zh-CN
gjdl	国家栋梁	zh-CN
gjdu	国家大事	zh-CN
gjfv	孤军奋战	zh-CN
gjgh	各家各户	zh-CN
gjgw	各就各位	zh-CN
gjgx	国际关系	zh-CN
gjit	干劲冲天	zh-CN
gjjg	国家机关	zh-CN
gjjq	国家机器	zh-CN
gjjr	国际金融	zh-CN
gjmt	国进民退	zh-CN
gjmu	国计民生	zh-CN
gjmv	纲举目张	zh-CN
gjmy	国际贸易	zh-CN
gjrh	甘居人后	zh-CN
gjsb	拱肩缩背	zh-CN
gjsn	各尽所能	zh-CN
gjtl	感激涕零	zh-CN
gjtq	狗急跳墙	zh-CN
gjts	各具特色	zh-CN
gjuj	赶尽杀绝	zh-CN
gjun	钢筋水泥	zh-CN
gjur	孤军深入	zh-CN
gjuw	国际事务	zh-CN
gjuy	广结善缘	zh-CN
gjvm	国际知名	zh-CN
gjvw	古今中外	zh-CN
gjwt	国际舞台	zh-CN
gjxu	国际形势	zh-CN
gjyb	更进一步	zh-CN
gjzb	国际资本	zh-CN
gjzv	孤军作战	zh-CN
gkdz	高开低走	zh-CN
gkgz	高开高走	zh-CN
gkjr	光可鉴人	zh-CN
gklc	管窥蠡测	zh-CN
gkld	孤苦伶仃	zh-CN
gklh	鬼哭狼嚎	zh-CN
gkwq	感慨万千	zh-CN
gkyg	甘苦与共	zh-CN
gkyk	功亏一篑	zh-CN
gkyl	广开言路	zh-CN
glby	哥伦比亚	zh-CN
gldx	国立大学	zh-CN
glgq	改来改去	zh-CN
glgw	孤陋寡闻	zh-CN
glii	顾虑重重	zh-CN
gljg	古灵精怪	zh-CN
gljy	格鲁吉亚	zh-CN
gllu	怪力乱神	zh-CN
glnd	格林纳达	zh-CN
glrj	更阑人静	zh-CN
glvy	官僚主义	zh-CN
glwy	孤立无援	zh-CN
gmbw	过目不忘	zh-CN
gmdg	关门打狗	zh-CN
gmdj	关门大吉	zh-CN
gmdy	沽名钓誉	zh-CN
gmgy	怪模怪样	zh-CN
gmhx	改名换姓	zh-CN
gmis	过目成诵	zh-CN
gmll	光明磊落	zh-CN
gmsj	高锰酸钾	zh-CN
gmsu	光芒四射	zh-CN
gmsy	顾名思义	zh-CN
gmth	冠冕堂皇	zh-CN
gmvd	光明正大	zh-CN
gmvf	国民政府	zh-CN
gmwv	光芒万丈	zh-CN
gmxk	刮目相看	zh-CN
gmxq	鬼迷心窍	zh-CN
gmyq	哥们义气	zh-CN
gndt	国难当头	zh-CN
gngj	国内国际	zh-CN
gngn	孤男寡女	zh-CN
gntd	肝脑涂地	zh-CN
gnxx	故弄玄虚	zh-CN
gpbq	高攀不起	zh-CN
gpbt	狗屁不通	zh-CN
gpgy	狗皮膏药	zh-CN
gpjw	国破家亡	zh-CN
gpmz	高朋满座	zh-CN
gpuz	顾盼生姿	zh-CN
gpws	公平无私	zh-CN
gqbb	攻其不备	zh-CN
gqdj	顾全大局	zh-CN
gqlx	归去来兮	zh-CN
gqsi	各取所长	zh-CN
gqsx	各取所需	zh-CN
gqtu	苟且偷生	zh-CN
gqty	共青团员	zh-CN
gqvx	苟且之心	zh-CN
gqxm	苟全性命	zh-CN
gqyd	攻其一点	zh-CN
gqye	隔墙有耳	zh-CN
gqyq	鼓起勇气	zh-CN
gqyu	感情用事	zh-CN
gqzf	过期作废	zh-CN
grbh	供认不讳	zh-CN
grbj	刚柔并济	zh-CN
grff	感人肺腑	zh-CN
grib	个人崇拜	zh-CN
grit	光荣传统	zh-CN
grjs	骨软筋酥	zh-CN
grjt	固若金汤	zh-CN
grls	骨肉离散	zh-CN
grrw	个人认为	zh-CN
grty	骨肉团圆	zh-CN
grvy	个人主义	zh-CN
grxc	骨肉相残	zh-CN
grxj	刚柔相济	zh-CN
grxl	骨肉相连	zh-CN
gryd	高人一等	zh-CN
gryj	个人意见	zh-CN
grym	改容易貌	zh-CN
gscw	隔三差五	zh-CN
gsds	勾三搭四	zh-CN
gsfv	高速发展	zh-CN
gsgx	古色古香	zh-CN
gsgy	各色各样	zh-CN
gsiw	隔三岔五	zh-CN
gslb	公私两便	zh-CN
gsqv	各司其职	zh-CN
gsrd	各色人等	zh-CN
gsry	高耸入云	zh-CN
gstx	国色天香	zh-CN
gszv	高速增长	zh-CN
gtbu	更谈不上	zh-CN
gtdd	感天动地	zh-CN
gtfm	故态复萌	zh-CN
gtgn	鬼头鬼脑	zh-CN
gtgu	高抬贵手	zh-CN
gthd	改天换地	zh-CN
gthm	改头换面	zh-CN
gthr	光天化日	zh-CN
gtju	狗头军师	zh-CN
gtkl	高谈阔论	zh-CN
gtlx	瓜田李下	zh-CN
gtly	共同利益	zh-CN
gtma	国泰民安	zh-CN
gtnl	故土难离	zh-CN
gtnm	关塔那摩	zh-CN
gtsp	龟兔赛跑	zh-CN
gttu	高台跳水	zh-CN
gtuu	感同身受	zh-CN
gtvi	共同之处	zh-CN
gtwx	歌台舞榭	zh-CN
gtyx	沟通一下	zh-CN
gtyy	共同语言	zh-CN
gucl	更上层楼	zh-CN
gudg	根深蒂固	zh-CN
gudl	瓜熟蒂落	zh-CN
gudx	工商大学	zh-CN
gugb	公事公办	zh-CN
gugg	故事梗概	zh-CN
gugq	怪声怪气	zh-CN
gugy	各式各样	zh-CN
gujj	各抒己见	zh-CN
gumc	高深莫测	zh-CN
gurc	更是如此	zh-CN
guri	骨瘦如柴	zh-CN
gurl	高手如林	zh-CN
gurr	拱手让人	zh-CN
gury	高手如云	zh-CN
gutm	攻守同盟	zh-CN
guvy	孤身只影	zh-CN
guwl	格杀勿论	zh-CN
guxr	拱手相让	zh-CN
guyh	工商银行	zh-CN
guym	根深叶茂	zh-CN
guyv	高山仰止	zh-CN
guzj	工商总局	zh-CN
gvbe	刚正不阿	zh-CN
gvbu	广种薄收	zh-CN
gvdl	国之栋梁	zh-CN
gvdr	刚中带柔	zh-CN
gvgy	各种各样	zh-CN
gvih	公众场合	zh-CN
gvis	公众场所	zh-CN
gvjj	固执己见	zh-CN
gvkb	管中窥豹	zh-CN
gvnm	孤枕难眠	zh-CN
gvrc	果真如此	zh-CN
gvrw	公众人物	zh-CN
gvry	甘之如饴	zh-CN
gvus	骨质疏松	zh-CN
gvvu	股掌之上	zh-CN
gvws	公正无私	zh-CN
gvwy	高枕无忧	zh-CN
gvyc	各执一词	zh-CN
gvyv	孤注一掷	zh-CN
gvyy	各种原因	zh-CN
gvzw	个中滋味	zh-CN
gwbk	攻无不克	zh-CN
gwj	高屋建瓴	zh-CN
gwjl	古往今来	zh-CN
gwjy	古为今用	zh-CN
gwmj	拐弯抹角	zh-CN
gwnr	国无宁日	zh-CN
gwpp	锅碗瓢盆	zh-CN
gwqv	各为其主	zh-CN
gwrq	高危人群	zh-CN
gwrv	广为人知	zh-CN
gwtv	姑妄听之	zh-CN
gwup	歌舞升平	zh-CN
gwuq	鼓舞士气	zh-CN
gwvv	格物致知	zh-CN
gwvx	购物中心	zh-CN
gwxd	狗尾续貂	zh-CN
gwyv	姑妄言之	zh-CN
gxdj	勾心斗角	zh-CN
gxdm	高姓大名	zh-CN
gxfc	恭喜发财	zh-CN
gxgv	改邪归正	zh-CN
gxhd	更新换代	zh-CN
gxjc	工薪阶层	zh-CN
gxju	高新技术	zh-CN
gxll	光鲜亮丽	zh-CN
gxls	公序良俗	zh-CN
gxlt	狗血淋头	zh-CN
gxpt	狗血喷头	zh-CN
gxqu	各行其是	zh-CN
gxqy	甘心情愿	zh-CN
gxsj	归心似箭	zh-CN
gxsy	隔靴搔痒	zh-CN
gxut	各显神通	zh-CN
gxvb	各项指标	zh-CN
gxvn	古稀之年	zh-CN
gxvz	广西壮族	zh-CN
gxwu	攻心为上	zh-CN
gxyj	姑息养奸	zh-CN
gxyl	高薪养廉	zh-CN
gxyv	改弦易辙	zh-CN
gxzl	关心则乱	zh-CN
gybj	过犹不及	zh-CN
gybq	过意不去	zh-CN
gyci	苟延残喘	zh-CN
gydh	公用电话	zh-CN
gydl	告一段落	zh-CN
gydx	工业大学	zh-CN
gyfm	皈依佛门	zh-CN
gygf	国有国法	zh-CN
gygh	各有各好	zh-CN
gygm	工业革命	zh-CN
gyht	官运亨通	zh-CN
gyjl	鬼蜮伎俩	zh-CN
gykr	狗眼看人	zh-CN
gylb	各有利弊	zh-CN
gylw	挂一漏万	zh-CN
gynz	顾影弄姿	zh-CN
gyps	观音菩萨	zh-CN
gyqq	各有千秋	zh-CN
gyqy	国有企业	zh-CN
gyrr	光阴荏苒	zh-CN
gysa	各有所爱	zh-CN
gysh	各有所好	zh-CN
gysi	各有所长	zh-CN
gysj	光阴似箭	zh-CN
gyuv	更有甚者	zh-CN
gyuy	寡言少语	zh-CN
gyvd	膏腴之地	zh-CN
gywv	官样文章	zh-CN
gyxj	工于心计	zh-CN
gyys	固有一死	zh-CN
gyyy	过眼云烟	zh-CN
gyzl	顾影自怜	zh-CN
gzbg	工作报告	zh-CN
gzbq	裹足不前	zh-CN
gzdw	工作单位	zh-CN
gzgd	敢作敢当	zh-CN
gzgj	鼓足干劲	zh-CN
gzgu	故作高深	zh-CN
gzgw	敢作敢为	zh-CN
gzhj	工作环境	zh-CN
gzjh	工作计划	zh-CN
gznl	工作能力	zh-CN
gzrm	各族人民	zh-CN
gzry	工作人员	zh-CN
gztd	工作态度	zh-CN
gztj	工作条件	zh-CN
gzuj	工作时间	zh-CN
gzuq	鼓足士气	zh-CN
gzvd	故作镇定	zh-CN
gzws	公子王孙	zh-CN
gzwv	各自为政	zh-CN
gzxx	鼓足信心	zh-CN
gzxy	工作需要	zh-CN
gzyq	鼓足勇气	zh-CN
gzyz	光宗耀祖	zh-CN
gzzf	工作作风	zh-CN
gzzj	工作总结	zh-CN
hakq	和蔼可亲	zh-CN
hbdb	货不对板	zh-CN
hbdd	黑白颠倒	zh-CN
hbdf	含苞待放	zh-CN
hbdi	悔不当初	zh-CN
hbdu	话不多说	zh-CN
hbdx	祸不单行	zh-CN
hbfm	黑白分明	zh-CN
hbft	魂不附体	zh-CN
hbfx	还本付息	zh-CN
hbgr	互不干扰	zh-CN
hbhu	会不会是	zh-CN
hbhy	毫不讳言	zh-CN
hbij	画饼充饥	zh-CN
hbjy	毫不介意	zh-CN
hbkq	很不客气	zh-CN
hbkv	毫不夸张	zh-CN
hblj	毫不利己	zh-CN
hblq	黑不溜秋	zh-CN
hblt	活蹦乱跳	zh-CN
hblz	胡编乱造	zh-CN
hbqz	怀璧其罪	zh-CN
hbru	还不如说	zh-CN
hbry	好不容易	zh-CN
hbsj	货比三家	zh-CN
hbtj	话不投机	zh-CN
hbue	虎不食儿	zh-CN
hbur	毫不示弱	zh-CN
hbuu	魂不守舍	zh-CN
hbvd	还不知道	zh-CN
hbvj	缓兵之计	zh-CN
hbws	悍不畏死	zh-CN
hbxg	毫不相干	zh-CN
hbxq	互不相欠	zh-CN
hbxr	互不相容	zh-CN
hbxu	红白喜事	zh-CN
hbxy	虎背熊腰	zh-CN
hbyf	含苞欲放	zh-CN
hbyy	毫不犹豫	zh-CN
hbzl	慌不择路	zh-CN
hcbb	厚此薄彼	zh-CN
hcby	怀才不遇	zh-CN
hcki	祸从口出	zh-CN
hclu	花丛老手	zh-CN
hctj	祸从天降	zh-CN
hcum	花草树木	zh-CN
hcur	获此殊荣	zh-CN
hdbj	荒诞不经	zh-CN
hdda	横刀夺爱	zh-CN
hdfz	红得发紫	zh-CN
hdhd	很多很多	zh-CN
hdhn	何德何能	zh-CN
hdhu	或多或少	zh-CN
hdhx	忽大忽小	zh-CN
hdjr	黄道吉日	zh-CN
hdlm	横刀立马	zh-CN
hdls	洪都拉斯	zh-CN
hdlv	海底捞针	zh-CN
hdnq	很多年前	zh-CN
hdwl	画地为牢	zh-CN
hdxb	邯郸学步	zh-CN
hdxg	好大喜功	zh-CN
hdxh	黑灯瞎火	zh-CN
hdxy	蝴蝶效应	zh-CN
hdzb	话到嘴边	zh-CN
hdzw	厚德载物	zh-CN
hebf	惠而不费	zh-CN
hebl	含而不露	zh-CN
hebq	怙恶不悛	zh-CN
hebt	和而不同	zh-CN
hedd	花儿朵朵	zh-CN
hehd	皇恩浩荡	zh-CN
hewy	合二为一	zh-CN
hexj	赫尔辛基	zh-CN
hfbj	豪放不羁	zh-CN
hfdx	哈佛大学	zh-CN
hfhy	呼风唤雨	zh-CN
hfjp	鹤发鸡皮	zh-CN
hfps	魂飞魄散	zh-CN
hfqt	洪福齐天	zh-CN
hftw	魂飞天外	zh-CN
hfty	鹤发童颜	zh-CN
hfvr	后发制人	zh-CN
hfxv	后发先至	zh-CN
hfxy	和风细雨	zh-CN
hfy	花繁叶茂	zh-CN
hfyh	汇丰银行	zh-CN
hfym	灰飞烟灭	zh-CN
hfyu	环肥燕瘦	zh-CN
hfyv	话锋一转	zh-CN
hgds	哈根达斯	zh-CN
hgfv	回光返照	zh-CN
hgjj	宏观经济	zh-CN
hgld	黑咕隆咚	zh-CN
hgql	缓过气来	zh-CN
hgtk	宏观调控	zh-CN
hgtl	回过头来	zh-CN
hgtq	回过头去	zh-CN
hguj	怀古伤今	zh-CN
hgul	回过神来	zh-CN
hgus	湖光山色	zh-CN
hgvy	后顾之忧	zh-CN
hgwy	好高骛远	zh-CN
hgxq	很感兴趣	zh-CN
hgxy	欢歌笑语	zh-CN
hgym	祸国殃民	zh-CN
hgzf	后果自负	zh-CN
hgzi	好果子吃	zh-CN
hgzx	悔过自新	zh-CN
hhba	惶惶不安	zh-CN
hhbf	好坏不分	zh-CN
hhbq	含糊不清	zh-CN
hhbu	还好不是	zh-CN
hhbv	呵护备至	zh-CN
hhcc	花花草草	zh-CN
hhdd	浩浩荡荡	zh-CN
hhdu	呼呼大睡	zh-CN
hhdx	哈哈大笑	zh-CN
hhee	浑浑噩噩	zh-CN
hhej	哼哈二将	zh-CN
hhgn	黄花闺女	zh-CN
hhgz	花花公子	zh-CN
hhhh	恍恍惚惚	zh-CN
hhhs	好合好散	zh-CN
hhht	呼和浩特	zh-CN
hhii	昏昏沉沉	zh-CN
hhiz	花花肠子	zh-CN
hhjj	哼哼叽叽	zh-CN
hhll	轰轰烈烈	zh-CN
hhmj	后悔莫及	zh-CN
hhqc	含糊其辞	zh-CN
hhqy	欢呼雀跃	zh-CN
hhry	挥汗如雨	zh-CN
hhts	花花太岁	zh-CN
hhuj	花花世界	zh-CN
hhvg	赫赫之功	zh-CN
hhvu	悔恨终生	zh-CN
hhvv	慌慌张张	zh-CN
hhwc	何患无辞	zh-CN
hhwd	挥霍无度	zh-CN
hhwq	后患无穷	zh-CN
hhxx	好好学习	zh-CN
hhym	赫赫有名	zh-CN
hhyq	后会有期	zh-CN
hhyu	昏昏欲睡	zh-CN
hhyx	挥挥衣袖	zh-CN
hhzx	怀恨在心	zh-CN
hibu	何尝不是	zh-CN
hicy	何出此言	zh-CN
hidq	回肠荡气	zh-CN
hids	混吃等死	zh-CN
hihh	好吃好喝	zh-CN
hill	酣畅淋漓	zh-CN
hilz	好吃懒做	zh-CN
himu	回春妙手	zh-CN
hiql	豁出去了	zh-CN
hirj	汗出如浆	zh-CN
hiuj	很长时间	zh-CN
hivv	横冲直撞	zh-CN
hiwt	很成问题	zh-CN
hiyd	还差一点	zh-CN
hizx	回嗔作喜	zh-CN
hjbf	厚积薄发	zh-CN
hjbi	好景不长	zh-CN
hjbj	好久不见	zh-CN
hjfl	后继乏力	zh-CN
hjfr	后继乏人	zh-CN
hjgu	横加干涉	zh-CN
hjhj	很久很久	zh-CN
hjhw	狐假虎威	zh-CN
hjid	化茧成蝶	zh-CN
hjjy	讳疾忌医	zh-CN
hjlp	虎踞龙盘	zh-CN
hjlx	花街柳巷	zh-CN
hjmi	胡搅蛮缠	zh-CN
hjrt	挥金如土	zh-CN
hjty	海角天涯	zh-CN
hjvn	花甲之年	zh-CN
hjvz	横加指责	zh-CN
hjwl	后继无力	zh-CN
hjwr	后继无人	zh-CN
hjyl	荒郊野岭	zh-CN
hjyq	很久以前	zh-CN
hjyt	欢聚一堂	zh-CN
hjyw	荒郊野外	zh-CN
hkba	惶恐不安	zh-CN
hkby	虎口拔牙	zh-CN
hkhl	花开花落	zh-CN
hkmj	航空母舰	zh-CN
hknu	很可能是	zh-CN
hktk	海阔天空	zh-CN
hktu	虎口逃生	zh-CN
hkul	海枯石烂	zh-CN
hkwn	昏聩无能	zh-CN
hkxe	黄口小儿	zh-CN
hkyu	虎口余生	zh-CN
hlbe	呼伦贝尔	zh-CN
hlbj	忽略不计	zh-CN
hlbq	很了不起	zh-CN
hlbu	旱涝保收	zh-CN
hlbw	何乐不为	zh-CN
hlgy	互利共赢	zh-CN
hlhq	换来换去	zh-CN
hlhr	忽冷忽热	zh-CN
hlht	糊里糊涂	zh-CN
hlhw	话里话外	zh-CN
hljq	鹤立鸡群	zh-CN
hlju	后来居上	zh-CN
hllj	获利了结	zh-CN
hlmm	黄粱美梦	zh-CN
hlpy	虎落平阳	zh-CN
hlsu	活力四射	zh-CN
hltz	囫囵吞枣	zh-CN
hluw	寒来暑往	zh-CN
hlvu	虎狼之师	zh-CN
hlwv	化零为整	zh-CN
hlyh	话里有话	zh-CN
hlym	黄粱一梦	zh-CN
hlzz	回炉再造	zh-CN
hmgl	汗马功劳	zh-CN
hmha	忽明忽暗	zh-CN
hmjl	荒谬绝伦	zh-CN
hmnm	横眉怒目	zh-CN
hmru	讳莫如深	zh-CN
hmsh	侯门似海	zh-CN
hmsv	火冒三丈	zh-CN
hmuy	横眉竖眼	zh-CN
hmwl	横蛮无理	zh-CN
hmyt	黄毛丫头	zh-CN
hmyx	回眸一笑	zh-CN
hnbi	海纳百川	zh-CN
hnfq	患难夫妻	zh-CN
hnhy	何年何月	zh-CN
hnid	汗牛充栋	zh-CN
hnlj	很难理解	zh-CN
hnln	红男绿女	zh-CN
hnmy	猴年马月	zh-CN
hnvj	患难之交	zh-CN
hnvy	还能这样	zh-CN
hnxx	很难想象	zh-CN
hnyg	患难与共	zh-CN
hnzy	还能怎样	zh-CN
hpgi	和平共处	zh-CN
hpgy	狐朋狗友	zh-CN
hphy	呼朋唤友	zh-CN
hpju	黄袍加身	zh-CN
hpjv	鸿篇巨制	zh-CN
hpjx	黄埔军校	zh-CN
hpti	和盘托出	zh-CN
hpyb	呼朋引伴	zh-CN
hqbr	寒气逼人	zh-CN
hqdy	何其毒也	zh-CN
hqgq	皇亲国戚	zh-CN
hqhc	何去何从	zh-CN
hqhl	合情合理	zh-CN
hqic	浩气长存	zh-CN
hqjx	划清界限	zh-CN
hqlw	红墙绿瓦	zh-CN
hqmm	含情脉脉	zh-CN
hqmr	魂牵梦绕	zh-CN
hqmy	魂牵梦萦	zh-CN
hqub	横七竖八	zh-CN
hqud	荷枪实弹	zh-CN
hqvm	害群之马	zh-CN
hqvv	豪情壮志	zh-CN
hqvx	后起之秀	zh-CN
hqwv	豪情万丈	zh-CN
hqxq	祸起萧墙	zh-CN
hqxr	寒气袭人	zh-CN
hqxt	花拳绣腿	zh-CN
hqyh	花旗银行	zh-CN
hqyv	虎躯一震	zh-CN
hqyx	花前月下	zh-CN
hqzh	黄雀在后	zh-CN
hrbj	诲人不倦	zh-CN
hrbq	害人不浅	zh-CN
hrbv	浑然不知	zh-CN
hrdw	恍然大悟	zh-CN
hrgs	恨入骨髓	zh-CN
hrgt	豁然贯通	zh-CN
hrhj	害人害己	zh-CN
hrkl	豁然开朗	zh-CN
hrru	恍然若失	zh-CN
hrti	浑然天成	zh-CN
hrtw	骇人听闻	zh-CN
hrvq	浩然之气	zh-CN
hrwv	浑然无知	zh-CN
hrym	花容月貌	zh-CN
hryq	虎入羊群	zh-CN
hryt	浑然一体	zh-CN
hryx	焕然一新	zh-CN
hslx	胡思乱想	zh-CN
hsnd	晦涩难懂	zh-CN
hsqj	横扫千军	zh-CN
hsux	活色生香	zh-CN
hsvt	好色之徒	zh-CN
hszr	挥洒自如	zh-CN
htdk	嚎啕大哭	zh-CN
htdv	宏图大志	zh-CN
htdx	哄堂大笑	zh-CN
htfu	回天乏术	zh-CN
htgy	黄土高原	zh-CN
hthd	昏天黑地	zh-CN
hthn	虎头虎脑	zh-CN
htht	皇天后土	zh-CN
htjc	花团锦簇	zh-CN
htjd	花天酒地	zh-CN
htkj	憨态可掬	zh-CN
htqd	呼天抢地	zh-CN
httl	灰头土脸	zh-CN
htua	回头是岸	zh-CN
htuw	虎头蛇尾	zh-CN
htvl	回天之力	zh-CN
htwj	红头文件	zh-CN
htxd	欢天喜地	zh-CN
htyu	糊涂一时	zh-CN
htyw	互通有无	zh-CN
htzu	回头再说	zh-CN
hubc	还是不错	zh-CN
hubd	胡说八道	zh-CN
hudd	虎视眈眈	zh-CN
huhd	何时何地	zh-CN
huhl	火烧火燎	zh-CN
huhq	好声好气	zh-CN
huhs	绘声绘色	zh-CN
huhy	绘声绘影	zh-CN
huiu	好事成双	zh-CN
hujy	火上浇油	zh-CN
humj	毁尸灭迹	zh-CN
humm	火烧眉毛	zh-CN
humy	混水摸鱼	zh-CN
huqj	皓首穷经	zh-CN
hurl	鼾声如雷	zh-CN
hutz	画蛇添足	zh-CN
huud	浑身是胆	zh-CN
huul	海市蜃楼	zh-CN
huum	海誓山盟	zh-CN
huux	浑身上下	zh-CN
huvj	横生枝节	zh-CN
huvl	还手之力	zh-CN
huvt	好事之徒	zh-CN
huvu	后事之师	zh-CN
huwu	回首往事	zh-CN
huxy	欢声笑语	zh-CN
huyl	荒山野岭	zh-CN
huyr	很少有人	zh-CN
hvbj	悔之不及	zh-CN
hvbl	横征暴敛	zh-CN
hvbq	挥之不去	zh-CN
hvgj	和衷共济	zh-CN
hvhj	后知后觉	zh-CN
hvjl	呼之即来	zh-CN
hvjq	挥之即去	zh-CN
hvli	花枝乱颤	zh-CN
hvql	火中取栗	zh-CN
hvrg	恨之入骨	zh-CN
hvvv	花枝招展	zh-CN
hvvx	会展中心	zh-CN
hvwl	化整为零	zh-CN
hvyx	好整以暇	zh-CN
hwbl	毫无保留	zh-CN
hwev	毫无二致	zh-CN
hwgj	毫无顾忌	zh-CN
hwgx	毫无关系	zh-CN
hwlv	后无来者	zh-CN
hwly	毫无理由	zh-CN
hwru	好为人师	zh-CN
hwry	荒无人烟	zh-CN
hwsk	换位思考	zh-CN
hwvm	化外之民	zh-CN
hwwq	回味无穷	zh-CN
hwwy	化为乌有	zh-CN
hwyg	互为因果	zh-CN
hwyi	毫无用处	zh-CN
hwyt	混为一谈	zh-CN
hwyw	毫无疑问	zh-CN
hwyy	毫无意义	zh-CN
hxbf	喝西北风	zh-CN
hxdb	韩信点兵	zh-CN
hxel	呼啸而来	zh-CN
hxfy	化学反应	zh-CN
hxgw	欢欣鼓舞	zh-CN
hxhb	混淆黑白	zh-CN
hxhy	活血化瘀	zh-CN
hxiq	红杏出墙	zh-CN
hxjq	含笑九泉	zh-CN
hxlb	花心萝卜	zh-CN
hxlt	虎穴龙潭	zh-CN
hxny	花香鸟语	zh-CN
hxpr	含血喷人	zh-CN
hxql	回想起来	zh-CN
hxrk	含辛茹苦	zh-CN
hxsq	灰心丧气	zh-CN
hxtw	互相推诿	zh-CN
hxtx	横行天下	zh-CN
hxut	混淆视听	zh-CN
hxvy	回心转意	zh-CN
hxwy	化险为夷	zh-CN
hxxh	好行小惠	zh-CN
hxyc	互相依存	zh-CN
hxyq	沆瀣一气	zh-CN
hxyx	会心一笑	zh-CN
hxzl	河西走廊	zh-CN
hybm	红颜薄命	zh-CN
hybq	怀冤抱屈	zh-CN
hybu	还有不少	zh-CN
hybv	很有帮助	zh-CN
hyby	很有必要	zh-CN
hycb	毁誉参半	zh-CN
hydh	好勇斗狠	zh-CN
hydl	很有道理	zh-CN
hyew	和衣而卧	zh-CN
hyfq	获益匪浅	zh-CN
hyfx	花样翻新	zh-CN
hyhj	忽远忽近	zh-CN
hyhu	红颜祸水	zh-CN
hyjd	何以见得	zh-CN
hyjh	含英咀华	zh-CN
hyjj	火眼金睛	zh-CN
hyjq	喊冤叫屈	zh-CN
hykn	很有可能	zh-CN
hyly	胡言乱语	zh-CN
hynh	花样年华	zh-CN
hyns	含饴弄孙	zh-CN
hypy	汉语拼音	zh-CN
hyqh	后院起火	zh-CN
hyqy	花言巧语	zh-CN
hyvy	豪言壮语	zh-CN
hywi	厚颜无耻	zh-CN
hywl	话音未落	zh-CN
hywq	花冤枉钱	zh-CN
hyxq	好言相劝	zh-CN
hyyd	毁于一旦	zh-CN
hyyy	很有意义	zh-CN
hzdz	何足道哉	zh-CN
hzey	涸泽而渔	zh-CN
hzfw	胡作非为	zh-CN
hzgi	何足挂齿	zh-CN
hzhb	合作伙伴	zh-CN
hzlh	合纵连横	zh-CN
hzqy	合资企业	zh-CN
hzvy	何罪之有	zh-CN
hzwq	何足为奇	zh-CN
hzwv	好自为之	zh-CN
hzyu	活字印刷	zh-CN
iald	尘埃落定	zh-CN
ibal	除暴安良	zh-CN
ibdl	差不多了	zh-CN
ibdu	成败得失	zh-CN
ibgq	喘不过气	zh-CN
ibhz	吃饱喝足	zh-CN
ibkw	臭不可闻	zh-CN
iblt	秤不离砣	zh-CN
ibmg	吃闭门羹	zh-CN
ibtd	差不太多	zh-CN
ibuq	成百上千	zh-CN
ibuv	赤膊上阵	zh-CN
ibxq	吃不下去	zh-CN
icjh	趁此机会	zh-CN
icjy	重操旧业	zh-CN
icld	陈词滥调	zh-CN
icvw	除此之外	zh-CN
icxc	出此下策	zh-CN
icyl	吃错药了	zh-CN
icyw	长此以往	zh-CN
idbx	拆东补西	zh-CN
idci	尺短寸长	zh-CN
iddu	抽刀断水	zh-CN
idfv	重蹈覆辙	zh-CN
idjx	唱独角戏	zh-CN
idtx	唱对台戏	zh-CN
iduy	传道授业	zh-CN
idvq	沉得住气	zh-CN
idvx	赤胆忠心	zh-CN
idzt	迟到早退	zh-CN
iebw	充耳不闻	zh-CN
iefe	出尔反尔	zh-CN
iewj	除恶务尽	zh-CN
ieyu	惩恶扬善	zh-CN
ifdy	春风得意	zh-CN
iflb	车匪路霸	zh-CN
ifny	嘲风弄月	zh-CN
ifpl	乘风破浪	zh-CN
ifql	吃饭去了	zh-CN
ifum	充分说明	zh-CN
ifyd	春风一度	zh-CN
igdg	称孤道寡	zh-CN
igdk	长歌当哭	zh-CN
iglx	陈规陋习	zh-CN
igmj	吃干抹净	zh-CN
igmm	春光明媚	zh-CN
igvv	常规战争	zh-CN
igyh	重归于好	zh-CN
ihdj	趁火打劫	zh-CN
ihhj	楚河汉界	zh-CN
ihib	唇红齿白	zh-CN
ihik	诚惶诚恐	zh-CN
ihlm	春花烂漫	zh-CN
ihlp	蠢话连篇	zh-CN
ihlq	春寒料峭	zh-CN
ihls	吃喝拉撒	zh-CN
ihpd	吃喝嫖赌	zh-CN
ihrw	车毁人亡	zh-CN
ihtn	冲昏头脑	zh-CN
ihtt	成何体统	zh-CN
ihvl	吹灰之力	zh-CN
ihwl	吃喝玩乐	zh-CN
ihxx	超乎想象	zh-CN
ihyl	出乎意料	zh-CN
iibj	愁肠百结	zh-CN
iibq	踌躇不前	zh-CN
iidr	楚楚动人	zh-CN
iihh	吃吃喝喝	zh-CN
iijh	重出江湖	zh-CN
iiji	驰骋疆场	zh-CN
iijj	长长久久	zh-CN
iikl	楚楚可怜	zh-CN
iiml	初出茅庐	zh-CN
iimm	缠缠绵绵	zh-CN
iimv	踌躇满志	zh-CN
iinf	插翅难飞	zh-CN
iing	称臣纳贡	zh-CN
iinn	吵吵闹闹	zh-CN
iint	插翅难逃	zh-CN
iipb	处处碰壁	zh-CN
iirr	吵吵嚷嚷	zh-CN
iivb	唇齿之邦	zh-CN
iivx	吃穿住行	zh-CN
iiww	颤颤巍巍	zh-CN
iixy	唇齿相依	zh-CN
iiyd	蠢蠢欲动	zh-CN
iiyy	绰绰有余	zh-CN
ijdg	超级大国	zh-CN
ijdy	穿金戴银	zh-CN
ijgm	初具规模	zh-CN
ijhh	楚界汉河	zh-CN
ijix	初见成效	zh-CN
ijkl	春节快乐	zh-CN
ijkt	吃尽苦头	zh-CN
ijlv	掣襟露肘	zh-CN
ijly	成家立业	zh-CN
ijpl	船坚炮利	zh-CN
ijrx	出将入相	zh-CN
ijsh	成吉思汗	zh-CN
ijtr	重见天日	zh-CN
ijtu	创巨痛深	zh-CN
ijuq	触景生情	zh-CN
ijvj	长久之计	zh-CN
ijyx	除旧迎新	zh-CN
ikdh	插科打诨	zh-CN
ikei	冲口而出	zh-CN
ikiv	出口成章	zh-CN
ikjm	吹糠见米	zh-CN
iknl	吃苦耐劳	zh-CN
ikur	出口伤人	zh-CN
ikxf	敞开心扉	zh-CN
ilbc	出类拔萃	zh-CN
ilbx	川流不息	zh-CN
ildd	豺狼当道	zh-CN
ildk	吃了大亏	zh-CN
ildv	重峦叠嶂	zh-CN
ilfm	初露锋芒	zh-CN
ilfn	出离愤怒	zh-CN
ilhb	豺狼虎豹	zh-CN
ilkx	乘龙快婿	zh-CN
ilmd	出了名的	zh-CN
ilpt	触类旁通	zh-CN
ilpw	吃里扒外	zh-CN
ilqj	春兰秋菊	zh-CN
ilqz	吃了枪子	zh-CN
ilti	吹拉弹唱	zh-CN
iltv	垂帘听政	zh-CN
ilvd	初来乍到	zh-CN
ilyj	吵了一架	zh-CN
imbs	长命百岁	zh-CN
imbv	愁眉不展	zh-CN
imby	沉默不语	zh-CN
imfc	缠绵悱恻	zh-CN
imgy	沉默寡言	zh-CN
imhc	出谋划策	zh-CN
imjj	窗明几净	zh-CN
imjs	沉湎酒色	zh-CN
imju	瞠目结舌	zh-CN
imjx	触目惊心	zh-CN
imkl	愁眉苦脸	zh-CN
imld	车马劳顿	zh-CN
imqc	吹毛求疵	zh-CN
imuh	城门失火	zh-CN
imuj	沉默是金	zh-CN
imvn	迟暮之年	zh-CN
imvv	臭名昭著	zh-CN
imvw	驰名中外	zh-CN
imwh	春梦无痕	zh-CN
imwi	出没无常	zh-CN
imwl	魑魅魍魉	zh-CN
imyy	柴米油盐	zh-CN
imzw	出门在外	zh-CN
indj	吃奶的劲	zh-CN
inhk	春暖花开	zh-CN
inju	陈年旧事	zh-CN
injv	陈年旧账	zh-CN
inlj	陈年老酒	zh-CN
inly	长年累月	zh-CN
invj	刹那之间	zh-CN
inyn	痴男怨女	zh-CN
ipdl	长篇大论	zh-CN
ipdv	IP地址	zh-CN
ipld	长篇累牍	zh-CN
ipxu	长篇小说	zh-CN
iqbb	乘其不备	zh-CN
iqbf	春秋笔法	zh-CN
iqbh	惩前毖后	zh-CN
iqby	出其不意	zh-CN
iqdn	重启电脑	zh-CN
iqfr	锄强扶弱	zh-CN
iqil	潮起潮落	zh-CN
iqit	臭气冲天	zh-CN
iqjd	成群结队	zh-CN
iqld	陈腔滥调	zh-CN
iqlz	重起炉灶	zh-CN
iqqh	承前启后	zh-CN
iqql	春去秋来	zh-CN
iqry	差强人意	zh-CN
iquj	唇枪舌剑	zh-CN
iquw	成千上万	zh-CN
iqvg	春秋战国	zh-CN
iqvr	长驱直入	zh-CN
iqvu	出奇制胜	zh-CN
iqyl	长期以来	zh-CN
irbj	宠辱不惊	zh-CN
irdt	趁热打铁	zh-CN
irtd	出人头地	zh-CN
irum	痴人说梦	zh-CN
irvm	成人之美	zh-CN
irvw	乘人之危	zh-CN
irww	超然物外	zh-CN
iryl	出人意料	zh-CN
isbj	抽丝剥茧	zh-CN
iscs	差三错四	zh-CN
islj	沉思良久	zh-CN
isvv	垂死挣扎	zh-CN
isyy	畅所欲言	zh-CN
itbi	丑态百出	zh-CN
itbl	丑态毕露	zh-CN
itbu	长途跋涉	zh-CN
itdp	吹弹得破	zh-CN
itfy	尘土飞扬	zh-CN
itgn	传统观念	zh-CN
itiw	彻头彻尾	zh-CN
itkp	吹弹可破	zh-CN
itmd	传统美德	zh-CN
itsq	垂头丧气	zh-CN
ituh	传统社会	zh-CN
itvg	呈堂证供	zh-CN
itvr	出头之日	zh-CN
itwh	传统文化	zh-CN
itwz	畅通无阻	zh-CN
ityl	差太远了	zh-CN
ityq	串通一气	zh-CN
ityu	长叹一声	zh-CN
iubf	出手不凡	zh-CN
iubl	长生不老	zh-CN
iubz	成事不足	zh-CN
iudx	城市大学	zh-CN
iufr	出水芙蓉	zh-CN
iujj	常胜将军	zh-CN
iujl	崇山峻岭	zh-CN
iukj	触手可及	zh-CN
iukk	诚实可靠	zh-CN
iukq	赤手空拳	zh-CN
iult	赤身裸体	zh-CN
iuml	车水马龙	zh-CN
iund	初生牛犊	zh-CN
iuqx	承上启下	zh-CN
iurd	出双入对	zh-CN
iurh	出神入化	zh-CN
iurs	出生入死	zh-CN
iuux	诚实守信	zh-CN
iuxv	春生夏长	zh-CN
iuzt	成事在天	zh-CN
ivdj	沉重代价	zh-CN
ivfy	叱咤风云	zh-CN
ivhl	差之毫厘	zh-CN
ivja	长治久安	zh-CN
ivmg	晨钟暮鼓	zh-CN
ivnd	纯真年代	zh-CN
ivnf	吃斋念佛	zh-CN
ivqg	重整旗鼓	zh-CN
ivqr	传之其人	zh-CN
ivtr	处之泰然	zh-CN
ivvw	池中之物	zh-CN
ivwh	成者王侯	zh-CN
ivyb	嗤之以鼻	zh-CN
ivyh	持之以恒	zh-CN
ivyx	穿针引线	zh-CN
ivzx	成竹在胸	zh-CN
iwbk	成王败寇	zh-CN
iwcr	查无此人	zh-CN
iwib	称王称霸	zh-CN
iwih	唇亡齿寒	zh-CN
iwjh	传为佳话	zh-CN
iwjm	重温旧梦	zh-CN
iwkn	成为可能	zh-CN
iwuj	查无实据	zh-CN
iwxt	臭味相投	zh-CN
ixdd	称兄道弟	zh-CN
ixdt	长吁短叹	zh-CN
ixdz	捶胸顿足	zh-CN
ixel	乘兴而来	zh-CN
ixer	乘虚而入	zh-CN
ixhl	吃香喝辣	zh-CN
ixiy	诚心诚意	zh-CN
ixjl	处心积虑	zh-CN
ixqd	春夏秋冬	zh-CN
ixqh	承先启后	zh-CN
ixry	称心如意	zh-CN
ixsi	垂涎三尺	zh-CN
ixsu	长相厮守	zh-CN
ixuw	长袖善舞	zh-CN
ixvf	抽薪止沸	zh-CN
ixvj	喘息之间	zh-CN
ixvm	城下之盟	zh-CN
ixwd	喘息未定	zh-CN
ixwx	痴心妄想	zh-CN
ixwz	畅行无阻	zh-CN
ixyd	垂涎欲滴	zh-CN
ixyj	垂涎已久	zh-CN
ixyk	春宵一刻	zh-CN
iyar	春意盎然	zh-CN
iybj	迟疑不决	zh-CN
iybk	吃哑巴亏	zh-CN
iybx	出言不逊	zh-CN
iycw	愁云惨雾	zh-CN
iydb	穿衣打扮	zh-CN
iydz	绰约多姿	zh-CN
iyfh	茶余饭后	zh-CN
iyit	彻夜长谈	zh-CN
iyjh	茶余酒后	zh-CN
iylu	春意阑珊	zh-CN
iyly	沉鱼落雁	zh-CN
iymb	沉冤莫白	zh-CN
iymw	崇洋媚外	zh-CN
iynm	彻夜难眠	zh-CN
iyry	春雨如油	zh-CN
iywm	彻夜未眠	zh-CN
iywv	出言无状	zh-CN
iyyj	抽油烟机	zh-CN
izdl	车载斗量	zh-CN
izdu	迟早的事	zh-CN
izjd	传宗接代	zh-CN
jabx	桀骜不驯	zh-CN
jaqm	举案齐眉	zh-CN
jasw	居安思危	zh-CN
jaub	节哀顺变	zh-CN
jazd	骄傲自大	zh-CN
jazm	骄傲自满	zh-CN
jbbb	骄兵必败	zh-CN
jbbw	津巴布韦	zh-CN
jbdg	见不得光	zh-CN
jbfu	绝不放手	zh-CN
jbgx	绝不姑息	zh-CN
jbhh	金碧辉煌	zh-CN
jbiy	久病成医	zh-CN
jbjd	加班加点	zh-CN
jbjv	精兵简政	zh-CN
jbkc	坚不可摧	zh-CN
jbkd	急不可待	zh-CN
jbkn	急不可耐	zh-CN
jbnv	剑拔弩张	zh-CN
jbpi	捷报频传	zh-CN
jbqj	精兵强将	zh-CN
jbqy	坚壁清野	zh-CN
jbrf	健步如飞	zh-CN
jbrr	技不如人	zh-CN
jbrx	今不如昔	zh-CN
jbtj	基本条件	zh-CN
jbuh	脊背生寒	zh-CN
jbwx	洁白无瑕	zh-CN
jbxf	箭不虚发	zh-CN
jbzu	饥不择食	zh-CN
jcba	局促不安	zh-CN
jcey	仅此而已	zh-CN
jcfi	精彩纷呈	zh-CN
jcjc	将错就错	zh-CN
jcjl	精彩绝伦	zh-CN
jcjy	惊才绝艳	zh-CN
jclj	就此了结	zh-CN
jcqy	见财起意	zh-CN
jcsf	几次三番	zh-CN
jcwg	家财万贯	zh-CN
jcxh	结草衔环	zh-CN
jdbf	绝大部分	zh-CN
jdbh	绝对不会	zh-CN
jdbx	绝对不行	zh-CN
jdby	坚定不移	zh-CN
jdcm	绝顶聪明	zh-CN
jddu	绝大多数	zh-CN
jdeq	崛地而起	zh-CN
jdfg	假道伐虢	zh-CN
jdfh	绝代风华	zh-CN
jdfl	江东父老	zh-CN
jdhx	皆大欢喜	zh-CN
jdhy	夹道欢迎	zh-CN
jdil	机动车辆	zh-CN
jdiv	集大成者	zh-CN
jdiy	旧地重游	zh-CN
jdjj	亟待解决	zh-CN
jdjr	绝代佳人	zh-CN
jdld	加大力度	zh-CN
jdlh	机动灵活	zh-CN
jdly	既得利益	zh-CN
jdmd	加德满都	zh-CN
jdml	简单明了	zh-CN
jdqc	就地取材	zh-CN
jdrx	激动人心	zh-CN
jdug	见多识广	zh-CN
jdur	借刀杀人	zh-CN
jdvf	就地正法	zh-CN
jdvl	家道中落	zh-CN
jdvw	井底之蛙	zh-CN
jdwm	借贷无门	zh-CN
jdwx	近代文学	zh-CN
jdxk	精雕细刻	zh-CN
jdxs	精打细算	zh-CN
jdxu	积德行善	zh-CN
jdxv	精雕细琢	zh-CN
jdyd	家大业大	zh-CN
jdyf	教导有方	zh-CN
jdys	结党营私	zh-CN
jeij	剪恶除奸	zh-CN
jejs	吉尔吉斯	zh-CN
jejv	久而久之	zh-CN
jels	接二连三	zh-CN
jeri	嫉恶如仇	zh-CN
jey	敬而远之	zh-CN
jeyv	简而言之	zh-CN
jfdd	鸡飞蛋打	zh-CN
jfgt	鸡飞狗跳	zh-CN
jfiv	见缝插针	zh-CN
jfjp	劫富济贫	zh-CN
jfjz	见缝就钻	zh-CN
jfsu	金风送爽	zh-CN
jfud	见风使舵	zh-CN
jfum	久负盛名	zh-CN
jfvj	酒逢知己	zh-CN
jfvq	肌肤之亲	zh-CN
jfxb	今非昔比	zh-CN
jfxi	接风洗尘	zh-CN
jfy	甲方乙方	zh-CN
jfyf	奸夫淫妇	zh-CN
jfyl	金风玉露	zh-CN
jfyu	绝非易事	zh-CN
jgb	将功补过	zh-CN
jgbg	见怪不怪	zh-CN
jgbx	居高不下	zh-CN
jgck	仅供参考	zh-CN
jgeq	揭竿而起	zh-CN
jgfj	借古讽今	zh-CN
jghy	急公好义	zh-CN
jgjc	鞠躬尽瘁	zh-CN
jgjj	加官晋爵	zh-CN
jgjl	急功近利	zh-CN
jgjs	假公济私	zh-CN
jglx	居高临下	zh-CN
jgly	建功立业	zh-CN
jglz	举个例子	zh-CN
jgmj	击鼓鸣金	zh-CN
jgqb	静观其变	zh-CN
jgqg	今古奇观	zh-CN
jgqm	金鼓齐鸣	zh-CN
jgrk	举国若狂	zh-CN
jgsg	嫁狗随狗	zh-CN
jgsj	机关算尽	zh-CN
jgsx	酒过三巡	zh-CN
jgtm	金戈铁马	zh-CN
jguj	几个世纪	zh-CN
jgux	举国上下	zh-CN
jguz	将功赎罪	zh-CN
jgvc	经国之才	zh-CN
jgvn	惊弓之鸟	zh-CN
jgvt	几个钟头	zh-CN
jgvw	居功至伟	zh-CN
jgvz	将功折罪	zh-CN
jgxm	巾帼须眉	zh-CN
jgxu	几个小时	zh-CN
jgxz	精耕细作	zh-CN
jgyq	降格以求	zh-CN
jgza	居功自傲	zh-CN
jhdx	浸会大学	zh-CN
jher	酒酣耳热	zh-CN
jhes	尽欢而散	zh-CN
jhhh	江河湖海	zh-CN
jhjj	江湖救急	zh-CN
jhjp	饥寒交迫	zh-CN
jhju	见好就收	zh-CN
jhjy	静候佳音	zh-CN
jhlx	酒后乱性	zh-CN
jhmm	机会渺茫	zh-CN
jhrx	江河日下	zh-CN
jhtd	襟怀坦荡	zh-CN
jhuc	惊慌失措	zh-CN
jhuy	镜花水月	zh-CN
jhvy	机会主义	zh-CN
jhwd	惊魂未定	zh-CN
jhxf	借花献佛	zh-CN
jhxi	旧恨新仇	zh-CN
jhxq	驾鹤西去	zh-CN
jhyp	惊鸿一瞥	zh-CN
jhyr	嫁祸于人	zh-CN
jhyu	劫后余生	zh-CN
jibq	纠缠不清	zh-CN
jibx	坚持不懈	zh-CN
jieq	绝尘而去	zh-CN
jirl	酒池肉林	zh-CN
jitq	金蝉脱壳	zh-CN
jjai	计将安出	zh-CN
jjbb	结结巴巴	zh-CN
jjbg	久假不归	zh-CN
jjbl	解决不了	zh-CN
jjbt	节节败退	zh-CN
jjbu	经久不衰	zh-CN
jjbx	经久不息	zh-CN
jjcu	荆棘丛生	zh-CN
jjcy	积极参与	zh-CN
jjdd	简简单单	zh-CN
jjdl	金鸡独立	zh-CN
jjex	见机而行	zh-CN
jjfu	久经风霜	zh-CN
jjfz	积极分子	zh-CN
jjgl	犄角旮旯	zh-CN
jjgt	解甲归田	zh-CN
jjgy	九九归一	zh-CN
jjhh	家家户户	zh-CN
jjhu	聚精会神	zh-CN
jjii	进进出出	zh-CN
jjj	将计就计	zh-CN
jjji	借酒浇愁	zh-CN
jjjj	斤斤计较	zh-CN
jjjz	戒骄戒躁	zh-CN
jjkk	健健康康	zh-CN
jjkw	岌岌可危	zh-CN
jjky	久经考验	zh-CN
jjld	津津乐道	zh-CN
jjml	简洁明了	zh-CN
jjmm	急急忙忙	zh-CN
jjnv	绞尽脑汁	zh-CN
jjny	经久耐用	zh-CN
jjpu	节节攀升	zh-CN
jjql	竭尽全力	zh-CN
jjrc	仅仅如此	zh-CN
jjrx	久居人下	zh-CN
jjsd	静极思动	zh-CN
jjsj	嫁鸡随鸡	zh-CN
jjsn	竭尽所能	zh-CN
jjst	荆棘塞途	zh-CN
jjtq	经济特区	zh-CN
jjtx	兼济天下	zh-CN
jjud	借鸡生蛋	zh-CN
jjuh	经济实惠	zh-CN
jjui	久经沙场	zh-CN
jjul	节节胜利	zh-CN
jjvd	积极主动	zh-CN
jjvu	掎角之势	zh-CN
jjvv	叽叽喳喳	zh-CN
jjvx	眷眷之心	zh-CN
jjwm	籍籍无名	zh-CN
jjwt	解决问题	zh-CN
jjww	叽叽歪歪	zh-CN
jjxd	借鸡下蛋	zh-CN
jjxj	经济学家	zh-CN
jjxl	涓涓细流	zh-CN
jjxu	见机行事	zh-CN
jjy	济济一堂	zh-CN
jjys	积极因素	zh-CN
jjyt	井井有条	zh-CN
jjyu	炯炯有神	zh-CN
jjyw	津津有味	zh-CN
jjyx	解决一下	zh-CN
jjyy	兢兢业业	zh-CN
jjzt	荆棘载途	zh-CN
jkbd	叫苦不迭	zh-CN
jkbt	绝口不提	zh-CN
jkfd	艰苦奋斗	zh-CN
jkiv	健康成长	zh-CN
jkjn	救苦救难	zh-CN
jklt	叫苦连天	zh-CN
jkvk	健康状况	zh-CN
jkwv	惊恐万状	zh-CN
jkyl	金科玉律	zh-CN
jkyy	金口玉言	zh-CN
jlbd	接连不断	zh-CN
jlbs	基里巴斯	zh-CN
jlcj	江郎才尽	zh-CN
jldx	吉林大学	zh-CN
jlew	尽力而为	zh-CN
jlgl	叽里呱啦	zh-CN
jlgs	鸡零狗碎	zh-CN
jlgu	精力过剩	zh-CN
jlip	精力充沛	zh-CN
jljs	加拉加斯	zh-CN
jllv	据理力争	zh-CN
jlmg	紧锣密鼓	zh-CN
jlru	军令如山	zh-CN
jltx	君临天下	zh-CN
jlum	举例说明	zh-CN
jlvu	嗟来之食	zh-CN
jlwm	价廉物美	zh-CN
jlwu	精力旺盛	zh-CN
jlwy	见利忘义	zh-CN
jlxx	见猎心喜	zh-CN
jlyt	急流勇退	zh-CN
jmgd	鸡鸣狗盗	zh-CN
jmgf	鸡鸣狗吠	zh-CN
jmny	挤眉弄眼	zh-CN
jmqg	精明强干	zh-CN
jmqv	静脉曲张	zh-CN
jmsp	鸡毛蒜皮	zh-CN
jmvh	近墨者黑	zh-CN
jmwl	假冒伪劣	zh-CN
jmwq	举目无亲	zh-CN
jndx	暨南大学	zh-CN
jnfd	酒囊饭袋	zh-CN
jnjy	借你吉言	zh-CN
jnly	经年累月	zh-CN
jnmj	锦囊妙计	zh-CN
jnnd	今年年底	zh-CN
jnni	今年年初	zh-CN
jnxv	解囊相助	zh-CN
jnxz	艰难险阻	zh-CN
jnym	九牛一毛	zh-CN
jpgd	鸡皮疙瘩	zh-CN
jplj	筋疲力尽	zh-CN
jprw	家破人亡	zh-CN
jprx	家贫如洗	zh-CN
jpwy	就怕万一	zh-CN
jpxl	借坡下驴	zh-CN
jpxu	金盆洗手	zh-CN
jqbl	鸡犬不留	zh-CN
jqbn	鸡犬不宁	zh-CN
jqbq	坚强不屈	zh-CN
jqbv	将勤补拙	zh-CN
jqdb	夹枪带棒	zh-CN
jqdx	剑桥大学	zh-CN
jqfh	尽情发挥	zh-CN
jqfl	奖勤罚懒	zh-CN
jqgy	究其根源	zh-CN
jqhi	九曲回肠	zh-CN
jqpp	精确匹配	zh-CN
jqqx	捐弃前嫌	zh-CN
jqsn	尽其所能	zh-CN
jqsu	激情四射	zh-CN
jqut	鸡犬升天	zh-CN
jqyk	见钱眼开	zh-CN
jqyu	交浅言深	zh-CN
jrbb	坚韧不拔	zh-CN
jrbt	截然不同	zh-CN
jrbu	居然不是	zh-CN
jrev	戛然而止	zh-CN
jrhi	噤若寒蝉	zh-CN
jris	君辱臣死	zh-CN
jriz	静若处子	zh-CN
jrjj	渐入佳境	zh-CN
jrjv	见仁见智	zh-CN
jrjy	假仁假义	zh-CN
jrkl	节日快乐	zh-CN
jrlx	寄人篱下	zh-CN
jrpu	坚如磐石	zh-CN
jrpy	酒肉朋友	zh-CN
jrql	拒人千里	zh-CN
jrrc	既然如此	zh-CN
jrry	尽如人意	zh-CN
jrtx	吉人天相	zh-CN
jrub	敬如上宾	zh-CN
jrum	敬若神明	zh-CN
jrvj	惊人之举	zh-CN
jrvn	急人之难	zh-CN
jrwj	金融危机	zh-CN
jryu	孑然一身	zh-CN
jryx	井然有序	zh-CN
jryy	佳人有约	zh-CN
jrzz	矫揉造作	zh-CN
jsbj	见死不救	zh-CN
jsby	己所不欲	zh-CN
jscq	酒色财气	zh-CN
jsfu	救死扶伤	zh-CN
jsgy	集思广益	zh-CN
jskb	尖酸刻薄	zh-CN
jsvt	酒色之徒	zh-CN
jswj	见所未见	zh-CN
jsyu	九死一生	zh-CN
jtdd	惊天动地	zh-CN
jtdx	交通大学	zh-CN
jtfh	借题发挥	zh-CN
jtgs	集团公司	zh-CN
jthd	集体活动	zh-CN
jthl	惊涛骇浪	zh-CN
jtil	卷土重来	zh-CN
jtje	交头接耳	zh-CN
jtjy	几天几夜	zh-CN
jtle	焦头烂额	zh-CN
jtln	进退两难	zh-CN
jtsb	家徒四壁	zh-CN
jtsk	狡兔三窟	zh-CN
jtud	脚踏实地	zh-CN
jtuj	进退失据	zh-CN
jtvf	家庭主妇	zh-CN
jtwd	经天纬地	zh-CN
jtwg	进退维谷	zh-CN
jtwm	进退无门	zh-CN
jtxw	街头巷尾	zh-CN
jtxx	精挑细选	zh-CN
jtxy	街谈巷议	zh-CN
jtyh	交通银行	zh-CN
jtyj	鸡同鸭讲	zh-CN
jtyn	金童玉女	zh-CN
jtzm	兼听则明	zh-CN
jtzy	家庭作业	zh-CN
juab	济世安邦	zh-CN
juam	济世安民	zh-CN
jubg	据实禀告	zh-CN
jubl	接受不了	zh-CN
jubv	精神不振	zh-CN
jubx	兼收并蓄	zh-CN
judl	绝世独立	zh-CN
judq	见识短浅	zh-CN
jufl	精神分裂	zh-CN
jugr	举世公认	zh-CN
jugy	娇生惯养	zh-CN
juhf	精神焕发	zh-CN
juhh	借尸还魂	zh-CN
juhs	惊世骇俗	zh-CN
juid	积少成多	zh-CN
juit	聚沙成塔	zh-CN
juiy	积水成渊	zh-CN
jujr	济世救人	zh-CN
juju	今生今世	zh-CN
jult	近水楼台	zh-CN
julu	就事论事	zh-CN
junl	几十年来	zh-CN
junq	几十年前	zh-CN
junt	劫数难逃	zh-CN
juqb	见识浅薄	zh-CN
jurh	江山如画	zh-CN
juth	锦上添花	zh-CN
jutq	九省通衢	zh-CN
jutz	举手投足	zh-CN
juvl	举手之劳	zh-CN
juvm	举世瞩目	zh-CN
juvy	经世致用	zh-CN
juwk	金石为开	zh-CN
juwm	举世闻名	zh-CN
juwu	举世无双	zh-CN
juxl	及时行乐	zh-CN
juyd	尽收眼底	zh-CN
juyg	江山易改	zh-CN
juyh	建设银行	zh-CN
juyx	介绍一下	zh-CN
juyy	骄奢淫逸	zh-CN
juzf	今是昨非	zh-CN
juzh	洁身自好	zh-CN
juzj	经史子集	zh-CN
jvbd	见诸报端	zh-CN
jvbg	精忠报国	zh-CN
jvbj	接踵比肩	zh-CN
jvbq	坚贞不屈	zh-CN
jvbu	紧追不舍	zh-CN
jvby	久治不愈	zh-CN
jvdl	就知道了	zh-CN
jvdw	就知道玩	zh-CN
jvdx	加州大学	zh-CN
jvel	接踵而来	zh-CN
jvev	接踵而至	zh-CN
jviv	见招拆招	zh-CN
jvjl	集中精力	zh-CN
jvjz	尽职尽责	zh-CN
jvlg	加州理工	zh-CN
jvli	价值连城	zh-CN
jvmb	就这么办	zh-CN
jvmt	紧皱眉头	zh-CN
jvmw	拒之门外	zh-CN
jvnf	积重难返	zh-CN
jvqi	鸠占鹊巢	zh-CN
jvrn	禁止入内	zh-CN
jvrq	举重若轻	zh-CN
jvuc	举止失措	zh-CN
jvuv	急中生智	zh-CN
jvvi	近朱者赤	zh-CN
jvvx	急转直下	zh-CN
jvwb	夹着尾巴	zh-CN
jvxw	街知巷闻	zh-CN
jvyb	就这样吧	zh-CN
jvyc	仅止于此	zh-CN
jvyg	教职员工	zh-CN
jvyh	击中要害	zh-CN
jvyl	就这样了	zh-CN
jvyy	金枝玉叶	zh-CN
jvzv	句斟字酌	zh-CN
jwbj	既往不咎	zh-CN
jwcj	金屋藏娇	zh-CN
jwdm	久闻大名	zh-CN
jwds	居无定所	zh-CN
jwfm	泾渭分明	zh-CN
jwgv	矫枉过正	zh-CN
jwiu	教无常师	zh-CN
jwjy	绝无仅有	zh-CN
jwkl	继往开来	zh-CN
jwnr	家无宁日	zh-CN
jwsv	据我所知	zh-CN
jwtc	救亡图存	zh-CN
jwth	精卫填海	zh-CN
jwtr	惊为天人	zh-CN
jwuv	节外生枝	zh-CN
jwvr	局外之人	zh-CN
jwvv	见微知著	zh-CN
jwvy	极为重要	zh-CN
jwvz	九五之尊	zh-CN
jwzi	金无足赤	zh-CN
jxbl	居心不良	zh-CN
jxbm	敬谢不敏	zh-CN
jxbx	将心比心	zh-CN
jxdj	匠心独具	zh-CN
jxdn	嫉贤妒能	zh-CN
jxdp	惊心动魄	zh-CN
jxhu	锦绣河山	zh-CN
jxhy	交相辉映	zh-CN
jxhz	居心何在	zh-CN
jxif	见性成佛	zh-CN
jxjy	将信将疑	zh-CN
jxlu	敬贤礼士	zh-CN
jxng	积习难改	zh-CN
jxny	鲸吸牛饮	zh-CN
jxpc	居心叵测	zh-CN
jxqq	近乡情怯	zh-CN
jxry	吉祥如意	zh-CN
jxsq	见贤思齐	zh-CN
jxuw	谨小慎微	zh-CN
jxvz	假戏真做	zh-CN
jxwb	吉凶未卜	zh-CN
jxxe	居心险恶	zh-CN
jxyd	机械运动	zh-CN
jxyk	惊喜欲狂	zh-CN
jxyw	九霄云外	zh-CN
jxyy	家学渊源	zh-CN
jycb	金银财宝	zh-CN
jycd	精于此道	zh-CN
jycs	假以辞色	zh-CN
jycx	决一雌雄	zh-CN
jydb	胶原蛋白	zh-CN
jydh	解疑答惑	zh-CN
jydm	久仰大名	zh-CN
jyfl	奖优罚劣	zh-CN
jyfs	举一反三	zh-CN
jygt	紧要关头	zh-CN
jyhw	寄予厚望	zh-CN
jyhx	家喻户晓	zh-CN
jyij	积忧成疾	zh-CN
jyiq	集腋成裘	zh-CN
jyjg	家有家规	zh-CN
jykn	极有可能	zh-CN
jylc	将遇良才	zh-CN
jyly	金玉良言	zh-CN
jymt	金玉满堂	zh-CN
jyqh	机缘巧合	zh-CN
jyqi	急于求成	zh-CN
jyqj	精益求精	zh-CN
jyqw	金玉其外	zh-CN
jysh	骄阳似火	zh-CN
jysq	见异思迁	zh-CN
jysu	节衣缩食	zh-CN
jysv	决一死战	zh-CN
jytt	晶莹剔透	zh-CN
jyuf	决一胜负	zh-CN
jyuh	解疑释惑	zh-CN
jyur	假以时日	zh-CN
jyux	谨言慎行	zh-CN
jyvt	经验之谈	zh-CN
jywz	激扬文字	zh-CN
jyyd	娇艳欲滴	zh-CN
jyyr	鸡鸭鱼肉	zh-CN
jyyu	锦衣玉食	zh-CN
jyyw	见义勇为	zh-CN
jyyx	记忆犹新	zh-CN
jyzq	咎由自取	zh-CN
jzac	君子爱财	zh-CN
jzba	焦躁不安	zh-CN
jzey	竭泽而渔	zh-CN
jzfb	酒足饭饱	zh-CN
jzgq	君子固穷	zh-CN
jzhq	君子好逑	zh-CN
jzhs	尖嘴猴腮	zh-CN
jznf	家贼难防	zh-CN
jzpf	剑走偏锋	zh-CN
jzqv	举足轻重	zh-CN
jzvi	近在咫尺	zh-CN
jzvj	君子之交	zh-CN
jzvp	金字招牌	zh-CN
jzxd	捷足先登	zh-CN
jzxu	箭在弦上	zh-CN
jzyq	近在眼前	zh-CN
jzyy	君子一言	zh-CN
kbdx	口不对心	zh-CN
kbgd	愧不敢当	zh-CN
kbge	刻薄寡恩	zh-CN
kbij	溃不成军	zh-CN
kbil	看不出来	zh-CN
kbiu	科班出身	zh-CN
kbju	可不就是	zh-CN
kbkn	可不可能	zh-CN
kbky	可不可以	zh-CN
kblx	快步流星	zh-CN
kbmb	看不明白	zh-CN
kbrh	刻不容缓	zh-CN
kbtd	看不太懂	zh-CN
kbuy	看不顺眼	zh-CN
kbxq	看不下去	zh-CN
kbys	空不异色	zh-CN
kbyx	口不应心	zh-CN
kbzv	恐怖组织	zh-CN
kcif	看菜吃饭	zh-CN
kdhn	哭爹喊娘	zh-CN
kdlk	凯迪拉克	zh-CN
kdqc	夸大其词	zh-CN
kdvu	克敌制胜	zh-CN
kdyk	慨当以慷	zh-CN
kfbq	口福不浅	zh-CN
kfby	狂风暴雨	zh-CN
kfgx	空腹高心	zh-CN
kfil	跨凤乘鸾	zh-CN
kfld	狂蜂浪蝶	zh-CN
kfvy	狂风骤雨	zh-CN
kfxf	口服心服	zh-CN
kggl	客观规律	zh-CN
kgkq	可歌可泣	zh-CN
kgmx	刻骨铭心	zh-CN
kgqk	客观情况	zh-CN
kgqy	跨国企业	zh-CN
kgtj	客观条件	zh-CN
kguu	客观事实	zh-CN
kguz	口干舌燥	zh-CN
kgys	客观因素	zh-CN
kgyy	客观原因	zh-CN
khbd	葵花宝典	zh-CN
khdd	宽宏大度	zh-CN
khdl	宽宏大量	zh-CN
khiy	开怀畅饮	zh-CN
khjg	开花结果	zh-CN
khjz	抗洪救灾	zh-CN
khlv	狂轰滥炸	zh-CN
khwb	苦海无边	zh-CN
kibg	开诚布公	zh-CN
kibq	口齿不清	zh-CN
kibx	口出不逊	zh-CN
kiky	口出狂言	zh-CN
kill	口齿伶俐	zh-CN
kivj	可乘之机	zh-CN
kjbl	看家本领	zh-CN
kjcy	抗拒从严	zh-CN
kjdx	科技大学	zh-CN
kjfg	克己奉公	zh-CN
kjfu	快捷方式	zh-CN
kjgl	苦尽甘来	zh-CN
kjif	口角春风	zh-CN
kjvu	恪尽职守	zh-CN
kjyb	可见一斑	zh-CN
kjyy	开卷有益	zh-CN
kjzu	苛捐杂税	zh-CN
kkaq	苦苦哀求	zh-CN
kkbb	磕磕绊绊	zh-CN
kkbk	开口闭口	zh-CN
kkdd	苦苦等待	zh-CN
kkdh	苦苦等候	zh-CN
kket	侃侃而谈	zh-CN
kkic	慷慨陈词	zh-CN
kkja	慷慨激昂	zh-CN
kkjn	慷慨解囊	zh-CN
kkjy	慷慨就义	zh-CN
kkkl	可口可乐	zh-CN
kkll	快快乐乐	zh-CN
kkly	苦口良药	zh-CN
kknl	刻苦耐劳	zh-CN
kkpp	磕磕碰碰	zh-CN
kkpx	苦口婆心	zh-CN
kkqq	客客气气	zh-CN
kkqt	夸夸其谈	zh-CN
kkry	空空如也	zh-CN
kktt	哭哭啼啼	zh-CN
kkuu	口口声声	zh-CN
kkwp	空口无凭	zh-CN
kkxi	口口相传	zh-CN
kkxx	开开心心	zh-CN
klbj	苦乐不均	zh-CN
kldf	开朗大方	zh-CN
kldy	克罗地亚	zh-CN
klif	靠脸吃饭	zh-CN
klok	卡拉OK	zh-CN
klxf	开路先锋	zh-CN
klyh	亢龙有悔	zh-CN
klyx	看了一下	zh-CN
klyy	看了一眼	zh-CN
klzs	考虑再三	zh-CN
kmfi	枯木逢春	zh-CN
kmfj	口蜜腹剑	zh-CN
kmgp	坑蒙拐骗	zh-CN
kmjb	快马加鞭	zh-CN
kmju	开门见山	zh-CN
kmvd	孔孟之道	zh-CN
kmvl	口没遮拦	zh-CN
kmyb	快马一鞭	zh-CN
kmyd	开门揖盗	zh-CN
kmyi	抗美援朝	zh-CN
knii	困难重重	zh-CN
kphi	看破红尘	zh-CN
kpyu	开篇伊始	zh-CN
kqbu	口气不善	zh-CN
kqjh	空前绝后	zh-CN
kqkd	可圈可点	zh-CN
kqkj	克勤克俭	zh-CN
kqky	口腔溃疡	zh-CN
kqvi	可取之处	zh-CN
krbd	岿然不动	zh-CN
krij	旷日持久	zh-CN
krit	喟然长叹	zh-CN
krky	快人快语	zh-CN
krxc	看人下菜	zh-CN
krxh	口若悬河	zh-CN
krxx	扣人心弦	zh-CN
ksmx	苦思冥想	zh-CN
kstx	客死他乡	zh-CN
ksvb	客随主便	zh-CN
ksvl	哭丧着脸	zh-CN
ktbm	口吐白沫	zh-CN
ktdw	科特迪瓦	zh-CN
kthd	哭天喊地	zh-CN
ktpd	开天辟地	zh-CN
ktqd	哭天抢地	zh-CN
ktuz	看图识字	zh-CN
ktvp	空头支票	zh-CN
kuby	恪守不渝	zh-CN
kueg	空手而归	zh-CN
kukx	可上可下	zh-CN
kuqc	旷世奇才	zh-CN
kuvv	口舌之争	zh-CN
kuwp	口说无凭	zh-CN
kuxf	口是心非	zh-CN
kuyd	困兽犹斗	zh-CN
kvbv	控制不住	zh-CN
kvby	枯枝败叶	zh-CN
kvjz	抗震救灾	zh-CN
kvlg	空中楼阁	zh-CN
kvmb	控制面板	zh-CN
kvqj	刻舟求剑	zh-CN
kvrk	脍炙人口	zh-CN
kvzl	苦中作乐	zh-CN
kwvl	口无遮拦	zh-CN
kwxd	开玩笑的	zh-CN
kwyl	孔武有力	zh-CN
kwyr	空无一人	zh-CN
kwyw	空无一物	zh-CN
kwzd	狂妄自大	zh-CN
kxbd	哭笑不得	zh-CN
kxev	可想而知	zh-CN
kxgy	苦心孤诣	zh-CN
kxhk	夸下海口	zh-CN
kxjy	苦心经营	zh-CN
kxkh	可喜可贺	zh-CN
kxlf	空穴来风	zh-CN
kxvr	胯下之辱	zh-CN
kxyi	空喜一场	zh-CN
kybk	看也不看	zh-CN
kydh	可以的话	zh-CN
kydr	宽以待人	zh-CN
kyjd	宽衣解带	zh-CN
kyjl	开源节流	zh-CN
kykw	可有可无	zh-CN
kyyx	溃于蚁穴	zh-CN
kzmy	开宗明义	zh-CN
kzyl	看在眼里	zh-CN
lahm	柳暗花明	zh-CN
lbbk	狼狈不堪	zh-CN
lbcx	力不从心	zh-CN
lbjl	来不及了	zh-CN
lbjn	兰博基尼	zh-CN
lbkf	礼不可废	zh-CN
lbkp	牢不可破	zh-CN
lbkv	乐不可支	zh-CN
lbly	利比里亚	zh-CN
lbmm	厉兵秣马	zh-CN
lbnj	力不能及	zh-CN
lbqc	萝卜青菜	zh-CN
lbsd	老不死的	zh-CN
lbsu	乐不思蜀	zh-CN
lbuh	力拔山河	zh-CN
lbur	力不胜任	zh-CN
lbut	狼奔豕突	zh-CN
lbuy	路不拾遗	zh-CN
lbwj	狼狈为奸	zh-CN
lbwv	狼狈万状	zh-CN
lbxg	两不相干	zh-CN
lbxy	聊表心意	zh-CN
lcbp	乐此不疲	zh-CN
lccv	立此存照	zh-CN
lcry	绿草如茵	zh-CN
lcsf	屡次三番	zh-CN
lcvb	鳞次栉比	zh-CN
lcvq	零存整取	zh-CN
lcwk	落草为寇	zh-CN
lcza	流窜作案	zh-CN
ldbd	雷打不动	zh-CN
ldbi	漏洞百出	zh-CN
ldbl	另当别论	zh-CN
ldbx	老大不小	zh-CN
ldif	立地成佛	zh-CN
ldit	老调重弹	zh-CN
ldjj	雷电交加	zh-CN
ldmv	拉丁美洲	zh-CN
ldmy	灵丹妙药	zh-CN
ldry	锒铛入狱	zh-CN
ldtj	李代桃僵	zh-CN
ldwi	老大无成	zh-CN
ldwq	力大无穷	zh-CN
ldxm	浪得虚名	zh-CN
ldyb	利大于弊	zh-CN
ldyu	落地有声	zh-CN
ldyv	老当益壮	zh-CN
ldyy	乱点鸳鸯	zh-CN
ldzj	流动资金	zh-CN
ldzm	拉丁字母	zh-CN
ldzr	连带责任	zh-CN
lebs	老而不死	zh-CN
leby	乐而不淫	zh-CN
lewf	乐而忘返	zh-CN
lewg	劳而无功	zh-CN
lfbu	流芳百世	zh-CN
lffw	龙飞凤舞	zh-CN
lfhm	鸾凤和鸣	zh-CN
lfhu	绿肥红瘦	zh-CN
lfix	龙凤呈祥	zh-CN
lflq	老夫老妻	zh-CN
lfqg	流芳千古	zh-CN
lfuq	老夫少妻	zh-CN
lfuv	轮番上阵	zh-CN
lfyf	罗敷有夫	zh-CN
lgdp	连滚带爬	zh-CN
lgdv	两个多钟	zh-CN
lgdx	理工大学	zh-CN
lgdy	两个多月	zh-CN
lgfn	龙肝凤脑	zh-CN
lgjy	立竿见影	zh-CN
lgqj	六根清净	zh-CN
lgsk	卢甘斯克	zh-CN
lguz	立功赎罪	zh-CN
lgvb	立国之本	zh-CN
lgvt	两个钟头	zh-CN
lgvy	乐观主义	zh-CN
lgxq	两个星期	zh-CN
lgxu	两个小时	zh-CN
lgyc	流光溢彩	zh-CN
lhdb	灵活多变	zh-CN
lhdy	梨花带雨	zh-CN
lhet	落荒而逃	zh-CN
lhiq	炉火纯青	zh-CN
lhjd	灵活机动	zh-CN
lhlu	落花流水	zh-CN
lhly	两河流域	zh-CN
lhti	老汉推车	zh-CN
lhvf	联合政府	zh-CN
lhwh	联欢晚会	zh-CN
lhxd	两虎相斗	zh-CN
lhxg	利害相关	zh-CN
lhxt	脸红心跳	zh-CN
lhxv	两虎相争	zh-CN
lhyg	利害攸关	zh-CN
lhyy	落花有意	zh-CN
libx	离愁别绪	zh-CN
liiv	老成持重	zh-CN
lijf	六朝金粉	zh-CN
lijr	良辰吉日	zh-CN
limj	良辰美景	zh-CN
lizz	乱臣贼子	zh-CN
ljbg	屡教不改	zh-CN
ljbp	路见不平	zh-CN
ljbv	屡禁不止	zh-CN
ljbx	屡见不鲜	zh-CN
ljfg	廉洁奉公	zh-CN
ljfi	龙驹凤雏	zh-CN
ljfl	老骥伏枥	zh-CN
ljfm	棱角分明	zh-CN
ljfn	良家妇女	zh-CN
ljim	老将出马	zh-CN
ljjh	老奸巨猾	zh-CN
ljpd	离经叛道	zh-CN
ljtv	励精图治	zh-CN
ljty	浪迹天涯	zh-CN
ljub	乐极生悲	zh-CN
ljxu	落井下石	zh-CN
ljyb	略见一斑	zh-CN
ljyd	灵机一动	zh-CN
ljyx	了解一下	zh-CN
ljzl	廉洁自律	zh-CN
ljzx	乱箭攒心	zh-CN
lkgg	劳苦功高	zh-CN
lklf	滥砍滥伐	zh-CN
lkss	雷克萨斯	zh-CN
lkyx	良苦用心	zh-CN
llbb	搂搂抱抱	zh-CN
llbt	浪里白条	zh-CN
lldf	落落大方	zh-CN
llex	量力而行	zh-CN
llfc	乱了分寸	zh-CN
llfi	沦落风尘	zh-CN
llfx	雷厉风行	zh-CN
llgh	落落寡欢	zh-CN
llid	两肋插刀	zh-CN
llii	拉拉扯扯	zh-CN
lljj	寥寥几句	zh-CN
lljv	淋漓尽致	zh-CN
lllq	聊来聊去	zh-CN
llls	啰里啰嗦	zh-CN
llqk	朗朗乾坤	zh-CN
llqq	来来去去	zh-CN
llrx	笼络人心	zh-CN
llss	零零碎碎	zh-CN
lltt	玲珑剔透	zh-CN
lltx	勠力同心	zh-CN
lluk	朗朗上口	zh-CN
llur	寥寥数人	zh-CN
llus	流离失所	zh-CN
lluu	老老实实	zh-CN
lluy	寥寥数语	zh-CN
llvj	乱了阵脚	zh-CN
llvv	林林种种	zh-CN
llwf	流连忘返	zh-CN
llyx	聊了一下	zh-CN
llzh	老泪纵横	zh-CN
llzm	历历在目	zh-CN
llzz	林林总总	zh-CN
lmbd	连绵不断	zh-CN
lmbj	连绵不绝	zh-CN
lmbx	黎民百姓	zh-CN
lmdg	罗马帝国	zh-CN
lmdk	罗曼蒂克	zh-CN
lmgv	廉明公正	zh-CN
lmju	龙马精神	zh-CN
lmny	罗马尼亚	zh-CN
lmuc	劳民伤财	zh-CN
lmus	老谋深算	zh-CN
lmut	老马识途	zh-CN
lmyj	临门一脚	zh-CN
lnbl	流年不利	zh-CN
lnid	老年痴呆	zh-CN
lnsu	流年似水	zh-CN
lnud	老牛舐犊	zh-CN
lnzv	冷暖自知	zh-CN
lphj	龙盘虎踞	zh-CN
lpld	连篇累牍	zh-CN
lply	廉颇老矣	zh-CN
lpvy	力排众议	zh-CN
lpxj	另辟蹊径	zh-CN
lqbg	屡劝不改	zh-CN
lqbr	六亲不认	zh-CN
lqbz	乱七八糟	zh-CN
lqcc	来去匆匆	zh-CN
lqcq	理屈词穷	zh-CN
lqdv	六七点钟	zh-CN
lqgm	另请高明	zh-CN
lqhq	老气横秋	zh-CN
lqlz	另起炉灶	zh-CN
lqqy	郎情妾意	zh-CN
lqrf	来去如风	zh-CN
lqsd	零敲碎打	zh-CN
lqsj	离群索居	zh-CN
lqwq	乐趣无穷	zh-CN
lqwz	来去无踪	zh-CN
lqxy	两情相悦	zh-CN
lqzm	良禽择木	zh-CN
lqzy	来去自由	zh-CN
lrbc	老弱病残	zh-CN
lrbj	令人不解	zh-CN
lrbu	冷若冰霜	zh-CN
lrdr	令人动容	zh-CN
lrfg	令人反感	zh-CN
lrfi	来日方长	zh-CN
lrfj	令人费解	zh-CN
lrfv	令人发指	zh-CN
lrij	令人吃惊	zh-CN
lrix	寥若晨星	zh-CN
lrjv	路人皆知	zh-CN
lrjx	令人惊喜	zh-CN
lrjy	令人惊讶	zh-CN
lrlj	利人利己	zh-CN
lrmy	令人满意	zh-CN
lrqy	泪如泉涌	zh-CN
lrty	令人讨厌	zh-CN
lruw	令人神往	zh-CN
lruy	令人生厌	zh-CN
lrvj	令人震惊	zh-CN
lrvv	了如指掌	zh-CN
lrwi	量入为出	zh-CN
lrxf	令人信服	zh-CN
lrxv	令人心折	zh-CN
lryh	令人遗憾	zh-CN
lryx	泪如雨下	zh-CN
lryy	烈日炎炎	zh-CN
lrzo	令人作呕	zh-CN
lrzt	令人赞叹	zh-CN
lsfy	连锁反应	zh-CN
lshb	绿色环保	zh-CN
lsjh	两三句话	zh-CN
lslh	累死累活	zh-CN
lsls	劳斯莱斯	zh-CN
lsnj	力所能及	zh-CN
lsrd	老僧入定	zh-CN
lsuu	鹿死谁手	zh-CN
lsyd	理所应当	zh-CN
ltbx	来头不小	zh-CN
ltcy	量体裁衣	zh-CN
lthx	龙潭虎穴	zh-CN
lthy	狼吞虎咽	zh-CN
ltln	愣头愣脑	zh-CN
ltlv	老态龙钟	zh-CN
ltly	流通领域	zh-CN
ltqd	流通渠道	zh-CN
ltuw	两天晒网	zh-CN
ltvb	力透纸背	zh-CN
ltvm	乐天知命	zh-CN
ltwg	里通外国	zh-CN
ltwj	雷霆万钧	zh-CN
ltwl	离题万里	zh-CN
ltwy	拉脱维亚	zh-CN
ltyy	老天有眼	zh-CN
lubf	流水不腐	zh-CN
lubj	老实巴交	zh-CN
lubq	敛声屏气	zh-CN
lubu	屡试不爽	zh-CN
luch	辣手摧花	zh-CN
ludv	劳师动众	zh-CN
ludz	量身定做	zh-CN
lugj	老鼠过街	zh-CN
luhj	六十花甲	zh-CN
luhz	龙蛇混杂	zh-CN
luiq	吕氏春秋	zh-CN
luit	老生常谈	zh-CN
luiy	绿树成荫	zh-CN
lujz	梁上君子	zh-CN
lukk	两手空空	zh-CN
luqy	临时起意	zh-CN
luvb	两手准备	zh-CN
luvd	乱世重典	zh-CN
luwg	滥杀无辜	zh-CN
luwl	礼尚往来	zh-CN
luwq	流水无情	zh-CN
luwr	两世为人	zh-CN
luwv	六神无主	zh-CN
luxj	历史学家	zh-CN
luxy	老少咸宜	zh-CN
luyi	略胜一筹	zh-CN
luyw	聊胜于无	zh-CN
luyx	烂熟于心	zh-CN
luzz	老神在在	zh-CN
lvbj	来者不拒	zh-CN
lvbu	来者不善	zh-CN
lvby	来之不易	zh-CN
lvdj	溜之大吉	zh-CN
lvhd	龙争虎斗	zh-CN
lvlb	屡战屡败	zh-CN
lvmq	临阵磨枪	zh-CN
lvqv	理直气壮	zh-CN
lvsy	连中三元	zh-CN
lvts	临阵退缩	zh-CN
lvtt	临阵脱逃	zh-CN
lvvd	立锥之地	zh-CN
lvvn	笼中之鸟	zh-CN
lvvy	聊斋志异	zh-CN
lwbj	临危不惧	zh-CN
lwbl	临危不乱	zh-CN
lwkl	力挽狂澜	zh-CN
lwqg	了无牵挂	zh-CN
lwum	临危受命	zh-CN
lwuq	了无生趣	zh-CN
lwvy	漏网之鱼	zh-CN
lwxb	沦为笑柄	zh-CN
lxbj	离乡背井	zh-CN
lxdh	联系电话	zh-CN
lxgf	狼心狗肺	zh-CN
lxgq	流行歌曲	zh-CN
lxgu	例行公事	zh-CN
lxgy	流星赶月	zh-CN
lxhb	龙行虎步	zh-CN
lxhv	兰心蕙质	zh-CN
lxin	老羞成怒	zh-CN
lxjv	令行禁止	zh-CN
lxjy	厉行节约	zh-CN
lxld	离心离德	zh-CN
lxli	连下两城	zh-CN
lxpm	溜须拍马	zh-CN
lxqf	两袖清风	zh-CN
lxqy	两厢情愿	zh-CN
lxry	履险如夷	zh-CN
lxvd	理想中的	zh-CN
lxwc	两小无猜	zh-CN
lxwm	落下帷幕	zh-CN
lxxu	礼贤下士	zh-CN
lxxy	怜香惜玉	zh-CN
lxyi	略逊一筹	zh-CN
lxyr	礼下于人	zh-CN
lyaj	乐业安居	zh-CN
lybd	力有不逮	zh-CN
lybf	落英缤纷	zh-CN
lybq	良莠不齐	zh-CN
lycc	来也匆匆	zh-CN
lyff	劳燕分飞	zh-CN
lyfm	另一方面	zh-CN
lyfy	流言蜚语	zh-CN
lygg	落叶归根	zh-CN
lygr	另一个人	zh-CN
lyhh	老眼昏花	zh-CN
lyhu	另一回事	zh-CN
lyhx	龙吟虎啸	zh-CN
lyiu	滥竽充数	zh-CN
lyjh	劳逸结合	zh-CN
lyjn	累月经年	zh-CN
lykk	良药苦口	zh-CN
lyly	冷言冷语	zh-CN
lypg	冷眼旁观	zh-CN
lyqr	另有其人	zh-CN
lyrc	理应如此	zh-CN
lysl	老有所乐	zh-CN
lysq	狼烟四起	zh-CN
lysw	老有所为	zh-CN
lysy	老有所依	zh-CN
lyuc	赖以生存	zh-CN
lyug	老于世故	zh-CN
lyvb	礼仪之邦	zh-CN
lyvq	滥用职权	zh-CN
lyvr	乐于助人	zh-CN
lyvz	牢狱之灾	zh-CN
lywd	力有未逮	zh-CN
lywh	里应外合	zh-CN
lywu	赖以为生	zh-CN
lyxd	冷眼相待	zh-CN
lyxk	另眼相看	zh-CN
lyxu	流于形式	zh-CN
lyxx	利欲熏心	zh-CN
lyyd	留有余地	zh-CN
lyyq	另有隐情	zh-CN
lyzw	聊以自慰	zh-CN
lyzy	聊以自娱	zh-CN
lzhf	路在何方	zh-CN
lzht	浪子回头	zh-CN
lzlz	列祖列宗	zh-CN
lzpb	论资排辈	zh-CN
lzqv	乐在其中	zh-CN
lzrn	烂醉如泥	zh-CN
lzvd	立足之地	zh-CN
lzyt	乱作一团	zh-CN
lzyx	狼子野心	zh-CN
lzzd	乱糟糟的	zh-CN
mbdy	麻痹大意	zh-CN
mbfu	名不副实	zh-CN
mbgl	忙不过来	zh-CN
mbgx	漠不关心	zh-CN
mbjl	蛮不讲理	zh-CN
mbjr	貌不惊人	zh-CN
mbjx	漫不经心	zh-CN
mbkf	密不可分	zh-CN
mbky	妙不可言	zh-CN
mbld	免不了的	zh-CN
mblu	民不聊生	zh-CN
mbmb	明不明白	zh-CN
mbrd	目不忍睹	zh-CN
mbsg	面壁思过	zh-CN
mbtf	密不透风	zh-CN
mbtt	马不停蹄	zh-CN
mbud	目不识丁	zh-CN
mbuf	明辨是非	zh-CN
mbuh	妙笔生花	zh-CN
mbuu	美不胜收	zh-CN
mbvj	目不转睛	zh-CN
mbvl	绵薄之力	zh-CN
mbww	明白无误	zh-CN
mbxi	名不虚传	zh-CN
mbxj	目不暇接	zh-CN
mbxu	目不斜视	zh-CN
mbzh	满不在乎	zh-CN
mcgu	莫测高深	zh-CN
mchm	谋财害命	zh-CN
mcuw	名存实亡	zh-CN
mczb	芒刺在背	zh-CN
mddz	酩酊大醉	zh-CN
mdhd	门当户对	zh-CN
mdhh	磨刀霍霍	zh-CN
mdhu	没当回事	zh-CN
mdhv	买椟还珠	zh-CN
mdig	马到成功	zh-CN
mdkd	目瞪口呆	zh-CN
mdms	满打满算	zh-CN
mdmx	没大没小	zh-CN
mdvn	耄耋之年	zh-CN
mdvy	满地找牙	zh-CN
mdvz	灭顶之灾	zh-CN
mdwx	面带微笑	zh-CN
mdxu	面对现实	zh-CN
mebx	秘而不宣	zh-CN
medf	马尔代夫	zh-CN
medw	摩尔多瓦	zh-CN
meyn	卖儿鬻女	zh-CN
mfgq	民富国强	zh-CN
mfhq	命赴黄泉	zh-CN
mfhy	满腹狐疑	zh-CN
mfjl	满腹经纶	zh-CN
mfnu	马放南山	zh-CN
mfqu	名副其实	zh-CN
mfsw	眉飞色舞	zh-CN
mfwc	免费午餐	zh-CN
mfwi	莫非王臣	zh-CN
mfwt	莫非王土	zh-CN
mfyt	满腹疑团	zh-CN
mgdj	没过多久	zh-CN
mgdq	目光短浅	zh-CN
mgiv	暮鼓晨钟	zh-CN
mgjd	每个阶段	zh-CN
mgjj	目光炯炯	zh-CN
mgsr	毛骨悚然	zh-CN
mgvf	美国政府	zh-CN
mgwn	铭感五内	zh-CN
mgxh	慢工细活	zh-CN
mgyd	眉高眼低	zh-CN
mgyv	魔高一丈	zh-CN
mhbj	迷惑不解	zh-CN
mhbq	模糊不清	zh-CN
mheg	沐猴而冠	zh-CN
mhei	面红耳赤	zh-CN
mhgg	蒙混过关	zh-CN
mhhu	幕后黑手	zh-CN
mhju	面黄肌瘦	zh-CN
mhmd	穆罕默德	zh-CN
mhqx	满汉全席	zh-CN
mhsl	眠花宿柳	zh-CN
mhul	貌合神离	zh-CN
mhvh	没话找话	zh-CN
mhvj	门户之见	zh-CN
mhwl	蛮横无理	zh-CN
mhxw	满怀希望	zh-CN
mhxx	满怀信心	zh-CN
mhyv	名花有主	zh-CN
miaf	明察暗访	zh-CN
mify	满城风雨	zh-CN
minw	没齿难忘	zh-CN
miqg	名垂千古	zh-CN
miqh	明察秋毫	zh-CN
miqu	名垂青史	zh-CN
mjdc	没精打采	zh-CN
mjgx	明镜高悬	zh-CN
mjjv	摩肩接踵	zh-CN
mjrx	灭绝人性	zh-CN
mjsy	门禁森严	zh-CN
mjub	鸣金收兵	zh-CN
mjwg	墨迹未干	zh-CN
mjwx	民间文学	zh-CN
mjzx	铭记在心	zh-CN
mkbl	马可波罗	zh-CN
mked	梅开二度	zh-CN
mkil	没看出来	zh-CN
mkmv	莫可名状	zh-CN
mkyq	目空一切	zh-CN
mkyx	每况愈下	zh-CN
mkzk	免开尊口	zh-CN
mlbu	名列榜首	zh-CN
mlcv	绵里藏针	zh-CN
mldj	没来得及	zh-CN
mldr	美丽动人	zh-CN
mlhi	茉莉花茶	zh-CN
mlkd	鸣锣开道	zh-CN
mllk	模棱两可	zh-CN
mlmh	美轮美奂	zh-CN
mlmu	没老没少	zh-CN
mlmy	眯了眯眼	zh-CN
mlmz	抿了抿嘴	zh-CN
mlns	面露难色	zh-CN
mlqm	名列前茅	zh-CN
mlqs	毛里求斯	zh-CN
mlqu	名留青史	zh-CN
mlsu	名落孙山	zh-CN
mlth	满脸通红	zh-CN
mltx	忙里偷闲	zh-CN
mlty	蜜里调油	zh-CN
mluu	名利双收	zh-CN
mlvj	弥留之际	zh-CN
mlvv	米粒之珠	zh-CN
mlvy	马列主义	zh-CN
mlxg	目露凶光	zh-CN
mlxy	马来西亚	zh-CN
mlyh	睦邻友好	zh-CN
mlyq	眉来眼去	zh-CN
mmbb	明明白白	zh-CN
mmbl	闷闷不乐	zh-CN
mmbr	麻木不仁	zh-CN
mmcc	磨磨蹭蹭	zh-CN
mmdh	茫茫大海	zh-CN
mmdt	冒名顶替	zh-CN
mmel	慕名而来	zh-CN
mmfd	名目繁多	zh-CN
mmgx	名门闺秀	zh-CN
mmh	迷迷糊糊	zh-CN
mmhg	满面红光	zh-CN
mmhh	马马虎虎	zh-CN
mmhi	明眸皓齿	zh-CN
mmhq	脉脉含情	zh-CN
mmiq	眉目传情	zh-CN
mmiv	美梦成真	zh-CN
mmiy	满目疮痍	zh-CN
mmjd	面面俱到	zh-CN
mmjj	磨磨叽叽	zh-CN
mmjl	美妙绝伦	zh-CN
mmkz	面目可憎	zh-CN
mmll	忙忙碌碌	zh-CN
mmmm	密密麻麻	zh-CN
mmqf	面目全非	zh-CN
mmqi	明末清初	zh-CN
mmqm	莫名其妙	zh-CN
mmrh	貌美如花	zh-CN
mmsq	孟母三迁	zh-CN
mmtx	名满天下	zh-CN
mmvd	明目张胆	zh-CN
mmvq	明媒正娶	zh-CN
mmvv	冥冥之中	zh-CN
mmvy	靡靡之音	zh-CN
mmwu	默默无声	zh-CN
mmwv	蒙昧无知	zh-CN
mmww	默默无闻	zh-CN
mmwy	默默无言	zh-CN
mmwz	名门望族	zh-CN
mmxq	面面相觑	zh-CN
mmxy	蒙蒙细雨	zh-CN
mmyq	梦寐以求	zh-CN
mmyx	面貌一新	zh-CN
mmyy	慢慢悠悠	zh-CN
mngy	木讷寡言	zh-CN
mnhu	没那回事	zh-CN
mnlm	木牛流马	zh-CN
mnlu	蒙娜丽莎	zh-CN
mnmb	没弄明白	zh-CN
mnmy	某年某月	zh-CN
mnvj	莫逆之交	zh-CN
mnyn	卖男鬻女	zh-CN
mpdx	名牌大学	zh-CN
mpgd	摸爬滚打	zh-CN
mpju	满盘皆输	zh-CN
mpzg	母凭子贵	zh-CN
mqaj	明枪暗箭	zh-CN
mqbl	牟取暴利	zh-CN
mqcv	摩拳擦掌	zh-CN
mqgd	明确规定	zh-CN
mqgv	密切关注	zh-CN
mqhu	妙趣横生	zh-CN
mqlx	密切联系	zh-CN
mqmx	眉清目秀	zh-CN
mqmy	美其名曰	zh-CN
mqri	满腔热忱	zh-CN
mqsl	谋取私利	zh-CN
mqsx	麻雀虽小	zh-CN
mqwv	目前为止	zh-CN
mqww	明确无误	zh-CN
mqxg	密切相关	zh-CN
mqxz	马前小卒	zh-CN
mqyd	明枪易躲	zh-CN
mrbv	盲人把烛	zh-CN
mrgy	美如冠玉	zh-CN
mrhh	明日黄花	zh-CN
mrhu	蓦然回首	zh-CN
mrim	美人迟暮	zh-CN
mrlc	没人理睬	zh-CN
mrmx	盲人摸象	zh-CN
mrmy	没日没夜	zh-CN
mrt	美若天仙	zh-CN
mrth	面如桃花	zh-CN
mrts	面如土色	zh-CN
mrtx	貌若天仙	zh-CN
mrvv	漠然置之	zh-CN
mrwc	茫然无措	zh-CN
msbk	莫桑比克	zh-CN
msdk	茅塞顿开	zh-CN
mskx	冥思苦想	zh-CN
mszj	毛遂自荐	zh-CN
mtdh	满头大汗	zh-CN
mtdi	命途多舛	zh-CN
mtdz	弥天大罪	zh-CN
mtgh	瞒天过海	zh-CN
mtgu	莫谈国事	zh-CN
mtkg	埋头苦干	zh-CN
mtll	门庭冷落	zh-CN
mtmn	没头没脑	zh-CN
mtru	门庭若市	zh-CN
mtsl	慢条斯理	zh-CN
mtug	没听说过	zh-CN
mtvf	迷途知返	zh-CN
mtxd	满天星斗	zh-CN
mtyj	漫天要价	zh-CN
muaj	民事案件	zh-CN
muby	漫山遍野	zh-CN
mudv	名声大振	zh-CN
mufl	名士风流	zh-CN
mugj	名胜古迹	zh-CN
muhi	妙手回春	zh-CN
muig	墨守成规	zh-CN
mujy	面授机宜	zh-CN
mukk	妙手空空	zh-CN
muld	玛莎拉蒂	zh-CN
mulg	麻省理工	zh-CN
mumi	马瘦毛长	zh-CN
mumj	毛手毛脚	zh-CN
munf	名实难副	zh-CN
muod	妙手偶得	zh-CN
muqt	马失前蹄	zh-CN
muqx	瞒上欺下	zh-CN
murx	妙手仁心	zh-CN
mutk	卖身投靠	zh-CN
muuv	马首是瞻	zh-CN
muwg	面上无光	zh-CN
muzr	谋事在人	zh-CN
muzw	名声在外	zh-CN
mvad	明争暗斗	zh-CN
mvat	明珠暗投	zh-CN
mvbu	明哲保身	zh-CN
mvbz	美中不足	zh-CN
mvdp	民主党派	zh-CN
mvdx	明正典刑	zh-CN
mvgf	明知故犯	zh-CN
mvgw	明知故问	zh-CN
mvhu	没这回事	zh-CN
mvlu	猫捉老鼠	zh-CN
mvlx	昧着良心	zh-CN
mvmg	民脂民膏	zh-CN
mvqr	梦中情人	zh-CN
mvtx	名震天下	zh-CN
mvvd	命中注定	zh-CN
mvvj	明智之举	zh-CN
mvwg	墨汁未干	zh-CN
mvwr	目中无人	zh-CN
mvyu	名正言顺	zh-CN
mwbj	漫无边际	zh-CN
mwbl	冥顽不灵	zh-CN
mwbq	面无表情	zh-CN
mwgd	明文规定	zh-CN
mwjy	美味佳肴	zh-CN
mwmd	漫无目的	zh-CN
mwml	没完没了	zh-CN
mwqn	勉为其难	zh-CN
mwry	渺无人烟	zh-CN
mwtx	茫无头绪	zh-CN
mwwf	目无王法	zh-CN
mwxs	面无血色	zh-CN
mwyx	渺无音信	zh-CN
mwzv	目无尊长	zh-CN
mxgi	墨西哥城	zh-CN
mxhx	满心欢喜	zh-CN
mxiv	梦想成真	zh-CN
mxkg	铭心刻骨	zh-CN
mxmf	没心没肺	zh-CN
mxuh	母系社会	zh-CN
mxvd	明修栈道	zh-CN
mxwl	面向未来	zh-CN
mxwx	名下无虚	zh-CN
mxxg	毛细血管	zh-CN
mxyl	木秀于林	zh-CN
mxyx	命悬一线	zh-CN
mxzw	扪心自问	zh-CN
mybd	绵延不断	zh-CN
mybf	没有办法	zh-CN
mybh	贸易保护	zh-CN
mybl	贸易壁垒	zh-CN
mybw	没有把握	zh-CN
myby	没有必要	zh-CN
mydh	没有的话	zh-CN
myfm	某一方面	zh-CN
myft	民怨沸腾	zh-CN
mygr	每一个人	zh-CN
mygz	每一个字	zh-CN
myis	满园春色	zh-CN
myiv	木已成舟	zh-CN
myjh	每一句话	zh-CN
mylv	妙语连珠	zh-CN
myly	没有理由	zh-CN
mymr	某月某日	zh-CN
myni	贸易逆差	zh-CN
myns	面有难色	zh-CN
mypi	卖淫嫖娼	zh-CN
myqf	明月清风	zh-CN
myql	谬以千里	zh-CN
myqy	民营企业	zh-CN
mysh	名扬四海	zh-CN
mysy	买一送一	zh-CN
mytx	名扬天下	zh-CN
myui	贸易顺差	zh-CN
mywl	贸易往来	zh-CN
mywt	没有问题	zh-CN
myyy	没有意义	zh-CN
mzeg	满载而归	zh-CN
mzgl	蒙在鼓里	zh-CN
mzmw	没滋没味	zh-CN
mzvg	弥足珍贵	zh-CN
mzyu	名噪一时	zh-CN
nbej	诺贝尔奖	zh-CN
nbhh	牛逼哄哄	zh-CN
nbiu	拿不出手	zh-CN
nbju	那不就是	zh-CN
nbke	怒不可遏	zh-CN
nblu	鸟不拉屎	zh-CN
nbmb	弄不明白	zh-CN
nbnv	女扮男装	zh-CN
nbqi	弄不清楚	zh-CN
ncnm	男才女貌	zh-CN
ncqj	难辞其咎	zh-CN
nddh	男大当婚	zh-CN
nddj	女大当嫁	zh-CN
ndht	难得糊涂	zh-CN
ndjy	年代久远	zh-CN
ndni	男盗女娼	zh-CN
ndrl	那当然了	zh-CN
nduj	那段时间	zh-CN
ndvy	拿定主意	zh-CN
ndxu	牛刀小试	zh-CN
ndyj	难得一见	zh-CN
ndyu	那倒也是	zh-CN
nfig	怒发冲冠	zh-CN
nflq	年富力强	zh-CN
nfnj	难分难解	zh-CN
nfyn	年复一年	zh-CN
ngbb	年过半百	zh-CN
ngdu	年高德劭	zh-CN
ngdx	那个东西	zh-CN
ngfg	南国风光	zh-CN
ngnv	男耕女织	zh-CN
ngqj	能工巧匠	zh-CN
ngsu	年过三十	zh-CN
nguu	牛鬼蛇神	zh-CN
nguw	能歌善舞	zh-CN
nhgx	南回归线	zh-CN
nhna	男欢女爱	zh-CN
nhnj	男婚女嫁	zh-CN
nhrc	拈花惹草	zh-CN
nhvu	怒火中烧	zh-CN
nhvw	呐喊助威	zh-CN
nhyu	那还用说	zh-CN
njdx	南京大学	zh-CN
njgc	鸟尽弓藏	zh-CN
njiv	弄假成真	zh-CN
njlg	尼加拉瓜	zh-CN
njnf	难解难分	zh-CN
njqq	年纪轻轻	zh-CN
njsl	那就算了	zh-CN
njvy	宁静致远	zh-CN
nkdx	南开大学	zh-CN
nkrx	囊空如洗	zh-CN
nksh	囊括四海	zh-CN
nkwy	扭亏为盈	zh-CN
nkym	南柯一梦	zh-CN
nlbw	南来北往	zh-CN
nleu	逆流而上	zh-CN
nlld	脑力劳动	zh-CN
nllu	年老力衰	zh-CN
nlnt	挠了挠头	zh-CN
nlsu	年老色衰	zh-CN
nltr	年老体弱	zh-CN
nltu	年老体衰	zh-CN
nluu	逆来顺受	zh-CN
nlvb	女流之辈	zh-CN
nlvn	牛郎织女	zh-CN
nmby	纳米比亚	zh-CN
nmdn	那么多年	zh-CN
nmdr	那么多人	zh-CN
nmeu	怒目而视	zh-CN
nmhu	那么回事	zh-CN
nmif	脑满肠肥	zh-CN
nmtr	年迈体弱	zh-CN
nmui	农贸市场	zh-CN
nmvc	浓墨重彩	zh-CN
nnbw	念念不忘	zh-CN
nnbx	男女不限	zh-CN
nndp	男女搭配	zh-CN
nnkg	难能可贵	zh-CN
nnlu	男女老少	zh-CN
nnly	男女老幼	zh-CN
nnpd	男女平等	zh-CN
nnrh	泥牛入海	zh-CN
nnss	年年岁岁	zh-CN
nntt	袅袅婷婷	zh-CN
nnwh	能奈我何	zh-CN
nnyc	念念有词	zh-CN
nnyy	年年有余	zh-CN
nnzy	喃喃自语	zh-CN
nqbd	南腔北调	zh-CN
nqbv	怒其不争	zh-CN
nqhp	鸟枪换炮	zh-CN
nqii	怒气冲冲	zh-CN
nqit	怒气冲天	zh-CN
nqiv	弄巧成拙	zh-CN
nqlv	年轻力壮	zh-CN
nqmy	浓情蜜意	zh-CN
nqnu	能屈能伸	zh-CN
nqpv	拈轻怕重	zh-CN
nqwl	宁缺毋滥	zh-CN
nqyw	年轻有为	zh-CN
nrly	尼日利亚	zh-CN
nrxw	耐人寻味	zh-CN
nsbq	宁死不屈	zh-CN
nsdk	纳斯达克	zh-CN
nsic	拈酸吃醋	zh-CN
nslf	南斯拉夫	zh-CN
nsmd	泥塑木雕	zh-CN
nswh	你死我活	zh-CN
ntdg	脑体倒挂	zh-CN
ntmm	牛头马面	zh-CN
nuhd	能说会道	zh-CN
nuhx	拿手好戏	zh-CN
nujn	难上加难	zh-CN
nujx	泥沙俱下	zh-CN
nunf	难舍难分	zh-CN
nunj	蹑手蹑脚	zh-CN
nuqd	南沙群岛	zh-CN
nuqk	年少轻狂	zh-CN
nuwv	年少无知	zh-CN
nuxv	逆水行舟	zh-CN
nuyw	年少有为	zh-CN
nvbh	难者不会	zh-CN
nvbv	南征北战	zh-CN
nvbw	宁折不弯	zh-CN
nvdl	能者多劳	zh-CN
nvdm	浓妆淡抹	zh-CN
nvgv	能征惯战	zh-CN
nvqj	闹中取静	zh-CN
nvqk	扭转乾坤	zh-CN
nvuv	能征善战	zh-CN
nvvw	囊中之物	zh-CN
nvwd	你争我夺	zh-CN
nvwg	你追我赶	zh-CN
nvwv	你知我知	zh-CN
nvxs	囊中羞涩	zh-CN
nvym	浓妆艳抹	zh-CN
nwgj	内外勾结	zh-CN
nwjk	内外交困	zh-CN
nwjx	内外兼修	zh-CN
nwnw	能文能武	zh-CN
nwuw	鸟为食亡	zh-CN
nwvw	逆我者亡	zh-CN
nwys	宁为玉碎	zh-CN
nxdb	内心独白	zh-CN
nxdx	那些东西	zh-CN
nxin	恼羞成怒	zh-CN
nxnd	难兄难弟	zh-CN
nxui	内心深处	zh-CN
nxwt	哪些问题	zh-CN
nxys	怒形于色	zh-CN
nxzj	弄虚作假	zh-CN
nybh	捏一把汗	zh-CN
nybv	南辕北辙	zh-CN
nybx	奴颜婢膝	zh-CN
nycx	匿影藏形	zh-CN
nydh	那样的话	zh-CN
nydx	农业大学	zh-CN
nygg	浓烟滚滚	zh-CN
nygx	年逾古稀	zh-CN
nyhx	鸟语花香	zh-CN
nyif	弄月嘲风	zh-CN
nyin	那一刹那	zh-CN
nyjr	娘要嫁人	zh-CN
nymg	奴颜媚骨	zh-CN
nymx	讷言敏行	zh-CN
nyub	能言善辩	zh-CN
nyvx	难以置信	zh-CN
nyvy	难言之隐	zh-CN
nywh	内忧外患	zh-CN
nywj	难以为继	zh-CN
nyxx	难以想象	zh-CN
nyxy	难以下咽	zh-CN
nyyh	农业银行	zh-CN
nyyx	囊萤映雪	zh-CN
nzgl	内在规律	zh-CN
nznb	男尊女卑	zh-CN
nzny	男左女右	zh-CN
nzty	挪作他用	zh-CN
nzux	泥足深陷	zh-CN
nzzz	念兹在兹	zh-CN
odsl	藕断丝连	zh-CN
oxlx	呕心沥血	zh-CN
paeq	拍案而起	zh-CN
pajj	拍案叫绝	zh-CN
pawu	平安无事	zh-CN
payy	偏安一隅	zh-CN
pbbk	疲惫不堪	zh-CN
pbbv	排兵布阵	zh-CN
pbdn	平板电脑	zh-CN
pbdy	迫不得已	zh-CN
pbel	扑鼻而来	zh-CN
pbij	拍板成交	zh-CN
pbjd	迫不及待	zh-CN
pbjj	贫病交加	zh-CN
pblm	跑不了庙	zh-CN
pbpl	漂不漂亮	zh-CN
pbqy	平步青云	zh-CN
pbuh	蓬荜生辉	zh-CN
pbwg	平白无故	zh-CN
pbwj	朋比为奸	zh-CN
pbxu	蓬勃向上	zh-CN
pbyi	喷薄欲出	zh-CN
pcps	骗财骗色	zh-CN
pdfb	平地风波	zh-CN
pdjn	庖丁解牛	zh-CN
pdwq	平淡无奇	zh-CN
pehl	破而后立	zh-CN
pfdx	捧腹大笑	zh-CN
pffh	贫富分化	zh-CN
pfhu	蚍蜉撼树	zh-CN
pfij	贫富差距	zh-CN
pfiv	破釜沉舟	zh-CN
pfmj	泼妇骂街	zh-CN
pfqs	平分秋色	zh-CN
pfvv	颇费周折	zh-CN
pfvx	平反昭雪	zh-CN
pfvy	匹夫之勇	zh-CN
pfwz	匹夫无罪	zh-CN
pfyh	浦发银行	zh-CN
pgcj	盘根错节	zh-CN
pgnl	屁滚尿流	zh-CN
pgpu	破罐破摔	zh-CN
pgvq	旁观者清	zh-CN
pgwd	刨根问底	zh-CN
phlt	炮火连天	zh-CN
pimx	破除迷信	zh-CN
piph	骗吃骗喝	zh-CN
piwl	鹏程万里	zh-CN
piwn	排除万难	zh-CN
pjbl	片甲不留	zh-CN
pjid	破茧成蝶	zh-CN
pjiy	破镜重圆	zh-CN
pjlx	破旧立新	zh-CN
pjsi	牝鸡司晨	zh-CN
pjtl	否极泰来	zh-CN
pjvj	披荆斩棘	zh-CN
pjvr	披坚执锐	zh-CN
pjxl	破家县令	zh-CN
pkdq	贫困地区	zh-CN
pknz	凭空捏造	zh-CN
pkrv	皮开肉绽	zh-CN
pldq	赔礼道歉	zh-CN
plff	攀龙附凤	zh-CN
plpl	噼里啪啦	zh-CN
plpq	跑来跑去	zh-CN
plyq	皮里阳秋	zh-CN
pmbm	盆满钵满	zh-CN
pmbx	平民百姓	zh-CN
pmel	扑面而来	zh-CN
pmer	破门而入	zh-CN
pmgh	跑马观花	zh-CN
pmnj	拍马难及	zh-CN
pmzd	旁门左道	zh-CN
pnql	跑哪去了	zh-CN
ppaa	平平安安	zh-CN
ppbb	蓬蓬勃勃	zh-CN
ppbu	偏旁部首	zh-CN
ppdd	平平淡淡	zh-CN
ppdy	瓢泼大雨	zh-CN
ppgg	瓶瓶罐罐	zh-CN
ppgz	翩翩公子	zh-CN
ppjj	平平静静	zh-CN
ppll	漂漂亮亮	zh-CN
ppmm	婆婆妈妈	zh-CN
ppmp	拍拍马屁	zh-CN
pppg	拍拍屁股	zh-CN
pppp	噼噼啪啪	zh-CN
ppqw	翩翩起舞	zh-CN
pptt	普普通通	zh-CN
ppun	翩翩少年	zh-CN
ppvx	平铺直叙	zh-CN
ppwq	平平无奇	zh-CN
ppyx	飘飘欲仙	zh-CN
ppzz	平平仄仄	zh-CN
pqcj	旁敲侧击	zh-CN
pqpz	平起平坐	zh-CN
prdw	庞然大物	zh-CN
prlr	判若两人	zh-CN
prvk	皮肉之苦	zh-CN
prwr	旁若无人	zh-CN
prxd	怦然心动	zh-CN
pryn	判若云泥	zh-CN
psph	拼死拼活	zh-CN
psxi	菩萨心肠	zh-CN
ptdy	滂沱大雨	zh-CN
ptei	破土而出	zh-CN
ptgd	铺天盖地	zh-CN
ptgl	劈头盖脸	zh-CN
ptgm	蓬头垢面	zh-CN
ptlm	抛头露面	zh-CN
ptlt	破铜烂铁	zh-CN
ptlz	品头论足	zh-CN
ptpx	偏听偏信	zh-CN
ptsf	披头散发	zh-CN
pttq	普天同庆	zh-CN
ptvx	普天之下	zh-CN
ptwx	破涕为笑	zh-CN
pudh	排山倒海	zh-CN
puik	拍手称快	zh-CN
pujh	拍手叫好	zh-CN
puml	扑朔迷离	zh-CN
puwh	朴实无华	zh-CN
puxf	萍水相逢	zh-CN
pvbi	破绽百出	zh-CN
pvby	旁征博引	zh-CN
pvfd	品种繁多	zh-CN
pvlf	铺张浪费	zh-CN
pvyy	抛砖引玉	zh-CN
pwyj	盼望已久	zh-CN
pxdw	爬行动物	zh-CN
pxdy	披星戴月	zh-CN
pxel	平心而论	zh-CN
pxjy	品学兼优	zh-CN
pxza	偏信则暗	zh-CN
pybm	疲于奔命	zh-CN
pygh	漂洋过海	zh-CN
pyjn	排忧解难	zh-CN
pyjr	平易近人	zh-CN
pylu	破衣烂衫	zh-CN
pyvb	平庸之辈	zh-CN
pyvy	片言只语	zh-CN
pyxi	旁逸斜出	zh-CN
pyyf	疲于应付	zh-CN
pzmj	迫在眉睫	zh-CN
qagl	乞哀告怜	zh-CN
qatm	弃暗投明	zh-CN
qbdw	穷兵黩武	zh-CN
qbgz	岂不怪哉	zh-CN
qbiu	泣不成声	zh-CN
qbjj	情比金坚	zh-CN
qbkx	岂不可惜	zh-CN
qbyn	祛病延年	zh-CN
qbzj	情不自禁	zh-CN
qcdl	强词夺理	zh-CN
qcqj	去粗取精	zh-CN
qcql	群策群力	zh-CN
qcsy	青葱岁月	zh-CN
qcye	清脆悦耳	zh-CN
qczj	遣词造句	zh-CN
qdgx	裙带关系	zh-CN
qdhi	恰到好处	zh-CN
qdhj	青灯黄卷	zh-CN
qdik	情窦初开	zh-CN
qdiv	屈打成招	zh-CN
qdjt	拳打脚踢	zh-CN
qdtg	巧夺天工	zh-CN
qdux	气定神闲	zh-CN
qdvj	请多指教	zh-CN
qdwg	千刀万剐	zh-CN
qdwv	千叮万嘱	zh-CN
qdyj	期待已久	zh-CN
qdyx	取大优先	zh-CN
qebb	千儿八百	zh-CN
qebd	求而不得	zh-CN
qebu	锲而不舍	zh-CN
qedv	取而代之	zh-CN
qelx	妻儿老小	zh-CN
qewx	千恩万谢	zh-CN
qeyj	轻而易举	zh-CN
qfbd	起伏不定	zh-CN
qfbj	千方百计	zh-CN
qfdu	棋逢对手	zh-CN
qfdy	情非得已	zh-CN
qfhj	前赴后继	zh-CN
qfhy	前俯后仰	zh-CN
qfky	凄风苦雨	zh-CN
qfly	凄风冷雨	zh-CN
qfmy	清风明月	zh-CN
qfsu	秋风送爽	zh-CN
qfsv	千夫所指	zh-CN
qfvt	切肤之痛	zh-CN
qfvy	千分之一	zh-CN
qfwv	全副武装	zh-CN
qfyu	确非易事	zh-CN
qgbb	千古不变	zh-CN
qgbq	七拱八翘	zh-CN
qghg	曲高和寡	zh-CN
qgih	气贯长虹	zh-CN
qgji	千古绝唱	zh-CN
qgjl	清规戒律	zh-CN
qgjn	强弓劲弩	zh-CN
qgjq	前功尽弃	zh-CN
qgjx	勤工俭学	zh-CN
qgmw	轻歌曼舞	zh-CN
qgqi	倾国倾城	zh-CN
qgqu	秋高气爽	zh-CN
qgvh	窃国者侯	zh-CN
qgvv	窃钩者诛	zh-CN
qgxd	旗鼓相当	zh-CN
qgxs	敲骨吸髓	zh-CN
qgyc	奇光异彩	zh-CN
qgyv	棋高一着	zh-CN
qgzc	岂敢造次	zh-CN
qhbd	清华北大	zh-CN
qhbj	青黄不接	zh-CN
qhbs	七荤八素	zh-CN
qhbu	欺行霸市	zh-CN
qhbv	千回百转	zh-CN
qhdx	清华大学	zh-CN
qhhy	前呼后拥	zh-CN
qhkj	奇货可居	zh-CN
qhlb	权衡利弊	zh-CN
qhnx	骑虎难下	zh-CN
qhsv	秋后算账	zh-CN
qhwf	秋毫无犯	zh-CN
qhwh	千呼万唤	zh-CN
qhyc	奇花异草	zh-CN
qhyk	情何以堪	zh-CN
qhyp	漆黑一片	zh-CN
qhyt	漆黑一团	zh-CN
qhzb	青红皂白	zh-CN
qhzy	前后左右	zh-CN
qibl	千锤百炼	zh-CN
qidr	奇耻大辱	zh-CN
qiei	倾巢而出	zh-CN
qiid	倾巢出动	zh-CN
qijc	轻车简从	zh-CN
qijv	浅尝即止	zh-CN
qinu	青春年少	zh-CN
qisj	前程似锦	zh-CN
qith	切齿痛恨	zh-CN
qiul	轻车熟路	zh-CN
qivh	起承转合	zh-CN
qivj	前车之鉴	zh-CN
qivv	浅尝辄止	zh-CN
qiwu	前尘往事	zh-CN
qixh	气冲霄汉	zh-CN
qiyd	前程远大	zh-CN
qiyl	青出于蓝	zh-CN
qjb	千娇百媚	zh-CN
qjbh	气急败坏	zh-CN
qjbm	奇经八脉	zh-CN
qjbx	趋吉避凶	zh-CN
qjdi	倾家荡产	zh-CN
qjdl	缺斤短两	zh-CN
qjfm	全军覆没	zh-CN
qjhg	前倨后恭	zh-CN
qjjr	情景交融	zh-CN
qjjy	勤俭节约	zh-CN
qjlu	轻解罗裳	zh-CN
qjlx	勤加练习	zh-CN
qjmx	千金买笑	zh-CN
qjmy	强奸民意	zh-CN
qjnq	千金难求	zh-CN
qjrf	其疾如风	zh-CN
qjrw	请君入瓮	zh-CN
qjty	曲径通幽	zh-CN
qjuw	气绝身亡	zh-CN
qjvf	千钧重负	zh-CN
qjvg	齐家治国	zh-CN
qjvh	秦晋之好	zh-CN
qjvu	情急智生	zh-CN
qjvx	情急之下	zh-CN
qjvz	欺君之罪	zh-CN
qjwd	轻举妄动	zh-CN
qjwh	千家万户	zh-CN
qjwl	穷极无聊	zh-CN
qjwm	千军万马	zh-CN
qjwu	欺君罔上	zh-CN
qjwv	迄今为止	zh-CN
qjww	清静无为	zh-CN
qjxj	千金小姐	zh-CN
qjyf	千钧一发	zh-CN
qjyn	千金一诺	zh-CN
qjyq	奇技淫巧	zh-CN
qjyr	强加于人	zh-CN
qjyy	琼浆玉液	zh-CN
qkwl	晴空万里	zh-CN
qkwv	穷寇勿追	zh-CN
qlbg	曲里八拐	zh-CN
qlbh	趋利避害	zh-CN
qlbl	七零八落	zh-CN
qlbu	七老八十	zh-CN
qldg	敲锣打鼓	zh-CN
qldj	其利断金	zh-CN
qldy	枪林弹雨	zh-CN
qlgl	奇了怪了	zh-CN
qlgw	曲里拐弯	zh-CN
qlig	秦楼楚馆	zh-CN
qlmh	清理门户	zh-CN
qlqw	亲力亲为	zh-CN
qlrr	其乐融融	zh-CN
qlts	清丽脱俗	zh-CN
qltt	千里迢迢	zh-CN
qlvd	千里之堤	zh-CN
qlvv	情理之中	zh-CN
qlvx	千里之行	zh-CN
qlwq	其乐无穷	zh-CN
qlwu	群龙无首	zh-CN
qlwy	歧路亡羊	zh-CN
qlyf	全力以赴	zh-CN
qlyy	琼楼玉宇	zh-CN
qlzs	妻离子散	zh-CN
qmby	其貌不扬	zh-CN
qmdx	轻描淡写	zh-CN
qmlw	群魔乱舞	zh-CN
qmvl	犬马之劳	zh-CN
qmvm	青梅竹马	zh-CN
qmzh	阡陌纵横	zh-CN
qnbv	勤能补拙	zh-CN
qncj	青年才俊	zh-CN
qngx	轻诺寡信	zh-CN
qnvm	强弩之末	zh-CN
qnvy	七年之痒	zh-CN
qnwx	千难万险	zh-CN
qnxu	倾囊相授	zh-CN
qnyr	迁怒于人	zh-CN
qnzj	情难自禁	zh-CN
qpbc	七拼八凑	zh-CN
qpbw	七平八稳	zh-CN
qpdy	倾盆大雨	zh-CN
qpfd	全盘否定	zh-CN
qphj	前仆后继	zh-CN
qphy	亲朋好友	zh-CN
qpqm	枪炮齐鸣	zh-CN
qpyl	千篇一律	zh-CN
qqaa	期期艾艾	zh-CN
qqbb	七七八八	zh-CN
qqbg	千奇百怪	zh-CN
qqcc	凄凄惨惨	zh-CN
qqdb	全权代表	zh-CN
qqdd	敲敲打打	zh-CN
qqdy	千秋大业	zh-CN
qqfh	牵强附会	zh-CN
qqgg	奇奇怪怪	zh-CN
qqhd	巧取豪夺	zh-CN
qqhh	前前后后	zh-CN
qqii	清清楚楚	zh-CN
qqiq	妻妾成群	zh-CN
qqiy	权倾朝野	zh-CN
qqjl	茕茕孑立	zh-CN
qqjy	权钱交易	zh-CN
qqjz	谦谦君子	zh-CN
qqkk	勤勤恳恳	zh-CN
qqlh	强强联合	zh-CN
qqll	起起落落	zh-CN
qqlu	强强联手	zh-CN
qqly	七情六欲	zh-CN
qqpy	亲戚朋友	zh-CN
qqss	轻轻松松	zh-CN
qqsy	窃窃私语	zh-CN
qqtr	全情投入	zh-CN
qquh	琴棋书画	zh-CN
qquu	确确实实	zh-CN
qquy	七窍生烟	zh-CN
qquz	娶妻生子	zh-CN
qqvv	曲曲折折	zh-CN
qqvx	乔迁之喜	zh-CN
qqwd	千秋万代	zh-CN
qqww	千千万万	zh-CN
qqxf	恰恰相反	zh-CN
qqxu	区区小事	zh-CN
qqzb	求全责备	zh-CN
qrbl	弃若敝履	zh-CN
qrpy	欺软怕硬	zh-CN
qrqf	恰如其分	zh-CN
qrsn	强人所难	zh-CN
qrtu	欺人太甚	zh-CN
qrvf	齐人之福	zh-CN
qrxp	沁人心脾	zh-CN
qrym	千人一面	zh-CN
qrys	气若游丝	zh-CN
qryt	杞人忧天	zh-CN
qsbh	七死八活	zh-CN
qshu	起死回生	zh-CN
qshx	前思后想	zh-CN
qsmx	奇思妙想	zh-CN
qsna	寝食难安	zh-CN
qspp	琴瑟琵琶	zh-CN
qsuq	情随事迁	zh-CN
qswl	千丝万缕	zh-CN
qsww	前所未闻	zh-CN
qswy	前所未有	zh-CN
qsyk	轻松愉快	zh-CN
qszr	轻松自如	zh-CN
qtbr	青天白日	zh-CN
qtcy	求同存异	zh-CN
qtdu	蜻蜓点水	zh-CN
qtgl	奇谈怪论	zh-CN
qtgr	情同骨肉	zh-CN
qtgu	清汤寡水	zh-CN
qtik	亲痛仇快	zh-CN
qtjm	情同姐妹	zh-CN
qtkj	囚徒困境	zh-CN
qtml	穷途末路	zh-CN
qtpl	晴天霹雳	zh-CN
qtqw	掐头去尾	zh-CN
qtuh	气吞山河	zh-CN
qtuz	情同手足	zh-CN
qtwb	前途未卜	zh-CN
qtwl	前途无量	zh-CN
qtwx	千头万绪	zh-CN
quba	寝食不安	zh-CN
qubf	求神拜佛	zh-CN
qubr	禽兽不如	zh-CN
qubw	前事不忘	zh-CN
qubx	七上八下	zh-CN
qudm	欺世盗名	zh-CN
quem	螓首蛾眉	zh-CN
quet	全身而退	zh-CN
queu	穷山恶水	zh-CN
qugm	囚首垢面	zh-CN
qugr	亲生骨肉	zh-CN
qugv	全神贯注	zh-CN
qugx	七十古稀	zh-CN
quhh	气势恢宏	zh-CN
qujl	亲身经历	zh-CN
qujy	穷奢极欲	zh-CN
qukx	切实可行	zh-CN
qulm	青史留名	zh-CN
quly	切身利益	zh-CN
qumx	欺上瞒下	zh-CN
qunf	其实难副	zh-CN
qupb	气势磅礴	zh-CN
qupe	欺善怕恶	zh-CN
quqj	轻手轻脚	zh-CN
quqq	怯声怯气	zh-CN
qurh	巧舌如簧	zh-CN
qush	情深似海	zh-CN
qusx	欺霜赛雪	zh-CN
quth	切身体会	zh-CN
quuq	全胜时期	zh-CN
quwb	求神问卜	zh-CN
quwu	千山万水	zh-CN
quwx	欺上罔下	zh-CN
quxy	轻声细语	zh-CN
quyd	翘首以待	zh-CN
quym	清水衙门	zh-CN
quyp	翘首以盼	zh-CN
quyq	情深缘浅	zh-CN
qvbd	求之不得	zh-CN
qvbg	却之不恭	zh-CN
qvbj	取之不尽	zh-CN
qvbk	七折八扣	zh-CN
qvbu	穷追不舍	zh-CN
qvdb	乔装打扮	zh-CN
qvdi	浅斟低唱	zh-CN
qvdv	轻重倒置	zh-CN
qvdy	枪支弹药	zh-CN
qvgg	齐抓共管	zh-CN
qvhj	轻重缓急	zh-CN
qvhq	欠债还钱	zh-CN
qvjc	轻装简从	zh-CN
qvku	屈指可数	zh-CN
qvkx	弃之可惜	zh-CN
qvlj	清正廉洁	zh-CN
qvls	敲诈勒索	zh-CN
qvmd	穷追猛打	zh-CN
qvnu	罄竹难书	zh-CN
qvrs	曲终人散	zh-CN
qvrw	趋之若鹜	zh-CN
qvub	切中时弊	zh-CN
qvuh	气壮山河	zh-CN
qvuj	起止时间	zh-CN
qvuv	轻装上阵	zh-CN
qvvy	其中之一	zh-CN
qvwq	千真万确	zh-CN
qvyb	奇珍异宝	zh-CN
qvyd	取之有道	zh-CN
qvyf	奇装异服	zh-CN
qvyg	其中一个	zh-CN
qvyh	切中要害	zh-CN
qvym	取之于民	zh-CN
qvyq	情真意切	zh-CN
qvys	掐指一算	zh-CN
qvzq	清者自清	zh-CN
qwcj	去芜存菁	zh-CN
qwcv	去伪存真	zh-CN
qwgr	前无古人	zh-CN
qwgu	奇文共赏	zh-CN
qwui	全无是处	zh-CN
qwux	悄无声息	zh-CN
qwwq	其味无穷	zh-CN
qwxg	全无心肝	zh-CN
qwxt	趣味相投	zh-CN
qwyu	趣闻轶事	zh-CN
qxdq	牵线搭桥	zh-CN
qxgv	奇形怪状	zh-CN
qxgy	清心寡欲	zh-CN
qxhl	齐心合力	zh-CN
qxje	穷凶极恶	zh-CN
qxju	谦虚谨慎	zh-CN
qxjz	抢险救灾	zh-CN
qxkl	勤学苦练	zh-CN
qxpr	穷乡僻壤	zh-CN
qxqy	全心全意	zh-CN
qxrk	求贤若渴	zh-CN
qxrl	其臭如兰	zh-CN
qxts	清新脱俗	zh-CN
qxuu	全校师生	zh-CN
qxvi	裙下之臣	zh-CN
qxvy	潜心专研	zh-CN
qxwk	千辛万苦	zh-CN
qxwq	气象万千	zh-CN
qxwy	确信无疑	zh-CN
qxxl	齐心协力	zh-CN
qxyd	浅显易懂	zh-CN
qxym	取信于民	zh-CN
qxyv	泉下有知	zh-CN
qybf	轻徭薄赋	zh-CN
qybk	缺一不可	zh-CN
qybu	千依百顺	zh-CN
qycc	去也匆匆	zh-CN
qycl	岂有此理	zh-CN
qydv	情有独钟	zh-CN
qydw	企业单位	zh-CN
qyfq	轻言放弃	zh-CN
qyfu	趋炎附势	zh-CN
qyfy	曲意逢迎	zh-CN
qygl	企业管理	zh-CN
qyhg	前因后果	zh-CN
qyhh	前仰后合	zh-CN
qyhm	轻于鸿毛	zh-CN
qyhx	强颜欢笑	zh-CN
qyjc	犬牙交错	zh-CN
qyky	情有可原	zh-CN
qyls	巧言令色	zh-CN
qymh	潜移默化	zh-CN
qyqu	确有其事	zh-CN
qyrh	巧言如簧	zh-CN
qytx	窃玉偷香	zh-CN
qyul	潜意识里	zh-CN
qyvj	权宜之计	zh-CN
qyvz	前一阵子	zh-CN
qywh	企业文化	zh-CN
qywy	千言万语	zh-CN
qyxa	器宇轩昂	zh-CN
qyxj	青眼相加	zh-CN
qyxt	气焰熏天	zh-CN
qyyf	穷于应付	zh-CN
qyyj	青眼有加	zh-CN
qyyu	其言也善	zh-CN
qzbt	千姿百态	zh-CN
qzbu	七嘴八舌	zh-CN
qzgy	青藏高原	zh-CN
qzim	亲自出马	zh-CN
qzmh	起早摸黑	zh-CN
qznf	千载难逢	zh-CN
qzsb	穷则思变	zh-CN
qzth	起早贪黑	zh-CN
qzwy	确凿无疑	zh-CN
rbdg	肉包打狗	zh-CN
rbfi	入不敷出	zh-CN
rbjf	弱不禁风	zh-CN
rbkd	锐不可当	zh-CN
rbuv	如臂使指	zh-CN
rbwj	人不为己	zh-CN
rbxu	日薄西山	zh-CN
rcbi	人才辈出	zh-CN
rcey	如此而已	zh-CN
rcjj	人才济济	zh-CN
rckl	如此看来	zh-CN
rclk	人财两空	zh-CN
rcul	如此说来	zh-CN
rcvb	如此这般	zh-CN
rcvd	如此之多	zh-CN
rcvj	冗词赘句	zh-CN
rcxz	如此下作	zh-CN
rcyl	如此一来	zh-CN
rddb	人大代表	zh-CN
rddu	人多地少	zh-CN
rdem	任督二脉	zh-CN
rdut	人定胜天	zh-CN
rduu	人地生疏	zh-CN
rduv	人多势众	zh-CN
rdvy	人道主义	zh-CN
rdwm	入地无门	zh-CN
rdyl	热带雨林	zh-CN
rdzz	人多嘴杂	zh-CN
rfcm	人非草木	zh-CN
rfpv	如法炮制	zh-CN
rfux	人非圣贤	zh-CN
rfyu	人浮于事	zh-CN
rggl	荣归故里	zh-CN
rghf	容光焕发	zh-CN
rghx	人工呼吸	zh-CN
rglm	人过留名	zh-CN
rgmd	人高马大	zh-CN
rgsq	如隔三秋	zh-CN
rgvn	人工智能	zh-CN
rgyv	人各有志	zh-CN
rgzh	如鲠在喉	zh-CN
rhfg	荣华富贵	zh-CN
rhgt	融会贯通	zh-CN
rhit	热火朝天	zh-CN
rhm	人欢马叫	zh-CN
rhmj	如花美眷	zh-CN
rhmm	人海茫茫	zh-CN
rhrt	如火如荼	zh-CN
rhsy	如花似玉	zh-CN
rhty	如虎添翼	zh-CN
rhuh	如何是好	zh-CN
rhuu	惹火烧身	zh-CN
rhvb	如获至宝	zh-CN
rhvu	人海战术	zh-CN
rirz	如痴如醉	zh-CN
riuh	日常生活	zh-CN
riwh	人畜无害	zh-CN
riyv	如出一辙	zh-CN
rjae	忍饥挨饿	zh-CN
rjbh	如假包换	zh-CN
rjbj	忍俊不禁	zh-CN
rjdj	日进斗金	zh-CN
rjdl	人杰地灵	zh-CN
rjdy	人间地狱	zh-CN
rjfp	人间凡品	zh-CN
rjgx	人际关系	zh-CN
rjhv	人迹罕至	zh-CN
rjjv	人尽皆知	zh-CN
rjqc	人尽其才	zh-CN
rjqr	如见其人	zh-CN
rjra	人见人爱	zh-CN
rjrl	若即若离	zh-CN
rjsk	如饥似渴	zh-CN
rjsq	如胶似漆	zh-CN
rjti	日久天长	zh-CN
rjuq	日久生情	zh-CN
rjvu	人急智生	zh-CN
rjws	入境问俗	zh-CN
rjyh	人间烟火	zh-CN
rjyl	日积月累	zh-CN
rjyv	人皆有之	zh-CN
rkmf	人困马乏	zh-CN
rlbb	如履薄冰	zh-CN
rldd	如临大敌	zh-CN
rlge	如雷贯耳	zh-CN
rlhy	热烈欢迎	zh-CN
rlpd	如履平地	zh-CN
rlrw	人来人往	zh-CN
rlry	任劳任怨	zh-CN
rlsh	如狼似虎	zh-CN
rlsr	绕梁三日	zh-CN
rlut	扰乱视听	zh-CN
rluy	如临深渊	zh-CN
rlvh	人老珠黄	zh-CN
rlwj	日理万机	zh-CN
rlwl	人力物力	zh-CN
rlwm	人类文明	zh-CN
rlxj	人类学家	zh-CN
rlxu	日落西山	zh-CN
rlyk	热泪盈眶	zh-CN
rmdx	人民大学	zh-CN
rmfx	如梦方醒	zh-CN
rmgt	人命关天	zh-CN
rmgx	人脉关系	zh-CN
rmgy	人模狗样	zh-CN
rmif	如沐春风	zh-CN
rmix	如梦初醒	zh-CN
rmra	若明若暗	zh-CN
rmsf	入木三分	zh-CN
rmth	人面桃花	zh-CN
rmtq	日暮途穷	zh-CN
rmux	人面兽心	zh-CN
rmvb	入幕之宾	zh-CN
rmvf	人民政府	zh-CN
rmvj	燃眉之急	zh-CN
rmwh	人满为患	zh-CN
rmyd	人莫予毒	zh-CN
rmyh	人民银行	zh-CN
rmyp	软磨硬泡	zh-CN
rmyu	戎马一生	zh-CN
rmyx	茹毛饮血	zh-CN
rmzb	如芒在背	zh-CN
rnsy	如你所愿	zh-CN
rnus	如鸟兽散	zh-CN
rnxs	阮囊羞涩	zh-CN
rqev	如期而至	zh-CN
rqlk	人去楼空	zh-CN
rqln	人情冷暖	zh-CN
rqmy	柔情蜜意	zh-CN
rqrh	人前人后	zh-CN
rqrl	入情入理	zh-CN
rqrs	如泣如诉	zh-CN
rqsu	柔情似水	zh-CN
rqtt	热气腾腾	zh-CN
rqtu	忍气吞声	zh-CN
rqug	人情世故	zh-CN
rqvd	人穷志短	zh-CN
rqwq	人弃我取	zh-CN
rqyj	日清月结	zh-CN
rqyy	热情洋溢	zh-CN
rqzr	任其自然	zh-CN
rrfu	如日方升	zh-CN
rrfv	忍辱负重	zh-CN
rrfw	人若犯我	zh-CN
rrhd	人人喊打	zh-CN
rrhh	热热乎乎	zh-CN
rrjv	人人皆知	zh-CN
rrnn	热热闹闹	zh-CN
rrpd	人人平等	zh-CN
rrq	扰人清梦	zh-CN
rrqm	人如其名	zh-CN
rrqu	弱肉强食	zh-CN
rrtu	忍辱偷生	zh-CN
rruq	冉冉升起	zh-CN
rrvt	如日中天	zh-CN
rrvu	仁人志士	zh-CN
rrvv	认认真真	zh-CN
rrwl	软弱无力	zh-CN
rrwq	任人唯亲	zh-CN
rrwx	任人唯贤	zh-CN
rryg	荣辱与共	zh-CN
rryy	日日夜夜	zh-CN
rryz	人人有责	zh-CN
rrzg	任人宰割	zh-CN
rrzw	人人自危	zh-CN
rsgv	人所共知	zh-CN
rskb	如丧考妣	zh-CN
rsyx	日思夜想	zh-CN
rtcx	人同此心	zh-CN
rtga	忍痛割爱	zh-CN
rtsu	如图所示	zh-CN
rucg	入室操戈	zh-CN
rudf	人声鼎沸	zh-CN
rugf	人神共愤	zh-CN
rugj	人身攻击	zh-CN
rujh	人生几何	zh-CN
rujv	如数家珍	zh-CN
ruqt	弱势群体	zh-CN
rurh	人山人海	zh-CN
rurm	人生如梦	zh-CN
rurq	人生如棋	zh-CN
rusg	日上三竿	zh-CN
rusu	如上所述	zh-CN
ruuf	惹是生非	zh-CN
ruvf	如释重负	zh-CN
ruwg	人谁无过	zh-CN
ruyl	日晒雨淋	zh-CN
ruyv	人是衣妆	zh-CN
ruzu	人生在世	zh-CN
rvcq	任重才轻	zh-CN
rvdg	柔中带刚	zh-CN
rvdy	任重道远	zh-CN
rviq	人之常情	zh-CN
rvjr	仁者见仁	zh-CN
rvjs	人之将死	zh-CN
rvls	热胀冷缩	zh-CN
rvvl	人中之龙	zh-CN
rvwm	日臻完美	zh-CN
rvwu	日臻完善	zh-CN
rvyj	仁至义尽	zh-CN
rvyu	仁者乐山	zh-CN
rwcs	人为财死	zh-CN
rwdl	人文地理	zh-CN
rwkr	忍无可忍	zh-CN
rwqu	若无其事	zh-CN
rwrl	人五人六	zh-CN
rwwr	人无完人	zh-CN
rwyq	人微言轻	zh-CN
rwyr	人外有人	zh-CN
rwyt	融为一体	zh-CN
rxbg	人心不古	zh-CN
rxft	热血沸腾	zh-CN
rxgd	人小鬼大	zh-CN
rxhd	人行横道	zh-CN
rxhh	人心惶惶	zh-CN
rxnc	人心难测	zh-CN
rxql	日行千里	zh-CN
rxrg	柔心弱骨	zh-CN
rxru	仁心仁术	zh-CN
rxss	入乡随俗	zh-CN
rxsx	人心所向	zh-CN
rxun	任贤使能	zh-CN
rxwg	乳臭未干	zh-CN
rxxb	人心向背	zh-CN
rxyy	日新月异	zh-CN
rycl	日夜操劳	zh-CN
ryct	日月蹉跎	zh-CN
rydd	仁义道德	zh-CN
rydu	如鱼得水	zh-CN
ryev	如约而至	zh-CN
ryfq	饶有风趣	zh-CN
ryft	肉眼凡胎	zh-CN
rygh	日月光华	zh-CN
ryhl	人欲横流	zh-CN
ryji	日夜兼程	zh-CN
ryjq	锐意进取	zh-CN
ryju	软硬兼施	zh-CN
ryjx	如意吉祥	zh-CN
ryjy	日以继夜	zh-CN
rykw	人言可畏	zh-CN
rymf	人仰马翻	zh-CN
ryqf	人以群分	zh-CN
ryrs	日月如梭	zh-CN
ryrw	若有若无	zh-CN
ryrx	若隐若现	zh-CN
rysj	人有三急	zh-CN
rysp	如意算盘	zh-CN
ryss	若有所思	zh-CN
rysu	若有所失	zh-CN
rysx	如影随形	zh-CN
ryti	日益突出	zh-CN
ryvi	如蝇逐臭	zh-CN
rywu	如烟往事	zh-CN
rywx	软玉温香	zh-CN
ryxi	日月星辰	zh-CN
ryxq	饶有兴趣	zh-CN
ryxu	人烟稀少	zh-CN
ryxv	饶有兴致	zh-CN
ryyi	如愿以偿	zh-CN
ryyv	日益严重	zh-CN
ryyy	人云亦云	zh-CN
rzdm	人走灯灭	zh-CN
rzgz	认祖归宗	zh-CN
rzif	如坐春风	zh-CN
rzil	人走茶凉	zh-CN
rzjh	人赃俱获	zh-CN
rzkj	孺子可教	zh-CN
rzvv	如坐针毡	zh-CN
rzyz	荣宗耀祖	zh-CN
rzzf	认贼作父	zh-CN
sbdk	斯巴达克	zh-CN
sbdy	随波荡漾	zh-CN
sbhg	死不悔改	zh-CN
sbkn	俗不可耐	zh-CN
sbmm	死不瞑目	zh-CN
sbvj	损兵折将	zh-CN
sbvl	随波逐流	zh-CN
sbxu	素不相识	zh-CN
sbyk	色不异空	zh-CN
sbyr	虽败犹荣	zh-CN
sbyy	散兵游勇	zh-CN
sbzx	死不足惜	zh-CN
scbl	色彩斑斓	zh-CN
scjl	三寸金莲	zh-CN
scsd	三从四德	zh-CN
scvu	三寸之舌	zh-CN
scxu	似曾相识	zh-CN
sdbt	色胆包天	zh-CN
sdfd	似懂非懂	zh-CN
sdfm	四大发明	zh-CN
sdim	扫地出门	zh-CN
sdjk	四大皆空	zh-CN
sdlt	死到临头	zh-CN
sdmv	四大名著	zh-CN
sdqs	死得其所	zh-CN
sduj	锁定胜局	zh-CN
sdvu	僧多粥少	zh-CN
sdyi	搔到痒处	zh-CN
sefu	死而复生	zh-CN
sehy	死而后已	zh-CN
sewd	萨尔瓦多	zh-CN
sewh	死而无憾	zh-CN
sewy	塞尔维亚	zh-CN
sfeq	随风而去	zh-CN
sfeu	随风而逝	zh-CN
sfsc	三番四次	zh-CN
sfvd	随风转舵	zh-CN
sfve	三分之二	zh-CN
sfvy	三分之一	zh-CN
sfwc	三番五次	zh-CN
sfwl	四分五裂	zh-CN
sgby	三更半夜	zh-CN
sgdl	三国鼎立	zh-CN
sgdv	三个多钟	zh-CN
sgdy	三个多月	zh-CN
sgfs	损公肥私	zh-CN
sgld	苏格拉底	zh-CN
sglp	三姑六婆	zh-CN
sgml	三顾茅庐	zh-CN
sgvt	三个钟头	zh-CN
sgwi	三纲五常	zh-CN
sgxq	三个星期	zh-CN
sgxu	三个小时	zh-CN
sgyy	三国演义	zh-CN
shbx	死活不信	zh-CN
shfr	死灰复燃	zh-CN
shju	随行就市	zh-CN
shqp	三魂七魄	zh-CN
shsy	岁寒三友	zh-CN
shuh	索贿受贿	zh-CN
shup	四海升平	zh-CN
shwd	三皇五帝	zh-CN
shwj	四海为家	zh-CN
shws	三呼万岁	zh-CN
shyj	四海一家	zh-CN
sidx	四川大学	zh-CN
sigd	搜肠刮肚	zh-CN
sikj	随处可见	zh-CN
sild	三长两短	zh-CN
siqf	思潮起伏	zh-CN
sivl	丝绸之路	zh-CN
sjit	四脚朝天	zh-CN
sjjl	三教九流	zh-CN
sjlt	所见略同	zh-CN
sjqa	三聚氰胺	zh-CN
sjqk	三缄其口	zh-CN
sjri	四季如春	zh-CN
sjsb	耸肩缩背	zh-CN
sjsd	随叫随到	zh-CN
sjsw	所见所闻	zh-CN
sjtl	丧尽天良	zh-CN
sjvq	丧家之犬	zh-CN
sjyb	随机应变	zh-CN
sjyx	送旧迎新	zh-CN
skjg	司空见惯	zh-CN
skyu	随口一说	zh-CN
slbj	酸了吧唧	zh-CN
slfk	斯洛伐克	zh-CN
sljd	三六九等	zh-CN
slkq	松了口气	zh-CN
slla	塞拉利昂	zh-CN
sllk	斯里兰卡	zh-CN
slnr	色厉内荏	zh-CN
slqd	四轮驱动	zh-CN
slqu	死里求生	zh-CN
slsj	耸了耸肩	zh-CN
sltu	死里逃生	zh-CN
slwu	三令五申	zh-CN
slxq	思来想去	zh-CN
slyt	死路一条	zh-CN
smbf	四面八方	zh-CN
smig	四面楚歌	zh-CN
smjt	四目交投	zh-CN
smni	岁末年初	zh-CN
smnv	驷马难追	zh-CN
smpu	素昧平生	zh-CN
smxd	四目相对	zh-CN
snje	塞内加尔	zh-CN
spbw	四平八稳	zh-CN
spll	死皮赖脸	zh-CN
splp	撕破脸皮	zh-CN
spls	塞浦路斯	zh-CN
sqbl	死乞白赖	zh-CN
sqdh	俗气得很	zh-CN
sqhl	死去活来	zh-CN
sqii	死气沉沉	zh-CN
sqrg	丧权辱国	zh-CN
sqsq	三妻四妾	zh-CN
sqxh	思前想后	zh-CN
srih	三人成虎	zh-CN
srlj	损人利己	zh-CN
srqj	肃然起敬	zh-CN
srqy	思如泉涌	zh-CN
srsh	色若死灰	zh-CN
srtw	耸人听闻	zh-CN
ssbb	随随便便	zh-CN
ssbt	四散奔逃	zh-CN
ssex	三思而行	zh-CN
ssfd	瑟瑟发抖	zh-CN
ssff	四四方方	zh-CN
sskk	松松垮垮	zh-CN
ssll	三三两两	zh-CN
ssnn	岁岁年年	zh-CN
ssrk	丝丝入扣	zh-CN
sssx	所思所想	zh-CN
ssxh	三岁小孩	zh-CN
ssyq	搜索引擎	zh-CN
ssyu	虽死犹生	zh-CN
stbd	四通八达	zh-CN
stbq	四体不勤	zh-CN
stdy	三天打鱼	zh-CN
stkl	酸甜苦辣	zh-CN
stlb	三头六臂	zh-CN
stlt	三天两头	zh-CN
stsn	缩头缩脑	zh-CN
subg	撒手不管	zh-CN
subh	四十不惑	zh-CN
subj	四时八节	zh-CN
suef	似是而非	zh-CN
suel	三十而立	zh-CN
sueq	撒手而去	zh-CN
sufh	随声附和	zh-CN
sulj	三十六计	zh-CN
suml	送上门来	zh-CN
sunh	似水年华	zh-CN
sunl	随手拈来	zh-CN
sunz	搔首弄姿	zh-CN
surh	撒手人寰	zh-CN
surq	似水柔情	zh-CN
susd	随时随地	zh-CN
susj	缩手缩脚	zh-CN
sutt	四世同堂	zh-CN
suw	四书五经	zh-CN
suwd	碎尸万段	zh-CN
suwj	所剩无几	zh-CN
suwl	死水微澜	zh-CN
suwr	四舍五入	zh-CN
suyx	三生有幸	zh-CN
svbh	四肢百骸	zh-CN
svel	随之而来	zh-CN
svgx	丝竹管弦	zh-CN
svjl	三贞九烈	zh-CN
svqu	三战全胜	zh-CN
svsj	速战速决	zh-CN
svwl	四肢无力	zh-CN
swdv	死无对证	zh-CN
swiq	三五成群	zh-CN
swjd	肆无忌惮	zh-CN
swqu	死无全尸	zh-CN
swsd	斯文扫地	zh-CN
swul	斯威士兰	zh-CN
swum	塞翁失马	zh-CN
swyc	算无遗策	zh-CN
swyl	送往迎来	zh-CN
swyt	三位一体	zh-CN
sxbg	死性不改	zh-CN
sxbk	丧心病狂	zh-CN
sxey	三心二意	zh-CN
sxfx	似笑非笑	zh-CN
sxjj	思想境界	zh-CN
sxlf	撕心裂肺	zh-CN
sxpm	所向披靡	zh-CN
sxrk	思贤如渴	zh-CN
sxsy	随心所欲	zh-CN
sxtd	死心塌地	zh-CN
sxuu	私相授受	zh-CN
sxwd	所向无敌	zh-CN
sxwq	思绪万千	zh-CN
sxym	夙兴夜寐	zh-CN
sxzn	私心杂念	zh-CN
syal	死于安乐	zh-CN
syea	随遇而安	zh-CN
syfm	死于非命	zh-CN
syju	所言极是	zh-CN
syly	三言两语	zh-CN
symz	死要面子	zh-CN
syqy	私营企业	zh-CN
syrr	岁月荏苒	zh-CN
syrs	岁月如梭	zh-CN
syun	所以说呢	zh-CN
syww	肆意妄为	zh-CN
syyg	死有余辜	zh-CN
szbf	孙子兵法	zh-CN
szdl	三足鼎立	zh-CN
szsw	所作所为	zh-CN
tabp	凸凹不平	zh-CN
tbck	坦白从宽	zh-CN
tbcr	投笔从戎	zh-CN
tbdi	螳臂当车	zh-CN
tbdj	坦白地讲	zh-CN
tbdl	天崩地裂	zh-CN
tbdu	太不懂事	zh-CN
tbdz	填饱肚子	zh-CN
tbjj	太不讲究	zh-CN
tbjq	听不进去	zh-CN
tbjy	头把交椅	zh-CN
tbjz	添兵减灶	zh-CN
tbku	脱不开身	zh-CN
tblj	挑拨离间	zh-CN
tbqi	听不清楚	zh-CN
tbsu	退避三舍	zh-CN
tbsy	推本溯源	zh-CN
tbtj	天兵天将	zh-CN
tbtt	头版头条	zh-CN
tbvi	恬不知耻	zh-CN
tbvl	推波助澜	zh-CN
tbwj	土崩瓦解	zh-CN
tbwz	提笔忘字	zh-CN
tbxd	同胞兄弟	zh-CN
tbxh	太不像话	zh-CN
tbxl	同病相怜	zh-CN
tbxx	太不小心	zh-CN
tbyk	铁板一块	zh-CN
tbyu	痛不欲生	zh-CN
tbzm	天不作美	zh-CN
tcdb	天材地宝	zh-CN
tchm	图财害命	zh-CN
tcry	天从人愿	zh-CN
tdil	推倒重来	zh-CN
tdiq	天道酬勤	zh-CN
tdlp	天打雷劈	zh-CN
tdlx	天地良心	zh-CN
tdqu	舔犊情深	zh-CN
tdst	痛定思痛	zh-CN
tdul	荼毒生灵	zh-CN
tdwy	贪得无厌	zh-CN
tdyc	天妒英才	zh-CN
tdyv	挑灯夜战	zh-CN
tdzk	添丁增口	zh-CN
tebw	听而不闻	zh-CN
teby	痛而不言	zh-CN
tegv	推而广之	zh-CN
tehv	堂而皇之	zh-CN
tejw	退而结网	zh-CN
tezx	铤而走险	zh-CN
tfbx	通风报信	zh-CN
tfdf	天翻地覆	zh-CN
tfju	挑肥拣瘦	zh-CN
tflx	条分缕析	zh-CN
tfmj	突飞猛进	zh-CN
tfqx	突发奇想	zh-CN
tfvg	天府之国	zh-CN
tfyb	天赋异禀	zh-CN
tfym	同父异母	zh-CN
tfyt	天方夜谭	zh-CN
tgdd	天公地道	zh-CN
tgdh	天高地厚	zh-CN
tgdv	天干地支	zh-CN
tgdy	天高地远	zh-CN
tgfl	太过分了	zh-CN
tggk	同甘共苦	zh-CN
tghk	天高海阔	zh-CN
tghl	退耕还林	zh-CN
tgjl	偷工减料	zh-CN
tglj	谈古论今	zh-CN
tgnx	吐故纳新	zh-CN
tgqf	痛改前非	zh-CN
tgti	同工同酬	zh-CN
tgwl	贪官污吏	zh-CN
tgyf	天各一方	zh-CN
tgyh	韬光养晦	zh-CN
tgyj	同归于尽	zh-CN
thbv	蜕化变质	zh-CN
thda	天昏地暗	zh-CN
thdl	天荒地老	zh-CN
thgd	醍醐灌顶	zh-CN
thgn	偷换概念	zh-CN
thlj	谈婚论嫁	zh-CN
thll	桃红柳绿	zh-CN
thlu	土豪劣绅	zh-CN
thlv	天花乱坠	zh-CN
thnh	徒呼奈何	zh-CN
thnv	头昏脑涨	zh-CN
thpv	通货膨胀	zh-CN
thry	谈何容易	zh-CN
thsb	投怀送抱	zh-CN
thwd	挺好玩的	zh-CN
thwl	太好玩了	zh-CN
thyg	铁画银钩	zh-CN
thyh	头昏眼花	zh-CN
thyl	太好用了	zh-CN
thyx	昙花一现	zh-CN
tibv	推崇备至	zh-CN
tidb	天差地别	zh-CN
tidj	天长地久	zh-CN
tidk	同仇敌忾	zh-CN
tidy	天差地远	zh-CN
tigv	同床共枕	zh-CN
tigx	突出贡献	zh-CN
tiiv	铁杵成针	zh-CN
tiix	推陈出新	zh-CN
tijg	统筹兼顾	zh-CN
tijj	同场竞技	zh-CN
tirj	天长日久	zh-CN
titv	同吃同住	zh-CN
tity	铁齿铜牙	zh-CN
tiut	逃出生天	zh-CN
tivd	突出重点	zh-CN
tixd	坦诚相待	zh-CN
tixf	痛彻心扉	zh-CN
tiym	同床异梦	zh-CN
tjdb	投机倒把	zh-CN
tjdx	同济大学	zh-CN
tjdy	天经地义	zh-CN
tjhj	讨价还价	zh-CN
tjjr	推己及人	zh-CN
tjkz	塔吉克族	zh-CN
tjmg	偷鸡摸狗	zh-CN
tjpx	天将破晓	zh-CN
tjqq	投机取巧	zh-CN
tjvm	脱缰之马	zh-CN
tjvr	头角峥嵘	zh-CN
tjxu	投井下石	zh-CN
tkbq	填空补缺	zh-CN
tkei	脱口而出	zh-CN
tkll	痛快淋漓	zh-CN
tklt	痛哭流涕	zh-CN
tkvd	特快专递	zh-CN
tlbi	螳螂捕蝉	zh-CN
tldw	天罗地网	zh-CN
tldx	特立独行	zh-CN
tlhl	涕泪横流	zh-CN
tlht	拖了后腿	zh-CN
tlhv	偷梁换柱	zh-CN
tlhw	同流合污	zh-CN
tlhz	通力合作	zh-CN
tlkh	脱离苦海	zh-CN
tlkq	叹了口气	zh-CN
tlld	体力劳动	zh-CN
tlnr	天理难容	zh-CN
tlrq	天理人情	zh-CN
tltq	挑来挑去	zh-CN
tluj	脱离实际	zh-CN
tlvj	屠龙之技	zh-CN
tlvl	天伦之乐	zh-CN
tlvu	天籁之声	zh-CN
tlvv	天理昭昭	zh-CN
tlvy	天籁之音	zh-CN
tlwf	徒劳往返	zh-CN
tlwg	徒劳无功	zh-CN
tlwy	徒劳无益	zh-CN
tlxf	袒露心扉	zh-CN
tlxi	跳梁小丑	zh-CN
tmbg	图谋不轨	zh-CN
tmfw	捅马蜂窝	zh-CN
tmgi	土木工程	zh-CN
tmml	天蒙蒙亮	zh-CN
tmvn	天命之年	zh-CN
tmws	铁面无私	zh-CN
tmxr	贪慕虚荣	zh-CN
tmxz	唾沫星子	zh-CN
tndb	天南地北	zh-CN
tndu	拖泥带水	zh-CN
tnfr	头脑发热	zh-CN
tnhb	天南海北	zh-CN
tnjd	头脑简单	zh-CN
tnqw	探囊取物	zh-CN
tnry	天怒人怨	zh-CN
tpdd	调皮捣蛋	zh-CN
tpvf	脱贫致富	zh-CN
tpxl	头破血流	zh-CN
tqbx	图穷匕见	zh-CN
tqdl	通情达理	zh-CN
tqfy	探亲访友	zh-CN
tqgd	挺奇怪的	zh-CN
tqky	投亲靠友	zh-CN
tqlv	同气连枝	zh-CN
tqsh	投其所好	zh-CN
tqtb	铜墙铁壁	zh-CN
tqua	谈情说爱	zh-CN
tqym	吐气扬眉	zh-CN
tqzr	听其自然	zh-CN
trdb	体弱多病	zh-CN
trey	同日而语	zh-CN
trgj	天人共鉴	zh-CN
trgs	痛入骨髓	zh-CN
trhy	天人合一	zh-CN
triv	泰然处之	zh-CN
trmd	坦然面对	zh-CN
trql	突如其来	zh-CN
truv	坦然受之	zh-CN
trvb	天壤之别	zh-CN
trzr	泰然自若	zh-CN
tsfv	胎死腹中	zh-CN
tsgp	兔死狗烹	zh-CN
tshb	兔死狐悲	zh-CN
tsjs	挑三拣四	zh-CN
tsny	坦桑尼亚	zh-CN
tsry	天随人愿	zh-CN
tswq	童叟无欺	zh-CN
tsyd	通俗易懂	zh-CN
tszs	推三阻四	zh-CN
ttba	忐忑不安	zh-CN
ttbf	谈吐不凡	zh-CN
ttbj	滔滔不绝	zh-CN
ttbl	投桃报李	zh-CN
ttdc	饕餮大餐	zh-CN
ttdd	坦坦荡荡	zh-CN
ttdz	滔天大罪	zh-CN
ttez	塔塔尔族	zh-CN
ttgg	坛坛罐罐	zh-CN
tthg	脱胎换骨	zh-CN
tthh	堂堂皇皇	zh-CN
tthr	偷天换日	zh-CN
ttjj	挑挑拣拣	zh-CN
ttkk	痛痛快快	zh-CN
ttlg	亭台楼阁	zh-CN
ttll	拖拖拉拉	zh-CN
ttmm	偷偷摸摸	zh-CN
ttnr	头疼脑热	zh-CN
ttrw	体贴入微	zh-CN
tttn	探头探脑	zh-CN
tttt	吞吞吐吐	zh-CN
ttud	头头是道	zh-CN
ttut	吐吐舌头	zh-CN
ttuu	踏踏实实	zh-CN
ttvg	贪天之功	zh-CN
ttvv	堂堂正正	zh-CN
ttxd	替天行道	zh-CN
ttxu	天天向上	zh-CN
tty	头痛欲裂	zh-CN
ttyl	亭亭玉立	zh-CN
ttym	听天由命	zh-CN
ttyt	头痛医头	zh-CN
ttyy	团团圆圆	zh-CN
tubd	泰山北斗	zh-CN
tudx	听说读写	zh-CN
tuei	挺身而出	zh-CN
tugs	同生共死	zh-CN
tukd	唾手可得	zh-CN
tulv	天生丽质	zh-CN
tups	贪生怕死	zh-CN
tuqk	特殊情况	zh-CN
tusc	唐诗宋词	zh-CN
tutv	土生土长	zh-CN
tuwl	投石问路	zh-CN
tuyd	天生一对	zh-CN
tuyw	天生尤物	zh-CN
tvbq	停滞不前	zh-CN
tvdm	天诛地灭	zh-CN
tvdv	天知地知	zh-CN
tvgj	同舟共济	zh-CN
tvjq	头重脚轻	zh-CN
tvjw	添砖加瓦	zh-CN
tvjy	添枝加叶	zh-CN
tvjz	天之骄子	zh-CN
tvlm	天真烂漫	zh-CN
tvmf	涂脂抹粉	zh-CN
tvru	铁证如山	zh-CN
tvrv	听之任之	zh-CN
tvvj	弹指之间	zh-CN
tvwx	天真无邪	zh-CN
tvwy	天助我也	zh-CN
tvyt	投之以桃	zh-CN
tvyy	逃之夭夭	zh-CN
twbm	图文并茂	zh-CN
twdl	天文地理	zh-CN
twer	天无二日	zh-CN
twfh	贪污腐化	zh-CN
twfx	天外飞仙	zh-CN
twgv	叹为观止	zh-CN
twhh	天网恢恢	zh-CN
twkt	退无可退	zh-CN
twlk	天外来客	zh-CN
twlz	天王老子	zh-CN
twnc	天威难测	zh-CN
twuh	贪污受贿	zh-CN
twwf	体无完肤	zh-CN
twxj	天文学家	zh-CN
twyt	天外有天	zh-CN
txbz	贪心不足	zh-CN
txdd	提心吊胆	zh-CN
txdl	天下大乱	zh-CN
txdu	天下大事	zh-CN
txdv	天旋地转	zh-CN
txdy	天下第一	zh-CN
txfu	谈笑风生	zh-CN
txjf	啼笑皆非	zh-CN
txju	痛心疾首	zh-CN
txjx	痛下决心	zh-CN
txlb	袒胸露背	zh-CN
txlv	同性恋者	zh-CN
txpy	贪小便宜	zh-CN
txqy	偷香窃玉	zh-CN
txrn	推贤让能	zh-CN
txtd	同心同德	zh-CN
txtf	掏心掏肺	zh-CN
txtp	天下太平	zh-CN
txud	贪小失大	zh-CN
txvf	推心置腹	zh-CN
txwd	天下无敌	zh-CN
txwg	天下为公	zh-CN
txwm	童心未泯	zh-CN
txwu	天下无双	zh-CN
txxi	同性相斥	zh-CN
txxl	同心协力	zh-CN
txxw	天下兴亡	zh-CN
txzr	谈笑自若	zh-CN
tybh	头也不回	zh-CN
tydd	天摇地动	zh-CN
tydl	体育锻炼	zh-CN
tyei	脱颖而出	zh-CN
tyfg	田园风光	zh-CN
tygh	同业公会	zh-CN
tygn	特异功能	zh-CN
tyhj	天涯海角	zh-CN
tyjc	添油加醋	zh-CN
tyjh	土洋结合	zh-CN
tyjk	添衣加裤	zh-CN
tyjw	腾云驾雾	zh-CN
tyjy	桃园结义	zh-CN
tymx	头晕目眩	zh-CN
tymy	甜言蜜语	zh-CN
typd	糖衣炮弹	zh-CN
tyqb	徒有其表	zh-CN
tyqm	徒有其名	zh-CN
tytw	吞云吐雾	zh-CN
tyuj	同一时间	zh-CN
tyuq	同一时期	zh-CN
tywf	天衣无缝	zh-CN
tywj	童言无忌	zh-CN
tyxm	徒有虚名	zh-CN
tyxy	天要下雨	zh-CN
tyys	挺有意思	zh-CN
tzjx	天子脚下	zh-CN
tzqc	天纵其才	zh-CN
tzrh	天灾人祸	zh-CN
tzvh	天作之合	zh-CN
tzwf	贪赃枉法	zh-CN
tzyh	投资银行	zh-CN
uawz	少安毋躁	zh-CN
ubbx	誓不罢休	zh-CN
ubcm	恕不从命	zh-CN
ubdl	山崩地裂	zh-CN
ubfg	恕不奉告	zh-CN
ubfp	恕不奉陪	zh-CN
ubfu	生不逢时	zh-CN
ubg	事半功倍	zh-CN
ubgb	事倍功半	zh-CN
ubgf	食不果腹	zh-CN
ubgj	事不关己	zh-CN
ubgq	说不过去	zh-CN
ubgs	事不过三	zh-CN
ubgu	少不更事	zh-CN
ubgw	食不甘味	zh-CN
ubgx	善罢甘休	zh-CN
ubhj	睡不好觉	zh-CN
ubik	说不出口	zh-CN
ubil	说不出来	zh-CN
ubjd	深不见底	zh-CN
ubjs	十八九岁	zh-CN
ubju	少不经事	zh-CN
ubkc	深不可测	zh-CN
ubkd	势不可挡	zh-CN
ubld	傻不愣登	zh-CN
ublj	傻不拉叽	zh-CN
ubll	势不两立	zh-CN
ublq	神兵利器	zh-CN
ublu	稍不留神	zh-CN
ublv	树碑立传	zh-CN
ubml	身败名裂	zh-CN
ubnu	寿比南山	zh-CN
ubqi	说不清楚	zh-CN
ubqm	舍本求末	zh-CN
ubqy	深表歉意	zh-CN
ubrs	生不如死	zh-CN
ubsr	士别三日	zh-CN
ubtq	深表同情	zh-CN
ubuj	手不释卷	zh-CN
ubul	说不上来	zh-CN
ubuu	数不胜数	zh-CN
ubux	实报实销	zh-CN
ubvd	谁不知道	zh-CN
ubvm	舍本逐末	zh-CN
ubvt	上不着天	zh-CN
ubwd	时不我待	zh-CN
ubwy	时不我与	zh-CN
ubxh	谁不喜欢	zh-CN
ubxm	实不相瞒	zh-CN
ubxy	食不下咽	zh-CN
ubyh	深表遗憾	zh-CN
ubyi	事不宜迟	zh-CN
ubyj	身不由己	zh-CN
ubys	恕不远送	zh-CN
ubyt	生搬硬套	zh-CN
ubyy	是不一样	zh-CN
ubzl	时不再来	zh-CN
ucaw	恃才傲物	zh-CN
ucbl	深藏不露	zh-CN
ucfy	神采飞扬	zh-CN
ucgf	诗词歌赋	zh-CN
uchj	生存环境	zh-CN
ucjv	上层建筑	zh-CN
uclh	舌灿莲花	zh-CN
ucvd	生财之道	zh-CN
ucvj	身残志坚	zh-CN
ucxt	上蹿下跳	zh-CN
ucyd	生财有道	zh-CN
ucyl	生存压力	zh-CN
ucyx	受此影响	zh-CN
ucyy	神采奕奕	zh-CN
udbi	手到病除	zh-CN
uddx	说东道西	zh-CN
udgq	说得过去	zh-CN
udgv	失道寡助	zh-CN
udjx	声东击西	zh-CN
udkl	圣诞快乐	zh-CN
udlr	圣诞老人	zh-CN
udlt	事到临头	zh-CN
udq	首当其冲	zh-CN
udqf	适得其反	zh-CN
udqi	水到渠成	zh-CN
udql	手到擒来	zh-CN
udqu	舐犊情深	zh-CN
udrj	事到如今	zh-CN
udrx	世道人心	zh-CN
udtt	上得厅堂	zh-CN
uduc	是对是错	zh-CN
udui	水滴石穿	zh-CN
udup	上当受骗	zh-CN
udux	时断时续	zh-CN
udvf	树大招风	zh-CN
udwp	硕大无朋	zh-CN
udwz	数典忘祖	zh-CN
udxi	世代相传	zh-CN
udxx	生动形象	zh-CN
udyg	圣地亚哥	zh-CN
udzd	说到做到	zh-CN
udzy	师道尊严	zh-CN
uebh	食而不化	zh-CN
uebj	视而不见	zh-CN
uebl	疏而不漏	zh-CN
uebu	十恶不赦	zh-CN
ueby	少儿不宜	zh-CN
uefd	失而复得	zh-CN
uefm	善恶分明	zh-CN
uepd	生而平等	zh-CN
uess	十二三岁	zh-CN
uevv	生而知之	zh-CN
ueyf	十二月份	zh-CN
ueyn	生儿育女	zh-CN
ufbs	伤风败俗	zh-CN
ufdh	煽风点火	zh-CN
ufdx	师范大学	zh-CN
uffm	赏罚分明	zh-CN
ufhb	是非黑白	zh-CN
ufjd	杀伐决断	zh-CN
ufjj	删繁就简	zh-CN
ufjw	上房揭瓦	zh-CN
ufkx	煞费苦心	zh-CN
ufqh	适逢其会	zh-CN
ufqv	是非曲直	zh-CN
ufrx	世风日下	zh-CN
ufvd	是非之地	zh-CN
ufvr	身负重任	zh-CN
ufvw	深孚众望	zh-CN
ufvy	十分之一	zh-CN
ufxx	师范学校	zh-CN
ufyx	收发由心	zh-CN
ugbh	食古不化	zh-CN
ugby	深更半夜	zh-CN
ugdw	施工单位	zh-CN
ugeg	善贾而沽	zh-CN
ugfc	升官发财	zh-CN
ughj	睡个好觉	zh-CN
ugjc	硕果仅存	zh-CN
ugjg	说干就干	zh-CN
ugjq	时过境迁	zh-CN
ugll	硕果累累	zh-CN
uglx	瘦骨嶙峋	zh-CN
ugmc	神鬼莫测	zh-CN
ugmw	说个没完	zh-CN
ugqx	双管齐下	zh-CN
ugud	时高时低	zh-CN
uguj	上个世纪	zh-CN
ugus	水光山色	zh-CN
ugvv	收官之战	zh-CN
uhby	尸横遍野	zh-CN
uhdc	说话带刺	zh-CN
uhdx	上海大学	zh-CN
uhdy	疏忽大意	zh-CN
uhgp	摄魂勾魄	zh-CN
uhjd	上海交大	zh-CN
uhjj	身怀绝技	zh-CN
uhlj	身怀六甲	zh-CN
uhlp	失魂落魄	zh-CN
uhmb	生花妙笔	zh-CN
uhnf	时和年丰	zh-CN
uhqj	神乎其技	zh-CN
uhvy	社会主义	zh-CN
uhwq	水火无情	zh-CN
uhws	山呼万岁	zh-CN
uhxj	社会学家	zh-CN
uibq	伤春悲秋	zh-CN
uibz	生辰八字	zh-CN
uiej	恃宠而骄	zh-CN
uigm	神出鬼没	zh-CN
uihl	山川河流	zh-CN
uijy	省吃俭用	zh-CN
uiqh	势成骑虎	zh-CN
uiwm	师出无名	zh-CN
uiyy	事出有因	zh-CN
ujar	生机盎然	zh-CN
ujbb	生机勃勃	zh-CN
ujbv	身经百战	zh-CN
ujby	手脚并用	zh-CN
ujbz	时间不早	zh-CN
ujcq	事急从权	zh-CN
ujdg	少见多怪	zh-CN
ujdv	世界大战	zh-CN
ujgj	世界冠军	zh-CN
ujgm	神经过敏	zh-CN
ujhb	双剑合璧	zh-CN
ujhh	杀鸡骇猴	zh-CN
ujhp	世界和平	zh-CN
ujht	数九寒天	zh-CN
ujil	时间长了	zh-CN
ujjh	杀鸡儆猴	zh-CN
ujji	深居简出	zh-CN
ujjl	世界纪录	zh-CN
ujjp	时间紧迫	zh-CN
ujjr	舍己救人	zh-CN
ujld	势均力敌	zh-CN
ujmn	释迦牟尼	zh-CN
ujmr	世界末日	zh-CN
ujms	神机妙算	zh-CN
ujmu	神经末梢	zh-CN
ujpb	生机蓬勃	zh-CN
ujql	杀鸡取卵	zh-CN
ujqy	舍近求远	zh-CN
ujry	善解人意	zh-CN
ujur	神经衰弱	zh-CN
ujvm	实践证明	zh-CN
ujvt	市井之徒	zh-CN
ujwj	世界屋脊	zh-CN
ujwr	舍己为人	zh-CN
ujwt	实际问题	zh-CN
ujxd	实际行动	zh-CN
ujxh	杀鸡吓猴	zh-CN
ujyk	手疾眼快	zh-CN
ukev	适可而止	zh-CN
ukfr	矢口否认	zh-CN
ukjl	首开纪录	zh-CN
ukrp	守口如瓶	zh-CN
ukun	受苦受难	zh-CN
ukzv	水可载舟	zh-CN
ulbj	始料不及	zh-CN
ulbs	生老病死	zh-CN
ulbx	十里八乡	zh-CN
ulex	顺流而下	zh-CN
ulhh	生龙活虎	zh-CN
ulhi	说来话长	zh-CN
uliv	顺理成章	zh-CN
uljv	十六进制	zh-CN
ulnj	上了年纪	zh-CN
ulqj	身临其境	zh-CN
ulqs	十六七岁	zh-CN
ulqx	石榴裙下	zh-CN
ulsb	生离死别	zh-CN
ultt	生灵涂炭	zh-CN
ulty	水来土掩	zh-CN
ului	水落石出	zh-CN
uluq	说来说去	zh-CN
ulur	时冷时热	zh-CN
ulvb	神来之笔	zh-CN
ulvq	始乱终弃	zh-CN
ulvu	擅离职守	zh-CN
ulwi	顺利完成	zh-CN
ulwj	始料未及	zh-CN
ulxy	圣卢西亚	zh-CN
ulyi	生拉硬扯	zh-CN
ulyu	生理盐水	zh-CN
ulyv	时来运转	zh-CN
ulyx	试了一下	zh-CN
ulzi	上了贼船	zh-CN
umbx	生命不息	zh-CN
umcg	鼠目寸光	zh-CN
umdv	声名大振	zh-CN
umdy	善莫大焉	zh-CN
umhu	山盟海誓	zh-CN
umjl	手忙脚乱	zh-CN
umlj	声名狼藉	zh-CN
umln	圣马力诺	zh-CN
ummf	十面埋伏	zh-CN
umqq	声名鹊起	zh-CN
umrx	收买人心	zh-CN
umul	熟门熟路	zh-CN
umum	双目失明	zh-CN
umux	山明水秀	zh-CN
umvx	盛名之下	zh-CN
umxx	神秘兮兮	zh-CN
umyb	声名远播	zh-CN
umyd	拭目以待	zh-CN
umyl	深谋远虑	zh-CN
umyy	声名远扬	zh-CN
un	熟能生巧	zh-CN
uncm	恕难从命	zh-CN
undv	少年得志	zh-CN
unet	少年儿童	zh-CN
unhb	山南海北	zh-CN
unhi	十年寒窗	zh-CN
unjw	十拿九稳	zh-CN
unli	少年老成	zh-CN
untq	上年同期	zh-CN
unun	少男少女	zh-CN
unuq	熟能生巧	zh-CN
unwg	孰能无过	zh-CN
unxn	善男信女	zh-CN
upjx	双拼加形	zh-CN
uptj	石破天惊	zh-CN
upxl	顺坡下驴	zh-CN
uqbb	生气勃勃	zh-CN
uqbm	声情并茂	zh-CN
uqbs	十七八岁	zh-CN
uqfr	蜀犬吠日	zh-CN
uqh	深情厚谊	zh-CN
uqhx	神气活现	zh-CN
uqhy	诗情画意	zh-CN
uqkd	盛情款待	zh-CN
uqlr	盛气凌人	zh-CN
uqlv	身强力壮	zh-CN
uqnq	盛情难却	zh-CN
uqqu	神清气爽	zh-CN
uqrc	尚且如此	zh-CN
uqtt	杀气腾腾	zh-CN
uqtv	身强体壮	zh-CN
uquj	山穷水尽	zh-CN
uqul	山青水绿	zh-CN
uqum	十全十美	zh-CN
uqux	山清水秀	zh-CN
uquz	神气十足	zh-CN
uqwy	水清无鱼	zh-CN
uqxd	上情下达	zh-CN
uqxt	声气相通	zh-CN
uqyv	首屈一指	zh-CN
uqzr	顺其自然	zh-CN
uqzw	胜券在握	zh-CN
urbf	霜染白发	zh-CN
urcj	视如草芥	zh-CN
urfh	杀人放火	zh-CN
urgs	深入骨髓	zh-CN
urhv	声如洪钟	zh-CN
urhx	深入虎穴	zh-CN
urim	杀人偿命	zh-CN
urji	视如己出	zh-CN
urjr	水乳交融	zh-CN
urjv	世人皆知	zh-CN
urkl	生日快乐	zh-CN
urki	视如寇仇	zh-CN
urlx	潸然泪下	zh-CN
urmk	杀人灭口	zh-CN
urpv	势如破竹	zh-CN
urqi	深入浅出	zh-CN
urrm	杀人如麻	zh-CN
urrx	深入人心	zh-CN
urry	手如柔荑	zh-CN
urvb	视如珍宝	zh-CN
urvt	受人之托	zh-CN
urwd	视若无睹	zh-CN
urw	时日无多	zh-CN
urxu	杀人凶手	zh-CN
urxv	深入细致	zh-CN
uryb	授人以柄	zh-CN
uryh	杀人越货	zh-CN
uryk	胜任愉快	zh-CN
uryy	授人以鱼	zh-CN
usbd	殊死搏斗	zh-CN
usbm	生死不明	zh-CN
usbv	生死不知	zh-CN
uscw	生死存亡	zh-CN
usds	说三道四	zh-CN
usgt	生死关头	zh-CN
ushh	神思恍惚	zh-CN
usjl	声色俱厉	zh-CN
uslj	声嘶力竭	zh-CN
usqm	声色犬马	zh-CN
usrg	视死如归	zh-CN
usss	十三四岁	zh-CN
usuf	双宿双飞	zh-CN
usug	水色山光	zh-CN
usul	深思熟虑	zh-CN
usvj	生死之交	zh-CN
usvv	生死之战	zh-CN
uswb	生死未卜	zh-CN
usws	十四五岁	zh-CN
usx	食色性也	zh-CN
usxy	生死相依	zh-CN
usy	生死攸关	zh-CN
usyg	生死与共	zh-CN
usym	生死有命	zh-CN
uszr	神色自若	zh-CN
utbf	水土不服	zh-CN
utex	视同儿戏	zh-CN
utff	身体发肤	zh-CN
utgd	神通广大	zh-CN
uthb	生吞活剥	zh-CN
uthj	生态环境	zh-CN
uthl	伤天害理	zh-CN
utjk	身体健康	zh-CN
utlm	识途老马	zh-CN
utlr	视同路人	zh-CN
utlu	水土流失	zh-CN
utlx	身体力行	zh-CN
utmg	顺藤摸瓜	zh-CN
utph	生态平衡	zh-CN
uttg	殊途同归	zh-CN
utuh	势同水火	zh-CN
utvb	率土之滨	zh-CN
utwl	上天无路	zh-CN
utxj	水天相接	zh-CN
utxt	生态系统	zh-CN
utyl	世态炎凉	zh-CN
utyr	顺天应人	zh-CN
utys	水天一色	zh-CN
uubq	授受不亲	zh-CN
uubx	生生不息	zh-CN
uuby	实属不易	zh-CN
uudb	束手待毙	zh-CN
uudd	神神叨叨	zh-CN
uudq	生杀大权	zh-CN
uudu	审时度势	zh-CN
uued	顺时而动	zh-CN
uuew	顺势而为	zh-CN
uuey	说说而已	zh-CN
uuff	舒舒服服	zh-CN
uufg	闪闪发光	zh-CN
uuhd	声势浩大	zh-CN
uuid	设身处地	zh-CN
uuir	杀身成仁	zh-CN
uuix	嗜杀成性	zh-CN
uujk	十室九空	zh-CN
uujq	束手就擒	zh-CN
uukk	时时刻刻	zh-CN
uuld	首鼠两端	zh-CN
uuml	深山密林	zh-CN
uumz	少数民族	zh-CN
uunl	世事难料	zh-CN
uuqc	闪烁其词	zh-CN
uuqh	深受其害	zh-CN
uuql	烧杀抢掠	zh-CN
uuqu	实事求是	zh-CN
uuqy	顺手牵羊	zh-CN
uurq	顺水人情	zh-CN
uurr	盛衰荣辱	zh-CN
uury	守身如玉	zh-CN
uutv	顺水推舟	zh-CN
uuuj	束手束脚	zh-CN
uuvg	甩手掌柜	zh-CN
uuvm	事实证明	zh-CN
uuvq	首善之区	zh-CN
uuwc	束手无策	zh-CN
uuwi	世事无常	zh-CN
uuwn	实属无奈	zh-CN
uuws	舍生忘死	zh-CN
uuwy	伤势未愈	zh-CN
uuxh	尸山血海	zh-CN
uuxw	硕士学位	zh-CN
uuxz	莘莘学子	zh-CN
uuyd	生杀予夺	zh-CN
uuyw	蛇鼠一窝	zh-CN
uuzh	说实在话	zh-CN
uuzz	实实在在	zh-CN
uvbj	十之八九	zh-CN
uvbl	善者不来	zh-CN
uvbq	神志不清	zh-CN
uvbx	始终不懈	zh-CN
uvby	矢志不渝	zh-CN
uvdt	守株待兔	zh-CN
uvdy	深宅大院	zh-CN
uvgg	束之高阁	zh-CN
uvhl	失之毫厘	zh-CN
uvhw	山珍海味	zh-CN
uvig	水涨船高	zh-CN
uvjg	市直机关	zh-CN
uvji	始终坚持	zh-CN
uvjr	时至今日	zh-CN
uvlx	十指连心	zh-CN
uvly	水中捞月	zh-CN
uvqg	生殖器官	zh-CN
uvqr	舌战群儒	zh-CN
uvrs	逝者如斯	zh-CN
uvry	始终如一	zh-CN
uvsy	收之桑榆	zh-CN
uvuc	适者生存	zh-CN
uvuj	是真是假	zh-CN
uvvq	寿终正寝	zh-CN
uvwd	说着玩的	zh-CN
uvxt	生殖系统	zh-CN
uvyd	是这样的	zh-CN
uvyf	绳之以法	zh-CN
uvyk	受之有愧	zh-CN
uwct	手无寸铁	zh-CN
uwcv	伤亡惨重	zh-CN
uwdl	尚无定论	zh-CN
uwdv	声威大震	zh-CN
uwfw	身无分文	zh-CN
uwgi	生物工程	zh-CN
uwhj	十万火急	zh-CN
uwii	身无长处	zh-CN
uwiw	身无长物	zh-CN
uwjx	事无巨细	zh-CN
uwjz	说文解字	zh-CN
uwls	十五六岁	zh-CN
uwpw	上无片瓦	zh-CN
uwql	史无前例	zh-CN
uwqu	舍我其谁	zh-CN
uwsc	尸位素餐	zh-CN
uwtj	深恶痛绝	zh-CN
uwty	世外桃源	zh-CN
uwuj	市委书记	zh-CN
uwvw	身外之物	zh-CN
uwvy	恕我直言	zh-CN
uwxv	守望相助	zh-CN
uwxy	首尾相应	zh-CN
uwyu	山外有山	zh-CN
uwzd	手舞足蹈	zh-CN
uxbf	烧香拜佛	zh-CN
uxbj	手下败将	zh-CN
uxbt	水泄不通	zh-CN
uxby	深信不疑	zh-CN
uxdy	少先队员	zh-CN
uxiu	甚嚣尘上	zh-CN
uxjc	身心交瘁	zh-CN
uxjp	身心俱疲	zh-CN
uxlq	手下留情	zh-CN
uxlu	赏心乐事	zh-CN
uxly	身陷囹圄	zh-CN
uxmd	书香门第	zh-CN
uxqn	十项全能	zh-CN
uxqu	上下其手	zh-CN
uxqv	深陷其中	zh-CN
uxub	手心手背	zh-CN
uxuy	实心实意	zh-CN
uxuz	身先士卒	zh-CN
uxvg	身陷桎梏	zh-CN
uxwb	瞬息万变	zh-CN
uxwc	少小无猜	zh-CN
uxwm	歃血为盟	zh-CN
uxwt	世袭罔替	zh-CN
uxxx	上行下效	zh-CN
uxyh	水性杨花	zh-CN
uxyj	伤心欲绝	zh-CN
uxyl	升学压力	zh-CN
uxym	赏心悦目	zh-CN
uxyx	上下一心	zh-CN
uxzy	上下左右	zh-CN
uybe	说一不二	zh-CN
uybj	十有八九	zh-CN
uybq	拾遗补阙	zh-CN
uybv	食欲不振	zh-CN
uydx	石油大学	zh-CN
uyef	食言而肥	zh-CN
uyeg	铩羽而归	zh-CN
uyes	十一二岁	zh-CN
uyfi	甚于防川	zh-CN
uyfq	受益匪浅	zh-CN
uyfu	时有发生	zh-CN
uyfw	适用范围	zh-CN
uygi	深有感触	zh-CN
uyjb	杀一儆百	zh-CN
uyju	煞有介事	zh-CN
uyld	受益良多	zh-CN
uyqg	数易其稿	zh-CN
uyqj	数以千计	zh-CN
uytg	深有同感	zh-CN
uyth	深有体会	zh-CN
uytq	寿与天齐	zh-CN
uytt	手眼通天	zh-CN
uytx	神游太虚	zh-CN
uyue	数一数二	zh-CN
uyul	孰优孰劣	zh-CN
uyuw	时有时无	zh-CN
uyux	时隐时现	zh-CN
uyuy	世易时移	zh-CN
uyvc	事已至此	zh-CN
uyvn	善游者溺	zh-CN
uywj	数以万计	zh-CN
uywr	深以为然	zh-CN
uyxd	水银泻地	zh-CN
uyxg	实言相告	zh-CN
uyxs	睡眼惺忪	zh-CN
uyyf	十一月份	zh-CN
uyyh	商业银行	zh-CN
uyyu	施以援手	zh-CN
uyyw	事与愿违	zh-CN
uyzx	始于足下	zh-CN
uzbd	势在必得	zh-CN
uzbf	数罪并罚	zh-CN
uzbx	势在必行	zh-CN
uzjt	十字街头	zh-CN
uzjz	说走就走	zh-CN
uzpz	耍嘴皮子	zh-CN
uzrw	事在人为	zh-CN
uzug	实在是高	zh-CN
uzvq	手足之情	zh-CN
uzwc	手足无措	zh-CN
uzwl	少走弯路	zh-CN
uzyv	始作俑者	zh-CN
vaaj	治安案件	zh-CN
vbbq	止步不前	zh-CN
vbbx	朝不保夕	zh-CN
vbdb	找不到北	zh-CN
vbgj	周边国家	zh-CN
vbgw	转不过弯	zh-CN
vbhl	准备好了	zh-CN
vbjr	治病救人	zh-CN
vbju	这不就是	zh-CN
vbmm	招兵买马	zh-CN
vbqy	正本清源	zh-CN
vbsn	中饱私囊	zh-CN
vbsy	追本溯源	zh-CN
vbub	针砭时弊	zh-CN
vbum	丈八蛇矛	zh-CN
vbvd	知不知道	zh-CN
vbvi	支不支持	zh-CN
vbvt	照搬照套	zh-CN
vbwu	转败为胜	zh-CN
vbwx	转悲为喜	zh-CN
vbxk	照本宣科	zh-CN
vbyc	止步于此	zh-CN
vbyh	振臂一呼	zh-CN
vbyu	诈败佯输	zh-CN
vbzc	志不在此	zh-CN
vcbg	知错必改	zh-CN
vcig	斩草除根	zh-CN
vcjb	招财进宝	zh-CN
vcjg	知错就改	zh-CN
vcng	知错能改	zh-CN
vcul	真材实料	zh-CN
vcux	真才实学	zh-CN
vcyj	只此一家	zh-CN
vczb	注册资本	zh-CN
vczj	注册资金	zh-CN
vdbi	债多不愁	zh-CN
vdbv	战斗不止	zh-CN
vdcu	志大才疏	zh-CN
vddd	种豆得豆	zh-CN
vddx	重点大学	zh-CN
vdfw	正当防卫	zh-CN
vdfx	抓大放小	zh-CN
vdgm	正大光明	zh-CN
vdhl	直捣黄龙	zh-CN
vdir	长大成人	zh-CN
vdjc	张灯结彩	zh-CN
vdjd	真的假的	zh-CN
vdjt	斩钉截铁	zh-CN
vdju	指点江山	zh-CN
vdjv	重大进展	zh-CN
vdmj	指点迷津	zh-CN
vdrq	煮豆燃萁	zh-CN
vdsu	重大损失	zh-CN
vdtp	重大突破	zh-CN
vduj	重大事件	zh-CN
vdwt	重大问题	zh-CN
vdxz	直到现在	zh-CN
vdyh	渣打银行	zh-CN
vdyj	睁大眼睛	zh-CN
vdym	志得意满	zh-CN
vdyt	值得一提	zh-CN
vdyu	这倒也是	zh-CN
vdyx	重大影响	zh-CN
vdyy	值得拥有	zh-CN
vdzr	镇定自若	zh-CN
vdzy	重大作用	zh-CN
vebj	正儿八经	zh-CN
vebq	卓尔不群	zh-CN
vehu	丈二和尚	zh-CN
vens	抓耳挠腮	zh-CN
vetb	知恩图报	zh-CN
veyl	震耳欲聋	zh-CN
vfby	遮风避雨	zh-CN
vfdm	争分夺秒	zh-CN
vfdx	政法大学	zh-CN
vfdy	遮风挡雨	zh-CN
vfgy	追风赶月	zh-CN
vfic	争风吃醋	zh-CN
vfjg	政府机关	zh-CN
vfmu	装疯卖傻	zh-CN
vfru	执法如山	zh-CN
vfrx	振奋人心	zh-CN
vfxd	针锋相对	zh-CN
vfxv	朝发夕至	zh-CN
vfym	枝繁叶茂	zh-CN
vgab	治国安邦	zh-CN
vgam	治国安民	zh-CN
vgbq	珠光宝气	zh-CN
vgbr	猪狗不如	zh-CN
vgdd	枕戈待旦	zh-CN
vgdg	种瓜得瓜	zh-CN
vgdu	这个倒是	zh-CN
vgjd	追根究底	zh-CN
vgld	张冠李戴	zh-CN
vgqy	趾高气扬	zh-CN
vgrc	正该如此	zh-CN
vgrm	中国人民	zh-CN
vgsy	追根溯源	zh-CN
vgtl	转过头来	zh-CN
vgtq	转过头去	zh-CN
vguh	这个时候	zh-CN
vguj	震古烁今	zh-CN
vgul	转过身来	zh-CN
vguq	转过身去	zh-CN
vgvd	知根知底	zh-CN
vgvf	中国政府	zh-CN
vgvy	至关重要	zh-CN
vgwt	这个问题	zh-CN
vgwx	中国文学	zh-CN
vgxg	朝过夕改	zh-CN
vgxu	众寡悬殊	zh-CN
vgyd	忠肝义胆	zh-CN
vgyh	中国银行	zh-CN
vgyz	这个样子	zh-CN
vhbh	专横跋扈	zh-CN
vhbs	这还不算	zh-CN
vhmg	中华民国	zh-CN
vhmj	追悔莫及	zh-CN
vhmz	中华民族	zh-CN
vhqm	直呼其名	zh-CN
vhrc	沾花惹草	zh-CN
vhrd	指挥若定	zh-CN
vhrm	中华人民	zh-CN
vhrx	震撼人心	zh-CN
vhud	这话说的	zh-CN
vhvy	之乎者也	zh-CN
vhwy	正合我意	zh-CN
vhxu	朝花夕拾	zh-CN
vhzy	中和作用	zh-CN
vigf	展翅高飞	zh-CN
vihi	朱唇皓齿	zh-CN
vijj	中产阶级	zh-CN
viju	终成眷属	zh-CN
vild	舟车劳顿	zh-CN
viql	咫尺千里	zh-CN
vity	咫尺天涯	zh-CN
viyd	张弛有度	zh-CN
viyf	筑巢引凤	zh-CN
vjbb	正经八百	zh-CN
vjbv	招架不住	zh-CN
vjby	真金白银	zh-CN
vjdx	浙江大学	zh-CN
vjjv	捉襟见肘	zh-CN
vjld	直截了当	zh-CN
vjll	中坚力量	zh-CN
vjnb	真假难辨	zh-CN
vjnp	招降纳叛	zh-CN
vjqz	证据确凿	zh-CN
vjuj	斩尽杀绝	zh-CN
vjum	只见树木	zh-CN
vjvb	知己知彼	zh-CN
vjwv	至今为止	zh-CN
vjwz	正襟危坐	zh-CN
vjxu	折节下士	zh-CN
vjzi	捉奸在床	zh-CN
vkju	张口结舌	zh-CN
vknt	众口难调	zh-CN
vkuj	众口铄金	zh-CN
vkwu	真可谓是	zh-CN
vkyc	众口一词	zh-CN
vkyh	只可意会	zh-CN
vkyj	睁开眼睛	zh-CN
vlbh	珠联璧合	zh-CN
vlbx	争论不休	zh-CN
vldu	竹篮打水	zh-CN
vldv	中流砥柱	zh-CN
vlfk	振聋发聩	zh-CN
vlgy	重力感应	zh-CN
vljz	株连九族	zh-CN
vlmg	朝令暮改	zh-CN
vlmx	斩落马下	zh-CN
vlmy	至理名言	zh-CN
vlps	支离破碎	zh-CN
vltj	崭露头角	zh-CN
vlvm	皱了皱眉	zh-CN
vlvq	转来转去	zh-CN
vlvr	周六周日	zh-CN
vlvy	逐鹿中原	zh-CN
vlwm	指鹿为马	zh-CN
vlxg	朝令夕改	zh-CN
vlyq	转了一圈	zh-CN
vlyx	钟灵毓秀	zh-CN
vlzy	装聋作哑	zh-CN
vmbt	捉摸不透	zh-CN
vmbw	执迷不悟	zh-CN
vmdl	争名夺利	zh-CN
vmdn	这么多年	zh-CN
vmdr	这么多人	zh-CN
vmdx	指名道姓	zh-CN
vmhh	照猫画虎	zh-CN
vmhu	这么回事	zh-CN
vmjd	这么简单	zh-CN
vmkk	众目睽睽	zh-CN
vmlh	直冒冷汗	zh-CN
vmlj	钟鸣漏尽	zh-CN
vmlm	珠穆朗玛	zh-CN
vmmf	这么麻烦	zh-CN
vmvm	琢磨琢磨	zh-CN
vmvy	殖民主义	zh-CN
vmys	真没意思	zh-CN
vmzy	装模作样	zh-CN
vnej	知难而进	zh-CN
vnet	知难而退	zh-CN
vneu	知难而上	zh-CN
vnhh	乍暖还寒	zh-CN
vnjj	终南捷径	zh-CN
vnnf	众怒难犯	zh-CN
vnqn	重男轻女	zh-CN
vnyx	转念一想	zh-CN
vpql	众叛亲离	zh-CN
vpuj	真凭实据	zh-CN
vpxu	中篇小说	zh-CN
vqdf	只欠东风	zh-CN
vqdg	沾亲带故	zh-CN
vqdl	争权夺利	zh-CN
vqdy	争奇斗艳	zh-CN
vqgh	瞻前顾后	zh-CN
vqgr	至亲骨肉	zh-CN
vqhu	争强好胜	zh-CN
vqhy	整齐划一	zh-CN
vqlr	正气凛然	zh-CN
vqmi	朝秦暮楚	zh-CN
vqpb	朝气蓬勃	zh-CN
vqqu	珍禽奇兽	zh-CN
vqru	正确认识	zh-CN
vqsl	赵钱孙李	zh-CN
vquq	知情识趣	zh-CN
vqxt	志趣相投	zh-CN
vqyu	终其一生	zh-CN
vqzu	装腔作势	zh-CN
vrbb	终日奔波	zh-CN
vrcl	诸如此类	zh-CN
vrem	遮人耳目	zh-CN
vrjz	正人君子	zh-CN
vrkd	指日可待	zh-CN
vrml	郑人买履	zh-CN
vrrj	昭然若揭	zh-CN
vrsy	峥嵘岁月	zh-CN
vrur	知人善任	zh-CN
vrvf	逐日追风	zh-CN
vrvy	直人直语	zh-CN
vrwl	助人为乐	zh-CN
vrww	置若罔闻	zh-CN
vsbw	至死不悟	zh-CN
vsby	至死不渝	zh-CN
vsfx	至死方休	zh-CN
vsls	张三李四	zh-CN
vsmh	指桑骂槐	zh-CN
vsmj	蛛丝马迹	zh-CN
vsms	朝三暮四	zh-CN
vsmx	朝思暮想	zh-CN
vsvv	众所周知	zh-CN
vtaj	珠胎暗结	zh-CN
vtbr	遮天蔽日	zh-CN
vtdh	志同道合	zh-CN
vtgd	遮天盖地	zh-CN
vtgv	债台高筑	zh-CN
vtrh	政通人和	zh-CN
vtum	獐头鼠目	zh-CN
vudl	知书达理	zh-CN
vudw	壮士断腕	zh-CN
vudx	中山大学	zh-CN
vufy	众说纷纭	zh-CN
vufz	知识分子	zh-CN
vuhj	指手画脚	zh-CN
vuil	装傻充愣	zh-CN
vujj	直抒己见	zh-CN
vuju	转瞬即逝	zh-CN
vukr	炙手可热	zh-CN
vums	朝生暮死	zh-CN
vung	装神弄鬼	zh-CN
vuqv	置身其中	zh-CN
vurc	正是如此	zh-CN
vurl	掌声如雷	zh-CN
vusd	粥少僧多	zh-CN
vutb	纸上谈兵	zh-CN
vuuw	置身事外	zh-CN
vuvm	至善至美	zh-CN
vuvt	只手遮天	zh-CN
vuxv	真实写照	zh-CN
vuxy	直抒胸臆	zh-CN
vuyh	招商银行	zh-CN
vuzl	植树造林	zh-CN
vvba	惴惴不安	zh-CN
vvbe	忠贞不二	zh-CN
vvbl	置之不理	zh-CN
vvby	忠贞不渝	zh-CN
vvdd	指指点点	zh-CN
vvdf	整装待发	zh-CN
vvdw	置之度外	zh-CN
vvfc	辗转反侧	zh-CN
vvgg	政治改革	zh-CN
vvgt	转折关头	zh-CN
vvii	众志成城	zh-CN
vviv	茁壮成长	zh-CN
vviy	支柱产业	zh-CN
vvjh	谆谆教诲	zh-CN
vvjj	真真假假	zh-CN
vvjl	招之即来	zh-CN
vvjr	直至今日	zh-CN
vvjv	智者见智	zh-CN
vvjz	照照镜子	zh-CN
vvly	壮志凌云	zh-CN
vvmm	朝朝暮暮	zh-CN
vvnh	置之脑后	zh-CN
vvnm	辗转难眠	zh-CN
vvqu	郑重其事	zh-CN
vvqy	只知其一	zh-CN
vvsd	置之死地	zh-CN
vvtg	铮铮铁骨	zh-CN
vvtv	政治体制	zh-CN
vvud	追涨杀跌	zh-CN
vvuu	扎扎实实	zh-CN
vvvj	真知灼见	zh-CN
vvvv	重中之重	zh-CN
vvvx	只争朝夕	zh-CN
vvwi	壮志未酬	zh-CN
vvwn	助纣为虐	zh-CN
vvws	正直无私	zh-CN
vvxh	正中下怀	zh-CN
vvxj	政治学家	zh-CN
vvxu	政治协商	zh-CN
vvyc	振振有词	zh-CN
vvyd	政治运动	zh-CN
vvyu	智者乐水	zh-CN
vvyx	置之一笑	zh-CN
vvyy	遮遮掩掩	zh-CN
vvzv	浊者自浊	zh-CN
vvzx	沾沾自喜	zh-CN
vwbu	战无不胜	zh-CN
vwby	知无不言	zh-CN
vwcr	珠围翠绕	zh-CN
vwdx	中文大学	zh-CN
vwjg	站稳脚跟	zh-CN
vwmj	转弯抹角	zh-CN
vwqc	支吾其词	zh-CN
vwsg	众望所归	zh-CN
vwvw	周吴郑王	zh-CN
vwwa	转危为安	zh-CN
vwxs	朝闻夕死	zh-CN
vxcg	锥心刺骨	zh-CN
vxdb	真相大白	zh-CN
vxdd	周旋到底	zh-CN
vxgg	忠心耿耿	zh-CN
vxhb	中西合璧	zh-CN
vxhy	知行合一	zh-CN
vxiy	真心诚意	zh-CN
vxjr	秩序井然	zh-CN
vxkh	争先恐后	zh-CN
vxnl	这些年来	zh-CN
vxnu	招贤纳士	zh-CN
vxpy	众星捧月	zh-CN
vxqy	中小企业	zh-CN
vxrh	宅心仁厚	zh-CN
vxrz	这些日子	zh-CN
vxsx	中心思想	zh-CN
vxuu	直线上升	zh-CN
vxuy	真心实意	zh-CN
vxvv	专心致志	zh-CN
vxvy	真心真意	zh-CN
vxxb	朝夕相伴	zh-CN
vxxi	朝夕相处	zh-CN
vybh	直言不讳	zh-CN
vydh	这样的话	zh-CN
vydq	中原地区	zh-CN
vygu	招摇过市	zh-CN
vyii	止于唇齿	zh-CN
vyim	斩妖除魔	zh-CN
vyix	卓有成效	zh-CN
vyjn	专业技能	zh-CN
vyjq	中央集权	zh-CN
vykl	这样看来	zh-CN
vyls	正言厉色	zh-CN
vyly	专业领域	zh-CN
vymy	朝云暮雨	zh-CN
vyne	忠言逆耳	zh-CN
vyny	这样那样	zh-CN
vypy	只言片语	zh-CN
vysd	置于死地	zh-CN
vysm	庄严肃穆	zh-CN
vytu	重于泰山	zh-CN
vyuc	仗义疏财	zh-CN
vyul	这样说来	zh-CN
vyuq	智勇双全	zh-CN
vyuy	专业术语	zh-CN
vyvd	中庸之道	zh-CN
vyve	知遇之恩	zh-CN
vyvp	招摇撞骗	zh-CN
vyvu	忠于职守	zh-CN
vyvy	仗义执言	zh-CN
vywv	张牙舞爪	zh-CN
vyxn	知易行难	zh-CN
vyxq	这样下去	zh-CN
vyyh	中央银行	zh-CN
vyyl	这样一来	zh-CN
vyyr	珠圆玉润	zh-CN
vyyx	这样也行	zh-CN
vzbd	志在必得	zh-CN
vzbj	诸子百家	zh-CN
vzbt	只字不提	zh-CN
vzcy	重在参与	zh-CN
vzgy	志在高远	zh-CN
vzil	知足常乐	zh-CN
vzjm	纸醉金迷	zh-CN
vzql	志在千里	zh-CN
vzsf	志在四方	zh-CN
vzvj	逐字逐句	zh-CN
vzwt	只字未提	zh-CN
vzxe	止增笑耳	zh-CN
wbdt	文不对题	zh-CN
wbdy	万不得已	zh-CN
wbfr	我不犯人	zh-CN
wbgv	完璧归赵	zh-CN
wbly	威逼利诱	zh-CN
wbql	卧冰求鲤	zh-CN
wbuy	无病呻吟	zh-CN
wbvl	微薄之力	zh-CN
wbvm	无本之木	zh-CN
wbwj	无边无际	zh-CN
wbwn	万般无奈	zh-CN
wbxv	未卜先知	zh-CN
wbyu	无补于事	zh-CN
wbzd	微不足道	zh-CN
wbzi	卧病在床	zh-CN
wbzx	五笔字型	zh-CN
wcbf	五彩缤纷	zh-CN
wcbl	五彩斑斓	zh-CN
wctq	无从谈起	zh-CN
wcuj	唯才是举	zh-CN
wcuq	稳操胜券	zh-CN
wcxu	无从下手	zh-CN
wcxz	无从选择	zh-CN
wdbd	尾大不掉	zh-CN
wddy	围点打援	zh-CN
wdfu	无的放矢	zh-CN
wdjq	五毒俱全	zh-CN
wdlt	王道乐土	zh-CN
wdml	危地马拉	zh-CN
wdnq	舞刀弄枪	zh-CN
wdsc	五大三粗	zh-CN
wdub	无胆鼠辈	zh-CN
wdvt	未定之天	zh-CN
wdvv	歪打正着	zh-CN
wdwv	误打误撞	zh-CN
wdym	问道于盲	zh-CN
wdyo	无独有偶	zh-CN
wdyv	无动于衷	zh-CN
wdzr	无地自容	zh-CN
webz	无恶不作	zh-CN
wefy	忘恩负义	zh-CN
weqb	望而却步	zh-CN
weuw	望而生畏	zh-CN
wevy	万恶之源	zh-CN
wfbj	违法必究	zh-CN
wfbm	威风八面	zh-CN
wfbr	为富不仁	zh-CN
wfed	闻风而动	zh-CN
wfet	望风而逃	zh-CN
wfgx	万分感谢	zh-CN
wfjy	万分景仰	zh-CN
wflj	违法乱纪	zh-CN
wfll	威风凛凛	zh-CN
wflm	五福临门	zh-CN
wfpm	望风披靡	zh-CN
wfqj	无法企及	zh-CN
wfql	无风起浪	zh-CN
wfsb	文房四宝	zh-CN
wfsd	闻风丧胆	zh-CN
wfsf	微服私访	zh-CN
wfvy	万分之一	zh-CN
wfwh	无法挽回	zh-CN
wfwt	无法无天	zh-CN
wfxj	枉费心机	zh-CN
wfxq	歪风邪气	zh-CN
wfxu	无福消受	zh-CN
wfzb	无法自拔	zh-CN
wfzd	为非作歹	zh-CN
wfzy	无副作用	zh-CN
wgbf	五谷不分	zh-CN
wgbh	顽固不化	zh-CN
wgdi	王公大臣	zh-CN
wgdj	无关大局	zh-CN
wgef	无功而返	zh-CN
wget	无功而退	zh-CN
wgev	无果而终	zh-CN
wgfd	五谷丰登	zh-CN
wggz	王公贵族	zh-CN
wgic	万古长存	zh-CN
wgiq	万古长青	zh-CN
wgjc	万贯家财	zh-CN
wgjq	为国捐躯	zh-CN
wgjy	无关紧要	zh-CN
wglf	万古流芳	zh-CN
wgli	万国来朝	zh-CN
wglz	歪瓜裂枣	zh-CN
wgqq	万古千秋	zh-CN
wgty	无关痛痒	zh-CN
wguf	文过饰非	zh-CN
wgul	无功受禄	zh-CN
wgus	五光十色	zh-CN
wgvx	温故知新	zh-CN
wgwm	为国为民	zh-CN
wgwx	外国文学	zh-CN
wgyv	物归原主	zh-CN
wgzl	五谷杂粮	zh-CN
wgzx	闻过则喜	zh-CN
whaz	呜呼哀哉	zh-CN
whbm	五花八门	zh-CN
whbt	无话不谈	zh-CN
whcl	卧虎藏龙	zh-CN
whdb	五花大绑	zh-CN
whdx	武汉大学	zh-CN
whib	外汇储备	zh-CN
whid	文化程度	zh-CN
whjx	王侯将相	zh-CN
whku	无话可说	zh-CN
whqw	微乎其微	zh-CN
whqy	万壑千岩	zh-CN
whsh	五湖四海	zh-CN
whsy	忘乎所以	zh-CN
whtb	物华天宝	zh-CN
whvu	玩忽职守	zh-CN
whvv	乌合之众	zh-CN
whws	完好无损	zh-CN
whxy	未婚先孕	zh-CN
whzf	玩火自焚	zh-CN
wiaz	龌龊腌臜	zh-CN
wibk	未尝不可	zh-CN
wibq	卧床不起	zh-CN
wibz	无处不在	zh-CN
wicu	无处藏身	zh-CN
wijj	无产阶级	zh-CN
wikq	无处可去	zh-CN
wimj	望尘莫及	zh-CN
winr	未成年人	zh-CN
wiqu	望穿秋水	zh-CN
wiqy	无出其右	zh-CN
wivt	无耻之徒	zh-CN
wivy	无耻之尤	zh-CN
wiwd	问长问短	zh-CN
wiyp	维持原判	zh-CN
wjbb	晚节不保	zh-CN
wjbf	物极必反	zh-CN
wjbx	瓦解冰消	zh-CN
wjdh	万家灯火	zh-CN
wjev	无疾而终	zh-CN
wjgt	危急关头	zh-CN
wjix	万箭穿心	zh-CN
wjkg	无家可归	zh-CN
wjki	无机可乘	zh-CN
wjku	无计可施	zh-CN
wjqw	闻鸡起舞	zh-CN
wjqy	物尽其用	zh-CN
wjri	位极人臣	zh-CN
wjsf	危机四伏	zh-CN
wjuy	未尽事宜	zh-CN
wjvb	无价之宝	zh-CN
wjvj	刎颈之交	zh-CN
wjvt	无稽之谈	zh-CN
wjyl	我见犹怜	zh-CN
wjyu	无济于事	zh-CN
wjzx	万箭攒心	zh-CN
wkbb	无可辩驳	zh-CN
wkbj	唯恐不及	zh-CN
wkbn	无可比拟	zh-CN
wkbr	无孔不入	zh-CN
wkfg	无可奉告	zh-CN
wkhf	无可厚非	zh-CN
wkjy	无可救药	zh-CN
wkkj	无可抗拒	zh-CN
wkmv	无可名状	zh-CN
wknh	无可奈何	zh-CN
wktd	无可替代	zh-CN
wktt	无可挑剔	zh-CN
wkvb	无可争辩	zh-CN
wkvy	无可置疑	zh-CN
wkvz	无可指责	zh-CN
wkwh	无可挽回	zh-CN
wkxl	无可限量	zh-CN
wkxs	挖空心思	zh-CN
wkym	网开一面	zh-CN
wkzd	纨绔子弟	zh-CN
wlbt	乌兰巴托	zh-CN
wlbz	为老不尊	zh-CN
wlgj	温良恭俭	zh-CN
wlhd	五雷轰顶	zh-CN
wlht	无力回天	zh-CN
wlii	万里长城	zh-CN
wljj	万籁俱寂	zh-CN
wljr	无脸见人	zh-CN
wlkh	雾里看花	zh-CN
wlkt	无路可退	zh-CN
wlkz	无路可走	zh-CN
wlmq	乌鲁木齐	zh-CN
wlqn	无理取闹	zh-CN
wlqs	万缕千丝	zh-CN
wlrh	无论如何	zh-CN
wltd	无聊透顶	zh-CN
wlty	万里挑一	zh-CN
wlut	唯利是图	zh-CN
wlwv	五里雾中	zh-CN
wlwy	万里无云	zh-CN
wlxb	位列仙班	zh-CN
wlxg	物离乡贵	zh-CN
wlxj	物理学家	zh-CN
wlxu	未老先衰	zh-CN
wmbt	万马奔腾	zh-CN
wmbv	萎靡不振	zh-CN
wmdr	妩媚动人	zh-CN
wmfu	五马分尸	zh-CN
wmih	为民除害	zh-CN
wmiz	蛙鸣蝉噪	zh-CN
wmjl	物美价廉	zh-CN
wmlm	文明礼貌	zh-CN
wmqm	为民请命	zh-CN
wmqv	寤寐求之	zh-CN
wmqy	万马齐喑	zh-CN
wmty	亡命天涯	zh-CN
wmuc	唯命是从	zh-CN
wmuh	文明社会	zh-CN
wmvb	无名之辈	zh-CN
wmvi	无米之炊	zh-CN
wmvk	望梅止渴	zh-CN
wmvr	万木争荣	zh-CN
wmvt	亡命之徒	zh-CN
wmvw	无冕之王	zh-CN
wmwq	完美无缺	zh-CN
wmwx	惟妙惟肖	zh-CN
wmxb	无名小辈	zh-CN
wmxd	歪门邪道	zh-CN
wmxe	闻名遐迩	zh-CN
wmxz	无名小卒	zh-CN
wnat	瓦努阿图	zh-CN
wnjh	万念俱灰	zh-CN
wnms	未能免俗	zh-CN
wnqx	畏难情绪	zh-CN
wnrf	五内如焚	zh-CN
wnrl	委内瑞拉	zh-CN
wnry	吴侬软语	zh-CN
wnvb	无能之辈	zh-CN
wnvj	忘年之交	zh-CN
wnvu	污泥浊水	zh-CN
wnvx	无奈之下	zh-CN
wnwl	无能为力	zh-CN
wpmg	王婆卖瓜	zh-CN
wpwj	无凭无据	zh-CN
wqb	为期不远	zh-CN
wqbt	完全不同	zh-CN
wqby	无奇不有	zh-CN
wqbz	乌七八糟	zh-CN
wqgw	无权过问	zh-CN
wqmm	温情脉脉	zh-CN
wqqq	委曲求全	zh-CN
wqsk	为情所困	zh-CN
wqsy	忘其所以	zh-CN
wqtx	无期徒刑	zh-CN
wqvc	万全之策	zh-CN
wqvg	外强中干	zh-CN
wqwg	无牵无挂	zh-CN
wqwj	无穷无尽	zh-CN
wqwu	无权无势	zh-CN
wqwy	无情无义	zh-CN
wqxb	望其项背	zh-CN
wrbd	巍然不动	zh-CN
wrbh	无肉不欢	zh-CN
wrbi	剜肉补疮	zh-CN
wrgw	无人过问	zh-CN
wrif	蔚然成风	zh-CN
wriu	为人处世	zh-CN
wrkx	万人空巷	zh-CN
wrlc	无人理睬	zh-CN
wrll	危如累卵	zh-CN
wrmk	文人墨客	zh-CN
wrng	外柔内刚	zh-CN
wrnj	无人能及	zh-CN
wrpu	稳如磐石	zh-CN
wrqr	文如其人	zh-CN
wrqt	误入歧途	zh-CN
wrru	惘然若失	zh-CN
wrry	温润如玉	zh-CN
wrtu	稳如泰山	zh-CN
wrub	为人师表	zh-CN
wrux	为人说项	zh-CN
wrvu	万人之上	zh-CN
wrvx	无人知晓	zh-CN
wrwj	无人问津	zh-CN
wrxq	文人相轻	zh-CN
wryl	巍然屹立	zh-CN
wrzd	误人子弟	zh-CN
wrzj	为人作嫁	zh-CN
wsbb	无所不包	zh-CN
wsbc	万死不辞	zh-CN
wsbd	纹丝不动	zh-CN
wsbl	五色斑斓	zh-CN
wsbn	无所不能	zh-CN
wsbq	畏缩不前	zh-CN
wsbt	无所不通	zh-CN
wsbw	无所不为	zh-CN
wsby	无所不有	zh-CN
wsbz	无所不在	zh-CN
wsdx	无所遁形	zh-CN
wsgj	无所顾忌	zh-CN
wsqy	文思泉涌	zh-CN
wsuc	无所适从	zh-CN
wsuu	无所事事	zh-CN
wswj	无所畏惧	zh-CN
wsww	闻所未闻	zh-CN
wsyw	为所欲为	zh-CN
wsyx	无所用心	zh-CN
wsyy	我所欲也	zh-CN
wszw	无所作为	zh-CN
wtcd	万头攒动	zh-CN
wtcy	无头苍蝇	zh-CN
wtjl	味同嚼蜡	zh-CN
wttd	五体投地	zh-CN
wtvu	卧榻之上	zh-CN
wtwl	文韬武略	zh-CN
wubg	玩世不恭	zh-CN
wubw	为时不晚	zh-CN
wudj	万事大吉	zh-CN
wudy	无伤大雅	zh-CN
wujb	万事俱备	zh-CN
wulf	万世流芳	zh-CN
wuql	物伤其类	zh-CN
wurf	物是人非	zh-CN
wury	万事如意	zh-CN
wuub	万世师表	zh-CN
wuue	唯手熟尔	zh-CN
wuuz	为时尚早	zh-CN
wuvd	为数众多	zh-CN
wuwx	无声无息	zh-CN
wuxy	温室效应	zh-CN
wuyw	为时已晚	zh-CN
wuzt	无师自通	zh-CN
wvbb	文质彬彬	zh-CN
wvdj	围追堵截	zh-CN
wvdr	为之动容	zh-CN
wvju	无证驾驶	zh-CN
wvjy	无照经营	zh-CN
wvqd	万众期待	zh-CN
wvqj	稳中求进	zh-CN
wvuy	无中生有	zh-CN
wvvb	瓮中捉鳖	zh-CN
wvvd	文绉绉的	zh-CN
wvwd	稳扎稳打	zh-CN
wvwg	文治武功	zh-CN
wvwq	完整无缺	zh-CN
wvwv	玩着玩着	zh-CN
wvwy	万中无一	zh-CN
wvyu	稳中有升	zh-CN
wvyv	为之一振	zh-CN
wvyx	万众一心	zh-CN
wvzj	闻者足戒	zh-CN
wwbl	无往不利	zh-CN
wwbq	威武不屈	zh-CN
wwbv	无微不至	zh-CN
wwdd	稳稳当当	zh-CN
wwdl	娓娓道来	zh-CN
wwdt	娓娓动听	zh-CN
wwdx	未完待续	zh-CN
wwdz	唯我独尊	zh-CN
wwet	娓娓而谈	zh-CN
wwev	无为而治	zh-CN
wwey	温文尔雅	zh-CN
wwez	维吾尔族	zh-CN
wwjj	文文静静	zh-CN
wwjq	五味俱全	zh-CN
wwjv	围魏救赵	zh-CN
wwnm	舞文弄墨	zh-CN
wwnn	唯唯诺诺	zh-CN
wwqn	兀兀穷年	zh-CN
wwqq	完完全全	zh-CN
wwsy	为我所用	zh-CN
wwuq	文武双全	zh-CN
wwuy	望文生义	zh-CN
wwvd	文武之道	zh-CN
wwvg	蔚为壮观	zh-CN
wwvv	完完整整	zh-CN
wwvz	无妄之灾	zh-CN
wwwq	望闻问切	zh-CN
wwxx	歪歪斜斜	zh-CN
wwzx	嗡嗡作响	zh-CN
wxbf	戊戌变法	zh-CN
wxdu	无需多说	zh-CN
wxfu	无暇分身	zh-CN
wxgj	无暇顾及	zh-CN
wxgx	万象更新	zh-CN
wxhq	五星红旗	zh-CN
wxid	卧薪尝胆	zh-CN
wxjg	无暇兼顾	zh-CN
wxki	无隙可乘	zh-CN
wxkj	无懈可击	zh-CN
wxly	威胁利诱	zh-CN
wxnb	蜗行牛步	zh-CN
wxsd	威信扫地	zh-CN
wxvu	无心之失	zh-CN
wxvy	唯心主义	zh-CN
wxwk	问心无愧	zh-CN
wxws	我行我素	zh-CN
wxwv	无休无止	zh-CN
wxzi	无形资产	zh-CN
wybl	亡羊补牢	zh-CN
wybq	五音不全	zh-CN
wybv	无一不知	zh-CN
wydy	微言大义	zh-CN
wyfj	无以复加	zh-CN
wyh	毋庸讳言	zh-CN
wyhy	污言秽语	zh-CN
wyim	未雨绸缪	zh-CN
wykj	无药可救	zh-CN
wylb	无与伦比	zh-CN
wyld	万应灵丹	zh-CN
wylj	物以类聚	zh-CN
wyls	五颜六色	zh-CN
wylw	无一例外	zh-CN
wymb	乌云密布	zh-CN
wynf	外圆内方	zh-CN
wyny	无语凝噎	zh-CN
wyql	沃野千里	zh-CN
wyqv	蜿蜒曲折	zh-CN
wyry	无业人员	zh-CN
wyst	危言耸听	zh-CN
wyve	闻一知二	zh-CN
wyvq	乌烟瘴气	zh-CN
wyvu	无源之水	zh-CN
wyvv	无意之中	zh-CN
wyvy	毋庸置疑	zh-CN
wywb	无以为报	zh-CN
wywg	无缘无故	zh-CN
wywh	无怨无悔	zh-CN
wywi	无冤无仇	zh-CN
wywj	无以为继	zh-CN
wywk	无依无靠	zh-CN
wywl	无忧无虑	zh-CN
wywz	无影无踪	zh-CN
wyxj	婉言谢绝	zh-CN
wyxm	无一幸免	zh-CN
wyxt	望洋兴叹	zh-CN
wyyc	唯一一次	zh-CN
wyyd	无言以对	zh-CN
wyyg	唯一一个	zh-CN
wyyi	望眼欲穿	zh-CN
wyyj	我意已决	zh-CN
wyyl	万有引力	zh-CN
wyym	无业游民	zh-CN
wyzd	文以载道	zh-CN
wyzg	无欲则刚	zh-CN
wzbk	乌兹别克	zh-CN
wzdx	危在旦夕	zh-CN
wzfb	妄自菲薄	zh-CN
wzil	望子成龙	zh-CN
wzjm	无则加勉	zh-CN
wzjq	五脏俱全	zh-CN
wzlf	五脏六腑	zh-CN
wzqh	万紫千红	zh-CN
wzqv	无足轻重	zh-CN
wzqy	外资企业	zh-CN
wztu	无字天书	zh-CN
wzyx	文字游戏	zh-CN
wzzd	妄自尊大	zh-CN
wzzu	畏罪自杀	zh-CN
xajd	西安交大	zh-CN
xajh	笑傲江湖	zh-CN
xald	心安理得	zh-CN
xawu	相安无事	zh-CN
xbdb	想不到吧	zh-CN
xbdv	喧宾夺主	zh-CN
xbil	想不出来	zh-CN
xblt	下不来台	zh-CN
xbly	西伯利亚	zh-CN
xbql	想不起来	zh-CN
xbqy	下笔千言	zh-CN
xbrm	幸不辱命	zh-CN
xbty	信笔涂鸦	zh-CN
xbuy	小本生意	zh-CN
xbvd	下不着地	zh-CN
xbvx	相比之下	zh-CN
xbwl	下不为例	zh-CN
xbxg	习不习惯	zh-CN
xbxh	喜不喜欢	zh-CN
xbxy	需不需要	zh-CN
xbyv	邪不压正	zh-CN
xbyy	瑕不掩瑜	zh-CN
xbzj	喜不自禁	zh-CN
xbzu	喜不自胜	zh-CN
xbzy	心不在焉	zh-CN
xcdl	雄才大略	zh-CN
xcgj	心存感激	zh-CN
xcjd	心存芥蒂	zh-CN
xcjw	心存敬畏	zh-CN
xcjx	心存侥幸	zh-CN
xctj	喜从天降	zh-CN
xcur	心慈手软	zh-CN
xcyd	小菜一碟	zh-CN
xcyl	心存疑虑	zh-CN
xdbc	相当不错	zh-CN
xddy	笑掉大牙	zh-CN
xdey	相对而言	zh-CN
xdez	席地而坐	zh-CN
xdif	下得厨房	zh-CN
xdji	小肚鸡肠	zh-CN
xdjl	心胆俱裂	zh-CN
xdjm	兄弟姐妹	zh-CN
xdju	凶多吉少	zh-CN
xdjx	下定决心	zh-CN
xdkg	相当可观	zh-CN
xdkn	相当困难	zh-CN
xdlq	下大力气	zh-CN
xdmf	相当麻烦	zh-CN
xdmu	闲的没事	zh-CN
xdnh	虚度年华	zh-CN
xdry	相当容易	zh-CN
xdul	心地善良	zh-CN
xdum	心荡神迷	zh-CN
xdwk	先睹为快	zh-CN
xdwl	闲得无聊	zh-CN
xdwn	胸大无脑	zh-CN
xdwx	现代文学	zh-CN
xdxn	小打小闹	zh-CN
xdxq	兄弟阋墙	zh-CN
xdxx	小道消息	zh-CN
xdyv	形单影只	zh-CN
xeby	笑而不语	zh-CN
xegt	洗耳恭听	zh-CN
xemb	小儿麻痹	zh-CN
xeux	形而上学	zh-CN
xewj	悬而未决	zh-CN
xexh	小恩小惠	zh-CN
xeyj	显而易见	zh-CN
xeyx	玄而又玄	zh-CN
xfcy	晓风残月	zh-CN
xfdg	仙风道骨	zh-CN
xfdh	心腹大患	zh-CN
xfja	小富即安	zh-CN
xfjz	相夫教子	zh-CN
xfkf	心服口服	zh-CN
xfqz	心浮气躁	zh-CN
xfsy	学非所用	zh-CN
xfuf	想方设法	zh-CN
xfvh	心腹之患	zh-CN
xfvr	先发制人	zh-CN
xfwi	学富五车	zh-CN
xfxi	相辅相成	zh-CN
xfxy	腥风血雨	zh-CN
xfyl	心烦意乱	zh-CN
xfzl	兴风作浪	zh-CN
xgbs	吓个半死	zh-CN
xgcl	兴高采烈	zh-CN
xgcs	萧规曹随	zh-CN
xgdi	小姑独处	zh-CN
xgdj	循规蹈矩	zh-CN
xgdx	香港大学	zh-CN
xggm	小国寡民	zh-CN
xggz	相关工作	zh-CN
xgjd	寻根究底	zh-CN
xgll	香格里拉	zh-CN
xgqa	心高气傲	zh-CN
xgqy	心甘情愿	zh-CN
xgry	相关人员	zh-CN
xguj	下个世纪	zh-CN
xgur	新官上任	zh-CN
xgvx	学贯中西	zh-CN
xgwd	寻根问底	zh-CN
xgxh	形槁心灰	zh-CN
xgxq	下个星期	zh-CN
xgyd	侠肝义胆	zh-CN
xgzy	小鬼遭殃	zh-CN
xhbg	心怀不轨	zh-CN
xhbi	笑话百出	zh-CN
xhbx	纤毫毕现	zh-CN
xhdb	血红蛋白	zh-CN
xhdp	销魂夺魄	zh-CN
xhdv	胸怀大志	zh-CN
xhfj	下回分解	zh-CN
xhgt	心怀鬼胎	zh-CN
xhjh	新欢旧好	zh-CN
xhju	悬壶济世	zh-CN
xhnf	心花怒放	zh-CN
xhpc	心怀叵测	zh-CN
xhrg	虚怀若谷	zh-CN
xhug	销魂蚀骨	zh-CN
xhuh	行贿受贿	zh-CN
xhui	血海深仇	zh-CN
xhul	心狠手辣	zh-CN
xhup	小鹤双拼	zh-CN
xhuu	闲话少说	zh-CN
xhvt	绣花枕头	zh-CN
xhwf	循环往复	zh-CN
xhwl	寻花问柳	zh-CN
xhwn	嘘寒问暖	zh-CN
xhwu	悬壶问世	zh-CN
xhwv	学会为止	zh-CN
xhwy	学海无涯	zh-CN
xhxi	薪火相传	zh-CN
xhxt	循环系统	zh-CN
xhyc	闲花野草	zh-CN
xhye	新婚燕尔	zh-CN
xhyl	心灰意冷	zh-CN
xhyq	虚晃一枪	zh-CN
xhyu	显赫一时	zh-CN
xhyv	心回意转	zh-CN
xhyx	小鹤音形	zh-CN
xhzd	新华字典	zh-CN
xhzl	寻欢作乐	zh-CN
xibr	纤尘不染	zh-CN
xijh	新仇旧恨	zh-CN
xijj	新春佳节	zh-CN
xipp	心潮澎湃	zh-CN
xitc	行差踏错	zh-CN
xiuw	心驰神往	zh-CN
xivg	修成正果	zh-CN
xiys	行成于思	zh-CN
xiyx	响彻云霄	zh-CN
xizl	心诚则灵	zh-CN
xjbb	血迹斑斑	zh-CN
xjbf	想尽办法	zh-CN
xjbg	星级宾馆	zh-CN
xjbi	相交不拆	zh-CN
xjby	小家碧玉	zh-CN
xjdg	消极怠工	zh-CN
xjdv	心惊胆战	zh-CN
xjeq	喜极而泣	zh-CN
xjhi	薪尽火传	zh-CN
xjhj	相煎何急	zh-CN
xjhl	心急火燎	zh-CN
xjhw	相见恨晚	zh-CN
xjix	相继出现	zh-CN
xjjd	星级酒店	zh-CN
xjjm	行将就木	zh-CN
xjky	形迹可疑	zh-CN
xjly	喜结良缘	zh-CN
xjmy	细嚼慢咽	zh-CN
xjqh	洗尽铅华	zh-CN
xjrb	相敬如宾	zh-CN
xjrf	心急如焚	zh-CN
xjrt	心惊肉跳	zh-CN
xjtj	先决条件	zh-CN
xjtr	学究天人	zh-CN
xjvm	先见之明	zh-CN
xjxc	献计献策	zh-CN
xjxu	相机行事	zh-CN
xjyi	虚惊一场	zh-CN
xjyk	洗劫一空	zh-CN
xjys	消极因素	zh-CN
xjzq	小家子气	zh-CN
xkch	信口雌黄	zh-CN
xkht	先苦后甜	zh-CN
xkkh	信口开河	zh-CN
xkpr	血口喷人	zh-CN
xkry	心口如一	zh-CN
xktp	心宽体胖	zh-CN
xkuy	心旷神怡	zh-CN
xlau	心理暗示	zh-CN
xlbm	下落不明	zh-CN
xlbr	下里巴人	zh-CN
xlcg	悬梁刺股	zh-CN
xlfd	心理负担	zh-CN
xlfx	心理分析	zh-CN
xlhb	先礼后兵	zh-CN
xlhd	先来后到	zh-CN
xlhl	稀里哗啦	zh-CN
xlht	稀里糊涂	zh-CN
xlib	兴利除弊	zh-CN
xljc	心力交瘁	zh-CN
xlli	心路历程	zh-CN
xllv	小鹿乱撞	zh-CN
xlnl	心理年龄	zh-CN
xlrm	心乱如麻	zh-CN
xlrw	熙来攘往	zh-CN
xluq	心灵手巧	zh-CN
xlva	心理障碍	zh-CN
xlvb	心理准备	zh-CN
xlwu	闲来无事	zh-CN
xlxf	狭路相逢	zh-CN
xlxj	心理学家	zh-CN
xlyl	心理压力	zh-CN
xlzx	心理咨询	zh-CN
xlzy	心理作用	zh-CN
xmdx	厦门大学	zh-CN
xmfv	血脉偾张	zh-CN
xmjg	性命交关	zh-CN
xmly	喜马拉雅	zh-CN
xmpp	相貌平平	zh-CN
xmtt	相貌堂堂	zh-CN
xmul	卸磨杀驴	zh-CN
xmwd	邪门歪道	zh-CN
xmxy	像模像样	zh-CN
xmyl	心明眼亮	zh-CN
xmyn	幸免于难	zh-CN
xnal	喜怒哀乐	zh-CN
xnbl	徐娘半老	zh-CN
xnkl	新年快乐	zh-CN
xnwi	喜怒无常	zh-CN
xnxg	心脑血管	zh-CN
xnxu	虚拟现实	zh-CN
xpaf	嫌贫爱富	zh-CN
xpnr	细皮嫩肉	zh-CN
xpqh	心平气和	zh-CN
xpxl	嬉皮笑脸	zh-CN
xqah	兴趣爱好	zh-CN
xqar	兴趣盎然	zh-CN
xqfg	血气方刚	zh-CN
xqgg	稀奇古怪	zh-CN
xqjy	虚情假意	zh-CN
xqll	小巧玲珑	zh-CN
xqud	下情上达	zh-CN
xquy	相去甚远	zh-CN
xqwj	相去无几	zh-CN
xqxa	相亲相爱	zh-CN
xqxg	休戚相关	zh-CN
xqyg	休戚与共	zh-CN
xqyv	闲情逸致	zh-CN
xqyy	喜气洋洋	zh-CN
xrbk	虚弱不堪	zh-CN
xrdb	轩然大波	zh-CN
xrdg	心如刀割	zh-CN
xrdv	小人得志	zh-CN
xrff	想入非非	zh-CN
xrhf	血肉横飞	zh-CN
xrhj	先人后己	zh-CN
xrkg	形容枯槁	zh-CN
xrkj	笑容可掬	zh-CN
xrsh	心如死灰	zh-CN
xrtu	心如铁石	zh-CN
xrvj	小人之见	zh-CN
xrvq	血肉之躯	zh-CN
xrvu	心如止水	zh-CN
xrvx	小人之心	zh-CN
xrwv	先入为主	zh-CN
xrym	相濡以沫	zh-CN
xscc	行色匆匆	zh-CN
xsdl	歇斯底里	zh-CN
xseu	向死而生	zh-CN
xskc	秀色可餐	zh-CN
xsmh	寻死觅活	zh-CN
xspi	稀松平常	zh-CN
xswb	徇私舞弊	zh-CN
xswf	徇私枉法	zh-CN
xswl	吓死我了	zh-CN
xtbl	相提并论	zh-CN
xtbz	先天不足	zh-CN
xtdz	小题大做	zh-CN
xtml	形同陌路	zh-CN
xtrn	削铁如泥	zh-CN
xtxb	闲庭信步	zh-CN
xtxd	谢天谢地	zh-CN
xtxm	小偷小摸	zh-CN
xtxu	形同虚设	zh-CN
xtzb	悉听尊便	zh-CN
xtzz	小兔崽子	zh-CN
xuaj	刑事案件	zh-CN
xuba	心神不安	zh-CN
xubd	心神不定	zh-CN
xubg	学术报告	zh-CN
xubn	西双版纳	zh-CN
xubr	形势逼人	zh-CN
xubv	心术不正	zh-CN
xudd	信誓旦旦	zh-CN
xudf	蓄势待发	zh-CN
xudr	先声夺人	zh-CN
xudv	兴师动众	zh-CN
xueu	凶神恶煞	zh-CN
xuex	相视而笑	zh-CN
xufm	小试锋芒	zh-CN
xuhl	小事化了	zh-CN
xuib	兴衰成败	zh-CN
xuii	心事重重	zh-CN
xuil	细水长流	zh-CN
xujb	形神兼备	zh-CN
xujd	行善积德	zh-CN
xujl	学术交流	zh-CN
xuju	雪上加霜	zh-CN
xulu	显山露水	zh-CN
xulw	学术论文	zh-CN
xunj	销声匿迹	zh-CN
xunl	信手拈来	zh-CN
xunr	息事宁人	zh-CN
xupg	袖手旁观	zh-CN
xuqd	西沙群岛	zh-CN
xuqg	仙山琼阁	zh-CN
xusu	学生宿舍	zh-CN
xuuf	现身说法	zh-CN
xuup	欣赏水平	zh-CN
xuvy	形式主义	zh-CN
xuwt	现实问题	zh-CN
xuwz	兴师问罪	zh-CN
xuxj	小手小脚	zh-CN
xuxk	相生相克	zh-CN
xuxq	细声细气	zh-CN
xuxw	学士学位	zh-CN
xuyv	小事一桩	zh-CN
xuyy	现实意义	zh-CN
xuzr	行尸走肉	zh-CN
xvbb	兴致勃勃	zh-CN
xvbm	行政部门	zh-CN
xvbx	心照不宣	zh-CN
xvdm	心知肚明	zh-CN
xvdw	行政单位	zh-CN
xvgl	西装革履	zh-CN
xvhw	相知恨晚	zh-CN
xvhz	先斩后奏	zh-CN
xvjd	小中见大	zh-CN
xvjg	行政机关	zh-CN
xvkk	心直口快	zh-CN
xvll	血债累累	zh-CN
xvmj	细枝末节	zh-CN
xvmu	闲着没事	zh-CN
xvqh	行政区划	zh-CN
xvqu	险中求胜	zh-CN
xvrw	细致入微	zh-CN
xvst	雪中送炭	zh-CN
xvtg	显著提高	zh-CN
xvuu	虚张声势	zh-CN
xvvj	寻章摘句	zh-CN
xvwj	项庄舞剑	zh-CN
xvwm	削职为民	zh-CN
xvwu	心中无数	zh-CN
xvxh	血债血还	zh-CN
xvxj	先知先觉	zh-CN
xvyk	笑逐颜开	zh-CN
xvyl	晓之以理	zh-CN
xvyn	行之有年	zh-CN
xvyu	心中有数	zh-CN
xvyx	行之有效	zh-CN
xvyy	象征意义	zh-CN
xwdm	胸无点墨	zh-CN
xwdv	胸无大志	zh-CN
xwey	心无二用	zh-CN
xwfd	兴旺发达	zh-CN
xwhv	秀外慧中	zh-CN
xwif	胸无城府	zh-CN
xwlb	新闻联播	zh-CN
xwlj	喜闻乐见	zh-CN
xwll	行万里路	zh-CN
xwmj	细微末节	zh-CN
xwpm	虚无缥缈	zh-CN
xwpw	心无旁骛	zh-CN
xwrv	鲜为人知	zh-CN
xwsr	兴味索然	zh-CN
xwuj	县委书记	zh-CN
xwvj	学无止境	zh-CN
xwvy	弦外之音	zh-CN
xwxs	衔尾相随	zh-CN
xwyd	虚位以待	zh-CN
xwyt	吓我一跳	zh-CN
xwzn	心无杂念	zh-CN
xxbb	雄心勃勃	zh-CN
xxbg	刑讯逼供	zh-CN
xxbl	凶相毕露	zh-CN
xxby	唏嘘不已	zh-CN
xxdd	许许多多	zh-CN
xxdh	熊熊大火	zh-CN
xxff	学习方法	zh-CN
xxgm	洗心革面	zh-CN
xxhh	嘻嘻哈哈	zh-CN
xxij	学习成绩	zh-CN
xxjj	循序渐进	zh-CN
xxkk	辛辛苦苦	zh-CN
xxlh	熊熊烈火	zh-CN
xxli	心血来潮	zh-CN
xxll	淅淅沥沥	zh-CN
xxlt	消息灵通	zh-CN
xxnl	学习能力	zh-CN
xxnm	嬉笑怒骂	zh-CN
xxrk	欣喜若狂	zh-CN
xxrn	选贤任能	zh-CN
xxrr	熙熙攘攘	zh-CN
xxru	栩栩如生	zh-CN
xxss	形形色色	zh-CN
xxui	心想事成	zh-CN
xxuy	循循善诱	zh-CN
xxvh	星星之火	zh-CN
xxvy	行侠仗义	zh-CN
xxwv	心向往之	zh-CN
xxwz	象形文字	zh-CN
xxxg	息息相关	zh-CN
xxxr	欣欣向荣	zh-CN
xxxv	心胸狭窄	zh-CN
xxxx	惺惺相惜	zh-CN
xxyd	虚席以待	zh-CN
xxyj	喜新厌旧	zh-CN
xxyk	喜笑颜开	zh-CN
xxys	喜形于色	zh-CN
xxyx	休息一下	zh-CN
xxyy	小心翼翼	zh-CN
xxzl	学习资料	zh-CN
xxzt	惺惺作态	zh-CN
xybg	心有不甘	zh-CN
xybl	形影不离	zh-CN
xydg	兄友弟恭	zh-CN
xydm	鲜艳夺目	zh-CN
xyeq	向隅而泣	zh-CN
xyfm	降妖伏魔	zh-CN
xyfw	逍遥法外	zh-CN
xygx	血缘关系	zh-CN
xyif	心悦诚服	zh-CN
xyim	降妖除魔	zh-CN
xyiq	相映成趣	zh-CN
xyiv	胸有成竹	zh-CN
xyix	相沿成习	zh-CN
xyiy	夕阳产业	zh-CN
xyjb	悬崖绝壁	zh-CN
xylu	行云流水	zh-CN
xylx	心有灵犀	zh-CN
xymm	硝烟弥漫	zh-CN
xynn	心痒难挠	zh-CN
xypp	汹涌澎湃	zh-CN
xypv	稀有品种	zh-CN
xysy	闲言碎语	zh-CN
xyud	下意识的	zh-CN
xyuv	骁勇善战	zh-CN
xyux	休养生息	zh-CN
xyvt	象牙之塔	zh-CN
xyvy	学以致用	zh-CN
xywi	习以为常	zh-CN
xywm	相依为命	zh-CN
xywv	信以为真	zh-CN
xyww	羞与为伍	zh-CN
xywy	虚与委蛇	zh-CN
xyxd	形影相吊	zh-CN
xyxf	血雨腥风	zh-CN
xyxs	形影相随	zh-CN
xyxx	夕阳西下	zh-CN
xyxy	闲言闲语	zh-CN
xyyh	闲云野鹤	zh-CN
xyym	心猿意马	zh-CN
xyyq	吸引眼球	zh-CN
xyzg	兴妖作怪	zh-CN
xyzz	逍遥自在	zh-CN
xzbd	行踪不定	zh-CN
xzkl	现在看来	zh-CN
xzlh	幸灾乐祸	zh-CN
xzlu	现在来说	zh-CN
xzmj	寻踪觅迹	zh-CN
xzmx	瞎子摸象	zh-CN
xzrd	闲杂人等	zh-CN
xzrj	惜字如金	zh-CN
xzul	削足适履	zh-CN
xzum	心醉神迷	zh-CN
xzxs	孝子贤孙	zh-CN
xzyf	雄姿英发	zh-CN
yagv	有碍观瞻	zh-CN
yaki	有案可查	zh-CN
yauh	因爱生恨	zh-CN
yayh	又爱又恨	zh-CN
ybbh	夜不闭户	zh-CN
ybbq	一病不起	zh-CN
ybbt	衣不蔽体	zh-CN
ybdt	一步登天	zh-CN
ybdw	一步到位	zh-CN
ybeg	掩鼻而过	zh-CN
ybey	一般而言	zh-CN
ybfq	月白风清	zh-CN
ybfr	一部分人	zh-CN
ybgs	夜不归宿	zh-CN
ybgx	一笔勾销	zh-CN
ybhm	烟波浩渺	zh-CN
ybim	夜不成寐	zh-CN
ybjl	由表及里	zh-CN
ybjy	言不及义	zh-CN
ybkj	遥不可及	zh-CN
yblu	一不留神	zh-CN
yblw	也不例外	zh-CN
ybnm	夜不能寐	zh-CN
ybnu	也不能说	zh-CN
ybqr	养兵千日	zh-CN
ybrc	义不容辞	zh-CN
ybrm	原班人马	zh-CN
ybry	也不容易	zh-CN
ybsg	夜半三更	zh-CN
ybsv	一波三折	zh-CN
ybtd	一败涂地	zh-CN
ybtt	仪表堂堂	zh-CN
ybuw	也不失为	zh-CN
ybvb	以暴制暴	zh-CN
ybvd	也不知道	zh-CN
ybvj	一本正经	zh-CN
ybvl	一臂之力	zh-CN
ybvy	也不至于	zh-CN
ybwe	一般无二	zh-CN
ybwh	有备无患	zh-CN
ybwl	一本万利	zh-CN
ybwp	一波未平	zh-CN
ybxv	鹬蚌相争	zh-CN
ybxx	一不小心	zh-CN
ybyb	一步一步	zh-CN
ybyd	也不一定	zh-CN
ybyg	也不应该	zh-CN
ybyq	亦步亦趋	zh-CN
ybyv	言不由衷	zh-CN
ybyy	愿不愿意	zh-CN
ybzb	一败再败	zh-CN
ybzh	一鼻子灰	zh-CN
ycdf	阴曹地府	zh-CN
ycdz	以词定字	zh-CN
ycej	一蹴而就	zh-CN
ycel	由此而来	zh-CN
ycfi	异彩纷呈	zh-CN
ycjg	有错就改	zh-CN
yckl	由此看来	zh-CN
yckv	由此可知	zh-CN
yclt	以此类推	zh-CN
yctu	与此同时	zh-CN
ycuj	因材施教	zh-CN
ycwr	以此为荣	zh-CN
ycwv	以此为准	zh-CN
ycyg	与此有关	zh-CN
ycyi	阴错阳差	zh-CN
ycym	一草一木	zh-CN
ycyq	淫词艳曲	zh-CN
yczc	一错再错	zh-CN
ydar	印第安人	zh-CN
ydbd	一动不动	zh-CN
ydbi	药到病除	zh-CN
ydbu	言多必失	zh-CN
ydby	以德报怨	zh-CN
ydcr	应对从容	zh-CN
yddm	以点带面	zh-CN
ydei	易地而处	zh-CN
ydel	远道而来	zh-CN
ydfi	雨打风吹	zh-CN
ydfl	一代风流	zh-CN
ydfq	云淡风轻	zh-CN
ydfr	以德服人	zh-CN
ydfu	有的放矢	zh-CN
ydfw	一定范围	zh-CN
ydgd	以毒攻毒	zh-CN
ydhl	移动互联	zh-CN
ydhz	焉得虎子	zh-CN
ydid	一定程度	zh-CN
ydiy	远渡重洋	zh-CN
ydky	一定可以	zh-CN
ydld	一刀两断	zh-CN
ydmf	有点麻烦	zh-CN
ydqx	以大欺小	zh-CN
ydrl	应答如流	zh-CN
ydsi	约定俗成	zh-CN
ydtb	原地踏步	zh-CN
yduj	一段时间	zh-CN
yduq	有待商榷	zh-CN
ydur	诱敌深入	zh-CN
ydvc	应对之策	zh-CN
ydvy	因地制宜	zh-CN
ydwk	一睹为快	zh-CN
ydwm	羊大为美	zh-CN
ydwt	有点问题	zh-CN
ydxu	异端邪说	zh-CN
ydyb	一点也不	zh-CN
ydyd	一点一滴	zh-CN
ydyh	越多越好	zh-CN
ydyp	移动硬盘	zh-CN
ydyq	压倒一切	zh-CN
ydys	有点意思	zh-CN
ydyu	有得有失	zh-CN
ydzh	一肚子火	zh-CN
ydzq	一肚子气	zh-CN
yebf	引而不发	zh-CN
yedl	掩耳盗铃	zh-CN
yedt	悦耳动听	zh-CN
yefl	养儿防老	zh-CN
yeie	以讹传讹	zh-CN
yeue	有二说二	zh-CN
yewx	言而无信	zh-CN
yeyx	言而有信	zh-CN
yfb	有法必依	zh-CN
yfbc	以防不测	zh-CN
yfbd	原封不动	zh-CN
yfbq	艳福不浅	zh-CN
yfby	有法不依	zh-CN
yfdf	要风得风	zh-CN
yfdg	一夫当关	zh-CN
yfdq	一夫多妻	zh-CN
yffu	一帆风顺	zh-CN
yfgy	一分耕耘	zh-CN
yfi	一飞冲天	zh-CN
yfit	一反常态	zh-CN
yfku	一番口舌	zh-CN
yfky	有法可依	zh-CN
yfld	幼发拉底	zh-CN
yfly	有凤来仪	zh-CN
yfny	吟风弄月	zh-CN
yfqj	一发千钧	zh-CN
yfru	亦复如是	zh-CN
yfsu	严防死守	zh-CN
yfsv	约法三章	zh-CN
yfsx	用非所学	zh-CN
yftx	有福同享	zh-CN
yfty	义愤填膺	zh-CN
yfuh	一分收获	zh-CN
yfvf	有夫之妇	zh-CN
yfvv	阴风阵阵	zh-CN
yfwe	一分为二	zh-CN
yfwy	以防万一	zh-CN
yfyf	愚夫愚妇	zh-CN
yfym	一分一秒	zh-CN
yfyq	一夫一妻	zh-CN
yfyr	应付裕如	zh-CN
yfys	移风易俗	zh-CN
yfyw	阳奉阴违	zh-CN
yfyy	鸢飞鱼跃	zh-CN
yfzr	应付自如	zh-CN
ygbm	雁过拔毛	zh-CN
ygbv	一官半职	zh-CN
ygby	因果报应	zh-CN
ygcl	阳光灿烂	zh-CN
ygdd	阳关大道	zh-CN
ygdl	一个顶俩	zh-CN
ygdv	一个多钟	zh-CN
ygdy	一个多月	zh-CN
ygef	有感而发	zh-CN
ygeg	一个二个	zh-CN
ygej	一干二净	zh-CN
ygel	一概而论	zh-CN
yger	鱼贯而入	zh-CN
ygfi	仰观俯察	zh-CN
ygfj	以古非今	zh-CN
ygfm	一个方面	zh-CN
ygfq	异国风情	zh-CN
yggx	因果关系	zh-CN
yggy	云贵高原	zh-CN
yghl	叶公好龙	zh-CN
yghx	以观后效	zh-CN
ygii	衣冠楚楚	zh-CN
ygje	一个劲儿	zh-CN
ygjh	一个机会	zh-CN
yglb	一个礼拜	zh-CN
yglg	一个两个	zh-CN
yglh	一个来回	zh-CN
yglj	严格来讲	zh-CN
ygll	眼观六路	zh-CN
yglu	雁过留声	zh-CN
yglv	一国两制	zh-CN
yglz	一个例子	zh-CN
ygmm	阳光明媚	zh-CN
ygmv	欲盖弥彰	zh-CN
ygmz	一个模子	zh-CN
ygne	一股脑儿	zh-CN
ygq	邀功请赏	zh-CN
ygqu	言过其实	zh-CN
ygsj	勇冠三军	zh-CN
ygsl	眼观四路	zh-CN
ygtq	雨过天晴	zh-CN
ygtx	异国他乡	zh-CN
ygud	眼高手低	zh-CN
yguj	一个世纪	zh-CN
yguu	应该说是	zh-CN
yguv	一个手指	zh-CN
yguw	一个上午	zh-CN
ygvi	有功之臣	zh-CN
ygvq	阳刚之气	zh-CN
ygvt	一个钟头	zh-CN
ygvu	倚官仗势	zh-CN
ygvv	言归正传	zh-CN
ygwt	一个问题	zh-CN
ygwu	一个晚上	zh-CN
ygxq	一个星期	zh-CN
ygxu	一个小时	zh-CN
ygxw	一个下午	zh-CN
ygyd	眼高于顶	zh-CN
ygyg	一个一个	zh-CN
ygyh	言归于好	zh-CN
ygyj	有根有据	zh-CN
ygym	忧国忧民	zh-CN
ygys	于公于私	zh-CN
ygyu	愚公移山	zh-CN
ygyw	莺歌燕舞	zh-CN
ygyy	一个原因	zh-CN
ygzl	油光锃亮	zh-CN
ygzq	一鼓作气	zh-CN
yhbs	阴魂不散	zh-CN
yhbv	烟花爆竹	zh-CN
yhby	一呼百应	zh-CN
yhdd	玉皇大帝	zh-CN
yhdf	因祸得福	zh-CN
yhdx	羽化登仙	zh-CN
yhej	一挥而就	zh-CN
yhes	一哄而散	zh-CN
yheu	一哄而上	zh-CN
yhfg	月黑风高	zh-CN
yhfu	欲火焚身	zh-CN
yhgg	引吭高歌	zh-CN
yhis	雨后春笋	zh-CN
yhiu	浴火重生	zh-CN
yhjm	移花接木	zh-CN
yhju	有话就说	zh-CN
yhku	有话快说	zh-CN
yhll	眼花缭乱	zh-CN
yhlx	烟花柳巷	zh-CN
yhmp	与虎谋皮	zh-CN
yhnt	欲壑难填	zh-CN
yhqv	迂回曲折	zh-CN
yhuu	引火烧身	zh-CN
yhvj	有何指教	zh-CN
yhwc	倚红偎翠	zh-CN
yhwl	有害无利	zh-CN
yhwq	贻害无穷	zh-CN
yhwy	有害无益	zh-CN
yhxi	异乎寻常	zh-CN
yhxv	鱼和熊掌	zh-CN
yhzs	炎黄子孙	zh-CN
yiec	一差二错	zh-CN
yief	一触而发	zh-CN
yieq	扬长而去	zh-CN
yijf	一触即发	zh-CN
yijr	语出惊人	zh-CN
yimd	夜长梦多	zh-CN
yimv	一筹莫展	zh-CN
yisy	阳春三月	zh-CN
yiuj	言传身教	zh-CN
yiwg	腰缠万贯	zh-CN
yiwn	遗臭万年	zh-CN
yiyx	宜嗔宜喜	zh-CN
yiyy	又臭又硬	zh-CN
yjbl	有机玻璃	zh-CN
yjbq	玉洁冰清	zh-CN
yjbv	一蹶不振	zh-CN
yjbx	应接不暇	zh-CN
yjcv	引咎辞职	zh-CN
yjcx	一决雌雄	zh-CN
yjdj	有简打简	zh-CN
yjdl	引颈待戮	zh-CN
yjdr	以己度人	zh-CN
yjft	用进废退	zh-CN
yjgu	夜静更深	zh-CN
yjgx	一决高下	zh-CN
yjhi	有机合成	zh-CN
yjhk	养家糊口	zh-CN
yjhy	欲拒还迎	zh-CN
yjim	一举成名	zh-CN
yjix	一箭穿心	zh-CN
yjiy	殃及池鱼	zh-CN
yjjd	引经据典	zh-CN
yjjg	远交近攻	zh-CN
yjki	有机可乘	zh-CN
yjld	一举两得	zh-CN
yjlh	有句老话	zh-CN
yjls	腰肌劳损	zh-CN
yjlv	以假乱真	zh-CN
yjlx	一家老小	zh-CN
yjny	也就那样	zh-CN
yjqx	一见倾心	zh-CN
yjrg	一见如故	zh-CN
yjsk	一家三口	zh-CN
yjsz	语惊四座	zh-CN
yjtq	异军突起	zh-CN
yjud	一箭双雕	zh-CN
yjuk	眼疾手快	zh-CN
yjvd	一箭之地	zh-CN
yjvq	一见钟情	zh-CN
yjvv	一家之主	zh-CN
yjvy	一家之言	zh-CN
yjwg	殃及无辜	zh-CN
yjwl	有教无类	zh-CN
yjwm	远近闻名	zh-CN
yjwt	有进无退	zh-CN
yjwx	有惊无险	zh-CN
yjxj	用尽心机	zh-CN
yjxl	一觉醒来	zh-CN
yjxr	养精蓄锐	zh-CN
yjyd	一举一动	zh-CN
yjyg	言简意赅	zh-CN
yjyl	寓教于乐	zh-CN
yjyq	业精于勤	zh-CN
yjyv	一惊一乍	zh-CN
yjzl	牙尖嘴利	zh-CN
ykdx	医科大学	zh-CN
ykfv	亦可覆舟	zh-CN
ykjb	有口皆碑	zh-CN
ykjr	云开见日	zh-CN
ykny	有口难言	zh-CN
ykst	忆苦思甜	zh-CN
yktu	异口同声	zh-CN
ykwl	欲哭无泪	zh-CN
ykwx	有口无心	zh-CN
ykyd	一口咬定	zh-CN
ykyk	一口一口	zh-CN
ylbd	意料不到	zh-CN
ylbh	于理不合	zh-CN
ylbl	一了百了	zh-CN
yldh	舆论大哗	zh-CN
yldx	耶鲁大学	zh-CN
yleq	一来二去	zh-CN
ylff	议论纷纷	zh-CN
ylfi	一路风尘	zh-CN
ylfr	以理服人	zh-CN
ylgg	叶落归根	zh-CN
ylgm	用力过猛	zh-CN
ylgw	与狼共舞	zh-CN
ylhz	鱼龙混杂	zh-CN
ylib	因利乘便	zh-CN
ylid	一力承当	zh-CN
ylii	疑虑重重	zh-CN
yljd	舆论监督	zh-CN
yljh	一两句话	zh-CN
yljj	因陋就简	zh-CN
ylju	以卵击石	zh-CN
ylkt	有利可图	zh-CN
ylml	倚老卖老	zh-CN
ylmm	一脸迷茫	zh-CN
ylmr	一脸茫然	zh-CN
ylpa	一路平安	zh-CN
ylqv	一落千丈	zh-CN
ylrc	原来如此	zh-CN
ylrj	夜阑人静	zh-CN
ylru	引狼入室	zh-CN
ylsd	英伦三岛	zh-CN
ylsv	养老送终	zh-CN
ylsw	迎来送往	zh-CN
yltj	有利条件	zh-CN
yltu	以卵投石	zh-CN
ylub	伊丽莎白	zh-CN
ylud	亚历山大	zh-CN
yluf	一路顺风	zh-CN
yluu	衣来伸手	zh-CN
ylvq	叶落知秋	zh-CN
ylvv	意料之中	zh-CN
ylvw	意料之外	zh-CN
ylwg	一脸无辜	zh-CN
ylwh	以邻为壑	zh-CN
ylwl	云里雾里	zh-CN
ylwu	与邻为善	zh-CN
ylwy	一览无余	zh-CN
ylxd	以礼相待	zh-CN
ylxi	月落星沉	zh-CN
ylxm	以泪洗面	zh-CN
ylxp	一路小跑	zh-CN
ylxz	有两下子	zh-CN
ylyb	有利有弊	zh-CN
ylyd	越来越多	zh-CN
ylyh	越来越好	zh-CN
ylyj	有理有据	zh-CN
ylyq	妖里妖气	zh-CN
ylyt	摇了摇头	zh-CN
ylyx	越来越像	zh-CN
ylyy	一劳永逸	zh-CN
ylzd	夜郎自大	zh-CN
ymbb	一毛不拔	zh-CN
ymbf	也没办法	zh-CN
ymdx	一马当先	zh-CN
ymel	迎面而来	zh-CN
ymeq	掩面而泣	zh-CN
ymfm	羽毛丰满	zh-CN
ymgd	有目共睹	zh-CN
ymgg	妖魔鬼怪	zh-CN
ymgj	阴谋诡计	zh-CN
ymgx	也没关系	zh-CN
ymhv	鱼目混珠	zh-CN
ymjr	一鸣惊人	zh-CN
ymju	颜面尽失	zh-CN
ymjx	眼冒金星	zh-CN
ymlh	愚昧落后	zh-CN
ymlm	圆满落幕	zh-CN
ymlr	一目了然	zh-CN
ymlw	扬名立万	zh-CN
ymmx	倚门卖笑	zh-CN
ymmz	游牧民族	zh-CN
ymny	亚美尼亚	zh-CN
ympi	一马平川	zh-CN
ymqr	以貌取人	zh-CN
ymqy	缘木求鱼	zh-CN
ymsd	颜面扫地	zh-CN
ymtl	与民同乐	zh-CN
ymtq	扬眉吐气	zh-CN
ymuh	一目十行	zh-CN
ymuk	眼明手快	zh-CN
ymuw	英明神武	zh-CN
ymvc	一面之词	zh-CN
ymvj	一面之交	zh-CN
ymvu	验明正身	zh-CN
ymvv	揠苗助长	zh-CN
ymvx	鱼米之乡	zh-CN
ymwf	羽毛未丰	zh-CN
ymwh	一命呜呼	zh-CN
ymwj	野马无缰	zh-CN
ymwm	以梦为马	zh-CN
ymwu	有名无实	zh-CN
ymwv	愚昧无知	zh-CN
ymxb	以命相搏	zh-CN
ymxi	一脉相承	zh-CN
ymxl	眼明心亮	zh-CN
ymxs	一门心思	zh-CN
ymxx	月明星稀	zh-CN
ymyh	越描越黑	zh-CN
ymyy	一模一样	zh-CN
ynbz	一年半载	zh-CN
yndt	一年到头	zh-CN
yneu	迎难而上	zh-CN
ynix	遇难成祥	zh-CN
ynqj	一诺千金	zh-CN
ynsj	一年四季	zh-CN
yntd	有难同当	zh-CN
ynvb	云泥之别	zh-CN
ynvc	一念至此	zh-CN
ynvi	一念之差	zh-CN
ynvj	一念之间	zh-CN
ynvx	一怒之下	zh-CN
ynwr	以你为荣	zh-CN
ynyd	一年一度	zh-CN
ynyn	一男一女	zh-CN
ynyu	延年益寿	zh-CN
ynzu	英年早逝	zh-CN
ynzv	疑难杂症	zh-CN
ypbx	一片冰心	zh-CN
ypdx	眼皮底下	zh-CN
ypeh	一炮而红	zh-CN
ypgq	以偏概全	zh-CN
ypht	一抔黄土	zh-CN
yphy	一派胡言	zh-CN
ypjf	有屁就放	zh-CN
ypjh	一拍即合	zh-CN
ypkb	一片空白	zh-CN
yplj	一片狼藉	zh-CN
ypls	一拍两散	zh-CN
yprx	一贫如洗	zh-CN
ypsu	一盘散沙	zh-CN
ypuh	一曝十寒	zh-CN
ypvl	一拼之力	zh-CN
ypyx	一颦一笑	zh-CN
yqbl	移情别恋	zh-CN
yqbm	欲求不满	zh-CN
yqbt	一窍不通	zh-CN
yqbu	语气不善	zh-CN
yqbv	一钱不值	zh-CN
yqby	有求必应	zh-CN
yqdl	玉砌雕阑	zh-CN
yqdu	元气大伤	zh-CN
yqe	一清二白	zh-CN
yqeb	一穷二白	zh-CN
yqei	一清二楚	zh-CN
yqff	意气风发	zh-CN
yqfx	粤犬吠雪	zh-CN
yqgz	欲擒故纵	zh-CN
yqhd	油腔滑调	zh-CN
yqhi	一气呵成	zh-CN
yqit	怨气冲天	zh-CN
yqkj	勇气可嘉	zh-CN
yqlr	以强凌弱	zh-CN
yqms	以权谋私	zh-CN
yqnh	摇旗呐喊	zh-CN
yqru	由浅入深	zh-CN
yqrx	一腔热血	zh-CN
yqsi	用其所长	zh-CN
yqsy	一切随缘	zh-CN
yqtg	异曲同工	zh-CN
yqtx	有期徒刑	zh-CN
yqvh	一丘之貉	zh-CN
yqvx	一气之下	zh-CN
yqw	余情未了	zh-CN
yqwh	有去无回	zh-CN
yqwl	有气无力	zh-CN
yqwu	鸦雀无声	zh-CN
yqxg	偃旗息鼓	zh-CN
yqxt	意气相投	zh-CN
yqyg	一瘸一拐	zh-CN
yqyh	一前一后	zh-CN
yqyj	寓情于景	zh-CN
yqyl	于情于理	zh-CN
yqyn	有求于你	zh-CN
yqyq	予取予求	zh-CN
yqyr	有求于人	zh-CN
yqyu	意气用事	zh-CN
yqyx	怡情养性	zh-CN
yqyy	有情有义	zh-CN
yrbd	用人不当	zh-CN
yrbu	遇人不淑	zh-CN
yrbx	仰人鼻息	zh-CN
yrby	用人不疑	zh-CN
yrej	迎刃而解	zh-CN
yrem	掩人耳目	zh-CN
yreu	油然而生	zh-CN
yrey	因人而异	zh-CN
yrfb	与人方便	zh-CN
yrfv	易如反掌	zh-CN
yrgd	优柔寡断	zh-CN
yrgw	依然故我	zh-CN
yrhg	雍容华贵	zh-CN
yrjr	毅然决然	zh-CN
yrjw	一如既往	zh-CN
yrjz	与日俱增	zh-CN
yrkg	以柔克刚	zh-CN
yrku	贻人口实	zh-CN
yrnd	有容乃大	zh-CN
yrql	一日千里	zh-CN
yrrg	依然如故	zh-CN
yrru	引人入胜	zh-CN
yrrv	游人如织	zh-CN
yrsc	一日三餐	zh-CN
yrsq	一日三秋	zh-CN
yrsx	一日三省	zh-CN
yrtl	艳如桃李	zh-CN
yrux	哑然失笑	zh-CN
yrvm	引人注目	zh-CN
yrvx	一人之下	zh-CN
yrwb	以人为本	zh-CN
yrwj	以人为镜	zh-CN
yrwu	与人为善	zh-CN
yryl	映入眼帘	zh-CN
yryx	嫣然一笑	zh-CN
yryy	游刃有余	zh-CN
yrzd	怡然自得	zh-CN
yrzr	庸人自扰	zh-CN
ysbg	一丝不苟	zh-CN
ysbh	要死不活	zh-CN
ysbt	腰酸背痛	zh-CN
yseg	一扫而光	zh-CN
ysek	一扫而空	zh-CN
ysfl	云散风流	zh-CN
ysgu	雅俗共赏	zh-CN
yshf	严丝合缝	zh-CN
ysjs	一损俱损	zh-CN
yslb	伊斯兰堡	zh-CN
ysuy	野蔌山肴	zh-CN
yswb	营私舞弊	zh-CN
yswp	鱼死网破	zh-CN
yswy	有损无益	zh-CN
ysyh	一丝一毫	zh-CN
yszw	有所作为	zh-CN
ytbw	有条不紊	zh-CN
ytdw	一天到晚	zh-CN
ytfm	油头粉面	zh-CN
ytgu	迎头赶上	zh-CN
ythn	摇头晃脑	zh-CN
ythq	一团和气	zh-CN
ytht	一塌糊涂	zh-CN
ythy	言谈话语	zh-CN
ytit	仰天长叹	zh-CN
ytjc	言听计从	zh-CN
ytjh	一统江湖	zh-CN
ytjv	言谈举止	zh-CN
ytlm	一团乱麻	zh-CN
ytmn	有头没脑	zh-CN
ytsu	一潭死水	zh-CN
yttj	迎头痛击	zh-CN
yttx	一统天下	zh-CN
ytun	窈窕淑女	zh-CN
ytur	应天顺人	zh-CN
ytvd	勇挑重担	zh-CN
ytvx	晕头转向	zh-CN
ytwf	仪态万方	zh-CN
ytwj	以退为进	zh-CN
ytwk	一吐为快	zh-CN
ytwr	有天无日	zh-CN
ytwu	一头雾水	zh-CN
ytxl	蝇头小利	zh-CN
ytyl	有头有脸	zh-CN
ytyw	有头有尾	zh-CN
ytyy	一天一夜	zh-CN
yubb	一手包办	zh-CN
yubh	一时半会	zh-CN
yubv	掩饰不住	zh-CN
yubx	一声不响	zh-CN
yuch	一手策划	zh-CN
yudh	移山倒海	zh-CN
yudl	遗世独立	zh-CN
yudw	野生动物	zh-CN
yueg	一闪而过	zh-CN
yuen	一石二鸟	zh-CN
yuex	由上而下	zh-CN
yufm	衣食父母	zh-CN
yugy	有失公允	zh-CN
yuhf	燕瘦环肥	zh-CN
yuhq	一生何求	zh-CN
yuht	一时糊涂	zh-CN
yuhx	游手好闲	zh-CN
yuib	因势乘便	zh-CN
yuic	与世长辞	zh-CN
yuid	一时冲动	zh-CN
yujf	玉石俱焚	zh-CN
yujj	与时俱进	zh-CN
yujl	与生俱来	zh-CN
yuld	因势利导	zh-CN
yulf	玉树临风	zh-CN
yult	优胜劣汰	zh-CN
yumx	烟视媚行	zh-CN
yunn	饮食男女	zh-CN
yuqj	饮食起居	zh-CN
yurc	也是如此	zh-CN
yurj	夜深人静	zh-CN
yusk	一时三刻	zh-CN
yusy	饮水思源	zh-CN
yutr	一视同仁	zh-CN
yutt	一手托天	zh-CN
yuud	以少胜多	zh-CN
yuuf	以身试法	zh-CN
yuuu	一试身手	zh-CN
yuvh	鱼水之欢	zh-CN
yuvj	一时之间	zh-CN
yuvn	有生之年	zh-CN
yuvt	一手遮天	zh-CN
yuvv	由始至终	zh-CN
yuvx	衣食住行	zh-CN
yuwb	于事无补	zh-CN
yuwi	一事无成	zh-CN
yuwk	有恃无恐	zh-CN
yuwl	一时无两	zh-CN
yuwu	游山玩水	zh-CN
yuwv	与世无争	zh-CN
yuxg	以身殉国	zh-CN
yuxv	以身殉职	zh-CN
yuyg	疑神疑鬼	zh-CN
yuyl	有史以来	zh-CN
yuyn	益寿延年	zh-CN
yuyu	一生一世	zh-CN
yuyv	有始有终	zh-CN
yuyw	远胜于我	zh-CN
yuyy	亦师亦友	zh-CN
yuzp	影视作品	zh-CN
yuzz	以身作则	zh-CN
yvbj	一知半解	zh-CN
yvbm	邮政编码	zh-CN
yvbt	与众不同	zh-CN
yvbu	一着不慎	zh-CN
yvbv	抑制不住	zh-CN
yvdn	一专多能	zh-CN
yvdx	一枝独秀	zh-CN
yvff	焉知非福	zh-CN
yvgx	一争高下	zh-CN
yvhj	已臻化境	zh-CN
yvhl	一枕黄粱	zh-CN
yvil	言之成理	zh-CN
yvjx	一针见血	zh-CN
yvkw	一纸空文	zh-CN
yvmg	仰之弥高	zh-CN
yvml	寅支卯粮	zh-CN
yvqj	一掷千金	zh-CN
yvqt	一柱擎天	zh-CN
yvqu	颐指气使	zh-CN
yvrf	运指如飞	zh-CN
yvrw	一致认为	zh-CN
yvsg	银装素裹	zh-CN
yvtg	一致通过	zh-CN
yvtp	硬着头皮	zh-CN
yvty	一致同意	zh-CN
yvuf	胭脂水粉	zh-CN
yvug	愿者上钩	zh-CN
yvuj	刖趾适屦	zh-CN
yvut	以正视听	zh-CN
yvuz	言之尚早	zh-CN
yvvg	月中折桂	zh-CN
yvvk	饮鸩止渴	zh-CN
yvvu	有志之士	zh-CN
yvvy	由衷之言	zh-CN
yvww	言之无物	zh-CN
yvwz	言者无罪	zh-CN
yvxi	语重心长	zh-CN
yvxu	一桩心事	zh-CN
yvyd	严阵以待	zh-CN
yvyi	一张一弛	zh-CN
yvyl	言之有理	zh-CN
yvym	用之于民	zh-CN
yvyr	有朝一日	zh-CN
yvys	一至于斯	zh-CN
yvyu	一招一式	zh-CN
yvyw	原汁原味	zh-CN
yvyx	一朝一夕	zh-CN
yvyy	越战越勇	zh-CN
yvzz	言之凿凿	zh-CN
ywbj	言无不尽	zh-CN
ywbm	一文不名	zh-CN
ywbv	一文不值	zh-CN
ywdj	一网打尽	zh-CN
ywdl	渔翁得利	zh-CN
ywej	言无二价	zh-CN
ywfg	义无反顾	zh-CN
ywhl	吆五喝六	zh-CN
ywhy	以武会友	zh-CN
ywiw	一无长物	zh-CN
ywjz	咬文嚼字	zh-CN
ywkq	一无可取	zh-CN
ywlc	语无伦次	zh-CN
ywmm	烟雾弥漫	zh-CN
ywmw	有完没完	zh-CN
ywnr	永无宁日	zh-CN
ywpd	夷为平地	zh-CN
ywql	摇尾乞怜	zh-CN
ywqu	一往情深	zh-CN
ywqx	愿闻其详	zh-CN
ywqz	仰卧起坐	zh-CN
ywsd	一无所得	zh-CN
ywsh	一无所获	zh-CN
ywsi	一无所成	zh-CN
ywsq	一无所求	zh-CN
ywsv	一无所知	zh-CN
ywsy	一无所有	zh-CN
ywui	一无是处	zh-CN
ywvd	用武之地	zh-CN
ywvj	永无止境	zh-CN
ywvq	勇往直前	zh-CN
ywvy	言外之意	zh-CN
ywwg	与我无关	zh-CN
ywwj	一望无际	zh-CN
ywwq	一往无前	zh-CN
ywwy	一望无垠	zh-CN
ywxu	鹦鹉学舌	zh-CN
ywxv	永无休止	zh-CN
ywxw	偃武修文	zh-CN
ywyd	一问一答	zh-CN
ywyu	一五一十	zh-CN
ywyw	耀武扬威	zh-CN
ywyx	杳无音信	zh-CN
yxbb	野心勃勃	zh-CN
yxbd	意想不到	zh-CN
yxbi	英雄辈出	zh-CN
yxbl	原形毕露	zh-CN
yxbr	于心不忍	zh-CN
yxby	言行不一	zh-CN
yxdf	贻笑大方	zh-CN
yxdu	有线电视	zh-CN
yxdx	有些东西	zh-CN
yxeg	一笑而过	zh-CN
yxey	一心二用	zh-CN
yxfu	以下犯上	zh-CN
yxfv	浴血奋战	zh-CN
yxgs	有限公司	zh-CN
yxgz	游戏规则	zh-CN
yxhl	烟熏火燎	zh-CN
yxhx	以血还血	zh-CN
yxhy	遥相呼应	zh-CN
yxii	忧心忡忡	zh-CN
yxje	元凶巨恶	zh-CN
yxjm	英雄救美	zh-CN
yxjv	言行举止	zh-CN
yxki	有隙可乘	zh-CN
yxld	一系列的	zh-CN
yxlk	用心良苦	zh-CN
yxlr	月下老人	zh-CN
yxlu	意兴阑珊	zh-CN
yxlv	一笑了之	zh-CN
yxml	英雄末路	zh-CN
yxmm	隐姓埋名	zh-CN
yxqd	英雄气短	zh-CN
yxqi	一雪前耻	zh-CN
yxqj	一笑千金	zh-CN
yxql	一泻千里	zh-CN
yxqw	音信全无	zh-CN
yxqy	一厢情愿	zh-CN
yxrc	一向如此	zh-CN
yxrf	忧心如焚	zh-CN
yxrh	意下如何	zh-CN
yxrm	饮血茹毛	zh-CN
yxru	游戏人生	zh-CN
yxtk	异想天开	zh-CN
yxuc	一息尚存	zh-CN
yxud	因小失大	zh-CN
yxuh	有些时候	zh-CN
yxuj	因循守旧	zh-CN
yxuk	印象深刻	zh-CN
yxuq	有些事情	zh-CN
yxuw	游行示威	zh-CN
yxvd	一席之地	zh-CN
yxvj	一夕之间	zh-CN
yxvv	一笑置之	zh-CN
yxvy	言下之意	zh-CN
yxwl	有心无力	zh-CN
yxws	云消雾散	zh-CN
yxwt	有些问题	zh-CN
yxxw	云兴霞蔚	zh-CN
yxxx	异性相吸	zh-CN
yxyr	有血有肉	zh-CN
yxys	烟消云散	zh-CN
yxyu	越陷越深	zh-CN
yxyv	言行一致	zh-CN
yxyy	一心一意	zh-CN
yxzr	有限责任	zh-CN
yybb	原原本本	zh-CN
yybd	源源不断	zh-CN
yybf	一言不发	zh-CN
yybh	一言不合	zh-CN
yybj	犹豫不决	zh-CN
yybu	依依不舍	zh-CN
yybx	语焉不详	zh-CN
yyby	一言半语	zh-CN
yycc	郁郁葱葱	zh-CN
yydd	有一点点	zh-CN
yydg	泱泱大国	zh-CN
yydh	愿意的话	zh-CN
yydl	以逸待劳	zh-CN
yydn	由易到难	zh-CN
yydp	一语道破	zh-CN
yydu	一衣带水	zh-CN
yydy	洋洋得意	zh-CN
yyej	一饮而尽	zh-CN
yyeq	一跃而起	zh-CN
yyer	一拥而入	zh-CN
yyeu	应运而生	zh-CN
yyev	郁郁而终	zh-CN
yyex	一跃而下	zh-CN
yyff	淫雨霏霏	zh-CN
yyfl	一夜风流	zh-CN
yygg	蝇营狗苟	zh-CN
yygh	郁郁寡欢	zh-CN
yygq	阴阳怪气	zh-CN
yygv	艳阳高照	zh-CN
yygw	一一过问	zh-CN
yygx	一意孤行	zh-CN
yyhh	摇摇晃晃	zh-CN
yyht	一氧化碳	zh-CN
yyhv	妖言惑众	zh-CN
yyhw	意欲何为	zh-CN
yyhy	以牙还牙	zh-CN
yyii	一语成谶	zh-CN
yyij	囿于成见	zh-CN
yyim	一夜成名	zh-CN
yyiw	一跃成为	zh-CN
yyjc	油盐酱醋	zh-CN
yyjd	一言九鼎	zh-CN
yyjh	因缘际会	zh-CN
yyji	一言既出	zh-CN
yyjq	一应俱全	zh-CN
yyjr	夜以继日	zh-CN
yyjt	样样精通	zh-CN
yyjv	营养价值	zh-CN
yyjy	应有尽有	zh-CN
yykn	也有可能	zh-CN
yyli	源远流长	zh-CN
yylj	严以律己	zh-CN
yylr	余音缭绕	zh-CN
yylx	遥遥领先	zh-CN
yymb	阴云密布	zh-CN
yynn	余音袅袅	zh-CN
yypd	一语破的	zh-CN
yyqc	隐约其辞	zh-CN
yyqf	艳压群芳	zh-CN
yyqh	因缘巧合	zh-CN
yyqj	玉液琼浆	zh-CN
yyrl	余音绕梁	zh-CN
yyry	与有荣焉	zh-CN
yyug	一语双关	zh-CN
yyuh	熠熠生辉	zh-CN
yyuy	有一说一	zh-CN
yyvd	一语中的	zh-CN
yyve	养育之恩	zh-CN
yyvj	一夜之间	zh-CN
yyvm	一叶障目	zh-CN
yyvq	一叶知秋	zh-CN
yyvu	芸芸众生	zh-CN
yyvv	营业执照	zh-CN
yyvy	以夷制夷	zh-CN
yyvz	有一阵子	zh-CN
yywa	引以为傲	zh-CN
yywd	一言为定	zh-CN
yywe	有一无二	zh-CN
yywf	有缘无分	zh-CN
yywi	引以为耻	zh-CN
yywj	意犹未尽	zh-CN
yywm	有勇无谋	zh-CN
yywq	遥遥无期	zh-CN
yywv	有眼无珠	zh-CN
yywy	有意无意	zh-CN
yyxb	冤冤相报	zh-CN
yyxd	遥遥相对	zh-CN
yyxv	鱼与熊掌	zh-CN
yyxy	牙牙学语	zh-CN
yyyb	溢于言表	zh-CN
yyyd	有氧运动	zh-CN
yyyl	愈演愈烈	zh-CN
yyym	有勇有谋	zh-CN
yyyt	燕语莺啼	zh-CN
yyyv	欲言又止	zh-CN
yyyx	奄奄一息	zh-CN
yyyy	隐隐约约	zh-CN
yyze	言犹在耳	zh-CN
yyzr	运用自如	zh-CN
yyzt	隐隐作痛	zh-CN
yyzx	有言在先	zh-CN
yzbb	睚眦必报	zh-CN
yzbi	一字不差	zh-CN
yzbl	一字不漏	zh-CN
yzdp	越俎代庖	zh-CN
yzeu	易子而食	zh-CN
yzfx	一醉方休	zh-CN
yzgf	远走高飞	zh-CN
yzgv	有则改之	zh-CN
yzhu	油嘴滑舌	zh-CN
yziy	养尊处优	zh-CN
yzjg	纡尊降贵	zh-CN
yzpg	意在沛公	zh-CN
yzqd	一再强调	zh-CN
yzqj	一字千金	zh-CN
yzsu	英姿飒爽	zh-CN
yztb	远在天边	zh-CN
yztx	远走他乡	zh-CN
yzyw	有滋有味	zh-CN
yzyz	优哉游哉	zh-CN
zbdv	资不抵债	zh-CN
zbih	足不出户	zh-CN
zbin	坐北朝南	zh-CN
zbjk	赞不绝口	zh-CN
zbjm	自报家门	zh-CN
zblj	脏不拉叽	zh-CN
zbll	自不量力	zh-CN
zbrv	罪不容诛	zh-CN
zbtg	凿壁偷光	zh-CN
zbug	作壁上观	zh-CN
zbvl	坐不住了	zh-CN
zbvy	资本主义	zh-CN
zbyb	左膀右臂	zh-CN
zbzq	自暴自弃	zh-CN
zcvq	在此之前	zh-CN
zcxh	自惭形秽	zh-CN
zcyj	在此一举	zh-CN
zdba	躁动不安	zh-CN
zdej	罪大恶极	zh-CN
zdfz	坐地分赃	zh-CN
zdid	最大程度	zh-CN
zdlj	总的来讲	zh-CN
zdlk	总的来看	zh-CN
zdlu	总的来说	zh-CN
zdpm	左道旁门	zh-CN
zdqj	坐地起价	zh-CN
zdql	自得其乐	zh-CN
zdtp	自动调频	zh-CN
zdup	自动上屏	zh-CN
zdwt	最大问题	zh-CN
zdxd	最大限度	zh-CN
zdyh	再等一会	zh-CN
zdzy	自导自演	zh-CN
zebl	杂而不乱	zh-CN
zedd	作恶多端	zh-CN
zeld	坐而论道	zh-CN
zett	罪恶滔天	zh-CN
zeyv	总而言之	zh-CN
zfwg	自废武功	zh-CN
zfyf	造福一方	zh-CN
zfzb	作法自毙	zh-CN
zgbx	自顾不暇	zh-CN
zgdl	自甘堕落	zh-CN
zgfy	自告奋勇	zh-CN
zgjn	再过几年	zh-CN
zgjt	再过几天	zh-CN
zgln	再过两年	zh-CN
zgmt	砸锅卖铁	zh-CN
zgvu	资格证书	zh-CN
zgws	罪该万死	zh-CN
zgyl	自古以来	zh-CN
zgyp	左顾右盼	zh-CN
zgzd	自高自大	zh-CN
zgzw	载歌载舞	zh-CN
zhbg	再好不过	zh-CN
zhbh	纵横捭阖	zh-CN
zhbl	坐怀不乱	zh-CN
zhds	作何打算	zh-CN
zhfy	作何反应	zh-CN
zhgt	最后关头	zh-CN
zhgu	纵虎归山	zh-CN
zhgx	作何感想	zh-CN
zhii	纵横驰骋	zh-CN
zhjc	纵横交错	zh-CN
zhjd	作何决定	zh-CN
zhju	作何解释	zh-CN
zhnr	造化弄人	zh-CN
zhpj	作何评价	zh-CN
zhqi	自毁前程	zh-CN
zhrm	走火入魔	zh-CN
zhsh	纵横四海	zh-CN
zhtd	最后通牒	zh-CN
zhuk	最后时刻	zh-CN
zhvb	作何准备	zh-CN
zhvz	贼喊捉贼	zh-CN
zhxz	作何选择	zh-CN
zhyc	最后一次	zh-CN
zhyg	最后一个	zh-CN
zhyk	最后一刻	zh-CN
zhym	最后一秒	zh-CN
zhyt	最后一天	zh-CN
zify	子承父业	zh-CN
zijj	资产阶级	zh-CN
zimf	祖传秘方	zh-CN
zipf	祖传配方	zh-CN
ziuk	坐吃山空	zh-CN
ziwg	早出晚归	zh-CN
zixg	再创新高	zh-CN
ziym	子丑寅卯	zh-CN
zizl	自吹自擂	zh-CN
zjdu	自己动手	zh-CN
zjfk	作奸犯科	zh-CN
zjfm	自掘坟墓	zh-CN
zjgt	坐井观天	zh-CN
zjix	走街串巷	zh-CN
zjnt	在劫难逃	zh-CN
zjrq	自即日起	zh-CN
zjuf	遵纪守法	zh-CN
zjyd	罪加一等	zh-CN
zjzf	作茧自缚	zh-CN
zjzl	再接再厉	zh-CN
zjzy	自觉自愿	zh-CN
zjzz	自给自足	zh-CN
zkbr	自愧不如	zh-CN
zkhu	罪魁祸首	zh-CN
zlay	尊老爱幼	zh-CN
zlba	坐立不安	zh-CN
zlbd	坐冷板凳	zh-CN
zlgu	自力更生	zh-CN
zlhj	字里行间	zh-CN
zlmh	自立门户	zh-CN
zlqj	总揽全局	zh-CN
zlvj	自乱阵脚	zh-CN
zlwv	杂乱无章	zh-CN
zlyb	再来一遍	zh-CN
zlyc	再来一次	zh-CN
zlyd	揍了一顿	zh-CN
zlyt	嘴里一套	zh-CN
zlyu	左邻右舍	zh-CN
zlzq	走来走去	zh-CN
zmbf	自命不凡	zh-CN
zmbx	怎么不行	zh-CN
zmdl	怎么得了	zh-CN
zmdy	自鸣得意	zh-CN
zmgd	怎么搞的	zh-CN
zmgh	走马观花	zh-CN
zmhu	怎么回事	zh-CN
zmil	自谋出路	zh-CN
zmkn	怎么可能	zh-CN
zmur	走马上任	zh-CN
zmuy	贼眉鼠眼	zh-CN
zmvy	怎么这样	zh-CN
zmzk	自卖自夸	zh-CN
znib	走南闯北	zh-CN
znjj	钻牛角尖	zh-CN
znus	作鸟兽散	zh-CN
znuv	罪孽深重	zh-CN
znzm	做牛做马	zh-CN
zqbl	暂且不论	zh-CN
zqbx	自强不息	zh-CN
zqdf	自求多福	zh-CN
zqdl	紫气东来	zh-CN
zqmw	自取灭亡	zh-CN
zqq	自取其辱	zh-CN
zqqr	自欺欺人	zh-CN
zqz	在情在理	zh-CN
zqzb	杂七杂八	zh-CN
zqzh	早去早回	zh-CN
zqzj	自轻自贱	zh-CN
zrer	自然而然	zh-CN
zreu	择人而噬	zh-CN
zrug	作如是观	zh-CN
zsbc	在所不辞	zh-CN
zsbx	在所不惜	zh-CN
zshd	子孙后代	zh-CN
zskl	再三考虑	zh-CN
zsmt	子孙满堂	zh-CN
zsnm	在所难免	zh-CN
zssd	祖孙三代	zh-CN
zswd	子孙万代	zh-CN
zsyx	左思右想	zh-CN
zszl	自私自利	zh-CN
zszs	再三再四	zh-CN
ztbr	自叹不如	zh-CN
ztey	总体而言	zh-CN
ztfr	自叹弗如	zh-CN
ztki	自讨苦吃	zh-CN
ztlu	总体来说	zh-CN
ztlw	自投罗网	zh-CN
ztmq	自讨没趣	zh-CN
ztuj	总体上讲	zh-CN
ztul	总体说来	zh-CN
ztuu	总体上说	zh-CN
ztvl	在天之灵	zh-CN
ztwl	走投无路	zh-CN
ztxk	嘴甜心苦	zh-CN
ztyb	自掏腰包	zh-CN
ztzi	自弹自唱	zh-CN
ztzn	贼头贼脑	zh-CN
zubd	作声不得	zh-CN
zubg	坐视不管	zh-CN
zuex	自上而下	zh-CN
zufm	再生父母	zh-CN
zums	醉生梦死	zh-CN
zunb	自身难保	zh-CN
zuqg	自食其果	zh-CN
zuql	自食其力	zh-CN
zusu	综上所述	zh-CN
zutd	兹事体大	zh-CN
zuug	自视甚高	zh-CN
zuvd	尊师重道	zh-CN
zuvj	尊师重教	zh-CN
zuvv	自始至终	zh-CN
zuyb	再说一遍	zh-CN
zuyc	再说一次	zh-CN
zuyf	葬身鱼腹	zh-CN
zuyl	坐收渔利	zh-CN
zuzh	自说自话	zh-CN
zuzm	自生自灭	zh-CN
zuzq	早睡早起	zh-CN
zvbj	锱铢必较	zh-CN
zvbl	阻止不了	zh-CN
zvdm	足智多谋	zh-CN
zvfm	在这方面	zh-CN
zvjv	字斟句酌	zh-CN
zvki	自找苦吃	zh-CN
zvmb	最终目标	zh-CN
zvmd	最终目的	zh-CN
zvmf	自找麻烦	zh-CN
zvqy	字正腔圆	zh-CN
zvrc	早知如此	zh-CN
zvtj	资治通鉴	zh-CN
zvvm	自知之明	zh-CN
zvvq	在这之前	zh-CN
zvyi	左支右绌	zh-CN
zvzv	走着走着	zh-CN
zwba	坐卧不安	zh-CN
zwbn	坐卧不宁	zh-CN
zwju	自我介绍	zh-CN
zwpd	责无旁贷	zh-CN
zwtz	自我陶醉	zh-CN
zwuc	走为上策	zh-CN
zwuj	走为上计	zh-CN
zwxx	座无虚席	zh-CN
zwyu	自我意识	zh-CN
zwzd	自问自答	zh-CN
zwzf	作威作福	zh-CN
zxcu	自相残杀	zh-CN
zxdm	尊姓大名	zh-CN
zxfn	自寻烦恼	zh-CN
zxic	自学成才	zh-CN
zxih	走乡串户	zh-CN
zxll	罪行累累	zh-CN
zxmd	自相矛盾	zh-CN
zxpl	走下坡路	zh-CN
zxqi	坐享其成	zh-CN
zxqu	自行其是	zh-CN
zxqy	再续前缘	zh-CN
zxsl	自寻死路	zh-CN
zxwy	子虚乌有	zh-CN
zxyi	再下一城	zh-CN
zxyk	仔细一看	zh-CN
zybh	再也不会	zh-CN
zybu	再也不是	zh-CN
zycn	怎样才能	zh-CN
zydb	坐以待毙	zh-CN
zyfc	自有分寸	zh-CN
zyfy	左右逢源	zh-CN
zygl	载誉归来	zh-CN
zyhb	左右互搏	zh-CN
zyhv	造谣惑众	zh-CN
zyjs	尊严尽丧	zh-CN
zykg	左右开弓	zh-CN
zykn	最有可能	zh-CN
zyln	左右两难	zh-CN
zylq	择优录取	zh-CN
zyly	择优录用	zh-CN
zylz	龇牙咧嘴	zh-CN
zyqu	自圆其说	zh-CN
zyqx	坐言起行	zh-CN
zyuu	造谣生事	zh-CN
zyuy	子曰诗云	zh-CN
zyvu	造谣中伤	zh-CN
zyvy	自由职业	zh-CN
zywf	再也无法	zh-CN
zywn	左右为难	zh-CN
zywu	自以为是	zh-CN
zyww	恣意妄为	zh-CN
zyyb	左拥右抱	zh-CN
zyyd	罪有应得	zh-CN
zyyt	总有一天	zh-CN
zyzl	自娱自乐	zh-CN
zyzy	自言自语	zh-CN
zyzz	自由自在	zh-CN
zzbb	祖祖辈辈	zh-CN
zzbj	孜孜不倦	zh-CN
zzcm	自作聪明	zh-CN
zzdq	自作多情	zh-CN
zziq	啧啧称奇	zh-CN
zzkk	走走看看	zh-CN
zznt	罪责难逃	zh-CN
zzpp	仄仄平平	zh-CN
zzss	子子孙孙	zh-CN
zztt	走走停停	zh-CN
zzvj	字字珠玑	zh-CN
zzvv	自作主张	zh-CN
zzxh	栽赃陷害	zh-CN
zzxx	做贼心虚	zh-CN
zzyq	孜孜以求	zh-CN
zzzu	自作自受	zh-CN
bbff	本本分分	zh-CN
bcxl	不辞辛劳	zh-CN
bdju	博大精深	zh-CN
bfvy	捕风捉影	zh-CN
bgbj	毕恭毕敬	zh-CN
bjbm	不紧不慢	zh-CN
bjvm	不解之谜	zh-CN
bjyg	不拘一格	zh-CN
bjzv	并肩作战	zh-CN
bkfw	不可方物	zh-CN
bkjy	不可救药	zh-CN
bkuu	不可收拾	zh-CN
bkxq	不可小觑	zh-CN
bkyu	不可一世	zh-CN
blwy	暴露无遗	zh-CN
bmdv	本末倒置	zh-CN
bmll	八面玲珑	zh-CN
bmvv	拔苗助长	zh-CN
bmzi	闭门造车	zh-CN
bubj	笨手笨脚	zh-CN
bumj	不胜枚举	zh-CN
buuu	跋山涉水	zh-CN
bxly	巴西利亚	zh-CN
dcju	打草惊蛇	zh-CN
dcyj	多此一举	zh-CN
dddd	单打独斗	zh-CN
dddv	得道多助	zh-CN
ddgg	嘀嘀咕咕	zh-CN
ddiu	大打出手	zh-CN
dduu	多多少少	zh-CN
ddww	胆大妄为	zh-CN
ddyu	多多益善	zh-CN
dggr	达官贵人	zh-CN
dhlu	调虎离山	zh-CN
didh	大吃大喝	zh-CN
diqh	洞察秋毫	zh-CN
diug	多愁善感	zh-CN
diyj	大吃一惊	zh-CN
djdl	大吉大利	zh-CN
djju	打家劫舍	zh-CN
djjx	独具匠心	zh-CN
dnxl	冬暖夏凉	zh-CN
dsds	颠三倒四	zh-CN
duqu	独善其身	zh-CN
duxp	东施效颦	zh-CN
dvxy	斗转星移	zh-CN
ffff	反反复复	zh-CN
ffhh	分分合合	zh-CN
ffmm	方方面面	zh-CN
ffvj	泛泛之交	zh-CN
ffyy	沸沸扬扬	zh-CN
fguf	奉公守法	zh-CN
fgyj	反戈一击	zh-CN
flfq	飞来飞去	zh-CN
futp	粉饰太平	zh-CN
fuyb	放手一搏	zh-CN
fwdj	防微杜渐	zh-CN
fwuv	福无双至	zh-CN
fyfy	附庸风雅	zh-CN
ggjj	规规矩矩	zh-CN
ggmj	高歌猛进	zh-CN
ggvd	呱呱坠地	zh-CN
ghlp	鬼话连篇	zh-CN
gjbu	高居榜首	zh-CN
gjgl	国际惯例	zh-CN
gjgr	孤家寡人	zh-CN
gjlu	过街老鼠	zh-CN
glgl	咕噜咕噜	zh-CN
glhx	告老还乡	zh-CN
gull	果实累累	zh-CN
gulu	高山流水	zh-CN
guui	鬼使神差	zh-CN
gvjj	各执己见	zh-CN
gvnm	孤掌难鸣	zh-CN
gvru	狗仗人势	zh-CN
gvyv	高瞻远瞩	zh-CN
gxgv	改弦更张	zh-CN
gygy	孤言寡语	zh-CN
gzwv	各自为战	zh-CN
hdhu	患得患失	zh-CN
hdiu	华灯初上	zh-CN
hdly	寒冬腊月	zh-CN
hdyu	轰动一时	zh-CN
hebu	华而不实	zh-CN
hhvv	鸿鹄之志	zh-CN
hhxk	环环相扣	zh-CN
hhyy	花好月圆	zh-CN
hjhu	换句话说	zh-CN
hjyr	后继有人	zh-CN
hldj	画龙点睛	zh-CN
hlhu	花里胡哨	zh-CN
hlhx	活灵活现	zh-CN
hljb	汗流浃背	zh-CN
hlmm	汗流满面	zh-CN
hluj	花落谁家	zh-CN
hrgu	恍如隔世	zh-CN
hryh	浩如烟海	zh-CN
hudm	好事多磨	zh-CN
hukw	后生可畏	zh-CN
huuy	含沙射影	zh-CN
hvbn	会者不难	zh-CN
hvju	货真价实	zh-CN
hvqi	哗众取宠	zh-CN
hvyi	呼之欲出	zh-CN
hvyh	话中有话	zh-CN
hxbd	横行霸道	zh-CN
hyhx	忽隐忽现	zh-CN
hyvj	红颜知己	zh-CN
hyys	和颜悦色	zh-CN
ifhy	春风化雨	zh-CN
ifru	超凡入圣	zh-CN
ifxv	冲锋陷阵	zh-CN
igli	出乖露丑	zh-CN
imyy	臭名远扬	zh-CN
irru	怅然若失	zh-CN
iuxx	重拾信心	zh-CN
iygs	察言观色	zh-CN
izyh	姹紫嫣红	zh-CN
jbdr	见不得人	zh-CN
jbku	机不可失	zh-CN
jbrf	间不容发	zh-CN
jbtm	金榜题名	zh-CN
jbwj	举步维艰	zh-CN
jbyu	技不压身	zh-CN
jeyv	兼而有之	zh-CN
jifu	绝处逢生	zh-CN
jild	家长里短	zh-CN
jill	饥肠辘辘	zh-CN
jiuu	既成事实	zh-CN
jjii	加减乘除	zh-CN
jnvh	倦鸟知还	zh-CN
jqbd	举棋不定	zh-CN
jqju	驾轻就熟	zh-CN
jrbt	迥然不同	zh-CN
jubm	见势不妙	zh-CN
jujm	尽善尽美	zh-CN
juuj	江山社稷	zh-CN
jwjy	据为己有	zh-CN
jxfh	即兴发挥	zh-CN
jxjy	渐行渐远	zh-CN
jyyx	锦衣夜行	zh-CN
kbky	苦不堪言	zh-CN
kkww	坑坑洼洼	zh-CN
kvbf	口诛笔伐	zh-CN
kxjl	苦心积虑	zh-CN
lbdl	连本带利	zh-CN
lbjp	拉帮结派	zh-CN
lbju	两败俱伤	zh-CN
lcnm	郎才女貌	zh-CN
lgxu	论功行赏	zh-CN
lhdu	利害得失	zh-CN
lhiq	灵魂出窍	zh-CN
lirf	冷嘲热讽	zh-CN
ljjh	浪迹江湖	zh-CN
llbm	来历不明	zh-CN
llbu	恋恋不舍	zh-CN
llhh	来来回回	zh-CN
llid	绫罗绸缎	zh-CN
llmm	泪流满面	zh-CN
llqm	来龙去脉	zh-CN
llvh	利令智昏	zh-CN
llwj	寥寥无几	zh-CN
llww	碌碌无为	zh-CN
llxx	陆陆续续	zh-CN
lmsd	两面三刀	zh-CN
lqqm	两全其美	zh-CN
lsdr	理所当然	zh-CN
luru	料事如神	zh-CN
luyy	良师益友	zh-CN
lvuy	力争上游	zh-CN
lvye	略知一二	zh-CN
lybj	络绎不绝	zh-CN
lyli	伶牙俐齿	zh-CN
mahx	没安好心	zh-CN
mbzu	默不作声	zh-CN
mggu	马革裹尸	zh-CN
mgyj	卖官鬻爵	zh-CN
mklq	门可罗雀	zh-CN
mkyx	眉开眼笑	zh-CN
mmdd	懵懵懂懂	zh-CN
mmif	满面春风	zh-CN
mmll	朦朦胧胧	zh-CN
mmul	明眸善睐	zh-CN
muvu	没事找事	zh-CN
mwrs	面无人色	zh-CN
nnnn	扭扭捏捏	zh-CN
pddu	屁大点事	zh-CN
pdpd	屁颠屁颠	zh-CN
pdvu	普度众生	zh-CN
pgld	披肝沥胆	zh-CN
qbwh	千变万化	zh-CN
qibd	取长补短	zh-CN
qibk	千疮百孔	zh-CN
qigd	牵肠挂肚	zh-CN
qiwb	千差万别	zh-CN
qixx	气喘吁吁	zh-CN
qkdu	旗开得胜	zh-CN
qkld	穷困潦倒	zh-CN
qljq	黔驴技穷	zh-CN
qmdj	奇门遁甲	zh-CN
qmwj	亲密无间	zh-CN
qqbb	清清白白	zh-CN
qqdd	清清淡淡	zh-CN
qqff	起起伏伏	zh-CN
qquu	切切实实	zh-CN
qqww	卿卿我我	zh-CN
qqyu	芊芊玉手	zh-CN
qtbj	齐头并进	zh-CN
qtyh	情投意合	zh-CN
qubj	七手八脚	zh-CN
qujq	亲上加亲	zh-CN
quju	前世今生	zh-CN
quvh	敲山震虎	zh-CN
quxx	气势汹汹	zh-CN
rfyr	日复一日	zh-CN
rybi	软硬不吃	zh-CN
sdvi	所到之处	zh-CN
sild	死缠烂打	zh-CN
sjyb	死记硬背	zh-CN
srww	索然无味	zh-CN
sudj	丧失殆尽	zh-CN
tjjq	囤积居奇	zh-CN
tjuh	偷奸耍滑	zh-CN
tmxk	天马行空	zh-CN
tucg	同室操戈	zh-CN
tuxi	铁石心肠	zh-CN
txdd	通宵达旦	zh-CN
tzdu	天造地设	zh-CN
ubgq	事必躬亲	zh-CN
uhdd	神魂颠倒	zh-CN
uhll	伤痕累累	zh-CN
uhqu	神乎其神	zh-CN
uhuu	实话实说	zh-CN
uidd	说长道短	zh-CN
uirj	受宠若惊	zh-CN
ujdg	伤筋动骨	zh-CN
ujhx	舒筋活血	zh-CN
ujxm	身家性命	zh-CN
uljx	声泪俱下	zh-CN
uryh	拾人牙慧	zh-CN
uubf	身手不凡	zh-CN
uudd	世世代代	zh-CN
uuhr	水深火热	zh-CN
uuli	姗姗来迟	zh-CN
uull	顺顺利利	zh-CN
uuqy	舍生取义	zh-CN
uuuu	生生世世	zh-CN
uuuv	善始善终	zh-CN
uuvh	杀身之祸	zh-CN
uuwd	熟视无睹	zh-CN
uuxx	上上下下	zh-CN
uuyi	身首异处	zh-CN
uvgj	首战告捷	zh-CN
uvjb	失之交臂	zh-CN
uvmg	实至名归	zh-CN
uvww	食之无味	zh-CN
uvyr	受制于人	zh-CN
uvyu	少之又少	zh-CN
uwuj	省委书记	zh-CN
uxxi	蛇蝎心肠	zh-CN
uzju	稍纵即逝	zh-CN
vdyu	掷地有声	zh-CN
vefu	周而复始	zh-CN
vgvj	中规中矩	zh-CN
vgwu	至高无上	zh-CN
vild	争长论短	zh-CN
vjww	朝九晚五	zh-CN
vlvq	直来直去	zh-CN
vqyu	珍禽异兽	zh-CN
vuqr	仗势欺人	zh-CN
vuvd	众矢之的	zh-CN
vvjj	战战兢兢	zh-CN
vvqq	整整齐齐	zh-CN
vvru	蒸蒸日上	zh-CN
vvuu	知之甚少	zh-CN
vvww	支支吾吾	zh-CN
whzi	为虎作伥	zh-CN
wjbc	无坚不摧	zh-CN
wjbf	万劫不复	zh-CN
wjdc	无精打采	zh-CN
wjwu	无拘无束	zh-CN
wlxu	歪理邪说	zh-CN
wubd	为数不多	zh-CN
wubj	无商不奸	zh-CN
wuuf	无事生非	zh-CN
wuwj	万寿无疆	zh-CN
wuwk	无时无刻	zh-CN
wuww	畏首畏尾	zh-CN
wuyh	握手言和	zh-CN
wuyy	巫山云雨	zh-CN
wvvb	瓮中之鳖	zh-CN
wwnn	歪歪扭扭	zh-CN
wwsv	玩物丧志	zh-CN
wwvy	唯物主义	zh-CN
wwyu	万无一失	zh-CN
wwzi	五味杂陈	zh-CN
xbuv	邪不胜正	zh-CN
xbxj	虾兵蟹将	zh-CN
xdyv	相得益彰	zh-CN
xidj	小惩大诫	zh-CN
xidx	新陈代谢	zh-CN
xiwj	相差无几	zh-CN
xiww	喜出望外	zh-CN
xjyk	席卷一空	zh-CN
xlcd	笑里藏刀	zh-CN
xlih	血流成河	zh-CN
xlqb	星罗棋布	zh-CN
xlrv	血流如注	zh-CN
xltj	泄露天机	zh-CN
xluh	心领神会	zh-CN
xlxq	想来想去	zh-CN
xlyt	吓了一跳	zh-CN
xmyj	蓄谋已久	zh-CN
xmyz	心满意足	zh-CN
xnyr	小鸟依人	zh-CN
xnyu	血浓于水	zh-CN
xqlm	贤妻良母	zh-CN
xuyx	修身养性	zh-CN
xxbb	修修补补	zh-CN
xxbn	心绪不宁	zh-CN
xxhu	险象环生	zh-CN
xxji	相形见绌	zh-CN
xxju	小心谨慎	zh-CN
xxll	稀稀拉拉	zh-CN
xxss	潇潇洒洒	zh-CN
xxuu	虚虚实实	zh-CN
xxvv	雄心壮志	zh-CN
xxxy	心心相印	zh-CN
xxyy	香消玉殒	zh-CN
xyfu	咸鱼翻身	zh-CN
xylm	悬崖勒马	zh-CN
xysi	学有所成	zh-CN
ybbn	欲罢不能	zh-CN
ybru	用兵如神	zh-CN
ybvy	一步之遥	zh-CN
ybyy	有板有眼	zh-CN
ybyz	一兵一卒	zh-CN
ycbd	用词不当	zh-CN
ycih	以次充好	zh-CN
ycjb	由此及彼	zh-CN
yckj	由此可见	zh-CN
yhvu	有话直说	zh-CN
yhyu	有话要说	zh-CN
yibb	一成不变	zh-CN
yibd	扬长避短	zh-CN
yibr	一尘不染	zh-CN
yibx	阳春白雪	zh-CN
yidj	已成定局	zh-CN
yidy	一锤定音	zh-CN
yiww	运筹帷幄	zh-CN
yixd	以诚相待	zh-CN
yiyc	阴差阳错	zh-CN
yiyh	一唱一和	zh-CN
yjdk	油尽灯枯	zh-CN
yjhx	衣锦还乡	zh-CN
yjlv	冤家路窄	zh-CN
yjvi	一技之长	zh-CN
yjvs	一己之私	zh-CN
yjvu	远见卓识	zh-CN
yjvz	欲加之罪	zh-CN
yjxy	以儆效尤	zh-CN
yjyc	言尽于此	zh-CN
yjyg	咬紧牙关	zh-CN
ykwy	哑口无言	zh-CN
ylwh	有利无害	zh-CN
yqyq	阴晴圆缺	zh-CN
yrjr	一荣俱荣	zh-CN
yrvu	跃然纸上	zh-CN
yrwu	阅人无数	zh-CN
ysbg	一丝不挂	zh-CN
ytyr	怨天尤人	zh-CN
yubk	一声不吭	zh-CN
yufh	有伤风化	zh-CN
yugj	与世隔绝	zh-CN
yuud	一身是胆	zh-CN
yuvu	有识之士	zh-CN
yuwv	云山雾罩	zh-CN
yuxx	以身相许	zh-CN
yuyb	摇身一变	zh-CN
yuyl	有生以来	zh-CN
yuys	有声有色	zh-CN
yuyu	阴盛阳衰	zh-CN
yuyy	莺声燕语	zh-CN
yuzd	怨声载道	zh-CN
yuzj	咬舌自尽	zh-CN
yvyw	言之有物	zh-CN
ywui	意味深长	zh-CN
yxuj	一线生机	zh-CN
yybd	以怨报德	zh-CN
yydc	抑扬顿挫	zh-CN
yyeu	一拥而上	zh-CN
yyfu	因噎废食	zh-CN
yyhy	以眼还眼	zh-CN
yyii	晕晕沉沉	zh-CN
yynj	一言难尽	zh-CN
yyqi	咬牙切齿	zh-CN
yyss	洋洋洒洒	zh-CN
yywj	引以为戒	zh-CN
yyxr	炎炎夏日	zh-CN
yyyu	跃跃欲试	zh-CN
yyyv	摇摇欲坠	zh-CN
yyyx	一言一行	zh-CN
yyyy	犹犹豫豫	zh-CN
yzlv	一走了之	zh-CN
yzwj	有增无减	zh-CN
zuqy	自食其言	zh-CN
zyzy	自怨自艾	zh-CN
aeby	阿尔巴尼亚	zh-CN
aej	阿尔及利亚	zh-CN
aejy	阿尔及利亚	zh-CN
afet	埃菲尔铁塔	zh-CN
albg	阿拉伯联合酋长国	zh-CN
albz	阿拉伯数字	zh-CN
amds	哀莫大于心死	zh-CN
amsd	阿姆斯特丹	zh-CN
asey	埃塞俄比亚	zh-CN
avyu	爱之欲其生	zh-CN
axhp	按下葫芦起来瓢	zh-CN
bbbd	不比不知道	zh-CN
bblx	便把令来行	zh-CN
bbrd	兵败如山倒	zh-CN
bbyy	巴布亚新几内亚	zh-CN
bcki	病从口入，祸从口出	zh-CN
bdbt	不得不低头	zh-CN
bddt	不登大雅之堂	zh-CN
bdih	不到长城非好汉	zh-CN
bdsh	冰冻三尺，非一日之寒	zh-CN
beuk	布尔什维克	zh-CN
bfil	不费吹灰之力	zh-CN
bfqb	不分青红皂白	zh-CN
bfyz	不费一兵一卒	zh-CN
bfzl	不放在眼里	zh-CN
bgdj	半个多世纪	zh-CN
bgsy	不管三七二十一	zh-CN
bgyb	不敢越雷池一步	zh-CN
bgzv	八竿子打不着	zh-CN
bhbj	饱汉不知饿汉饥	zh-CN
bhpj	不患贫而患不均	zh-CN
bigb	百尺竿头更进一步	zh-CN
biln	拔出萝卜带出泥	zh-CN
bivt	不吃这一套	zh-CN
biys	不吃羊肉惹身臊	zh-CN
bjfi	宝剑锋从磨砺出	zh-CN
bjgl	不见棺材不落泪	zh-CN
bjkl	不积跬步无以至千里	zh-CN
bjmd	不结盟运动	zh-CN
bjty	不见兔子不撒鹰	zh-CN
bjuq	杯酒释兵权	zh-CN
bjux	北京师范大学	zh-CN
bjvx	不见真佛不烧香	zh-CN
bjyv	不经一事不长一智	zh-CN
bksm	不看僧面看佛面	zh-CN
bkty	不可同日而语	zh-CN
bkxw	不可信其无	zh-CN
blr	病来如山倒	zh-CN
blrd	病来如山倒	zh-CN
blvt	别来这一套	zh-CN
bnsy	饱暖思淫欲	zh-CN
bpbh	不怕不识货	zh-CN
bpmu	不怕没柴烧	zh-CN
bpyy	不怕一万，就怕万一	zh-CN
bqgy	毕其功于一役	zh-CN
brhz	不入虎穴，焉得虎子	zh-CN
brmq	被人卖了还帮着数钱	zh-CN
brtw	不如退而结网	zh-CN
bryj	不如意事常八九	zh-CN
bsb	百思不得其解	zh-CN
bsrq	比死人多口气	zh-CN
btiu	不同程度上	zh-CN
btlq	不听老人言，吃亏在眼前	zh-CN
btly	不听老人言	zh-CN
buby	比上不足，比下有余	zh-CN
buhx	不识好人心	zh-CN
buid	不是吃素的	zh-CN
bulm	不识庐山真面目	zh-CN
buud	不是省油的灯	zh-CN
buyp	不是鱼死，就是网破	zh-CN
bvdm	不知道为什么	zh-CN
bve	不战而屈人之兵	zh-CN
bveb	不战而屈人之兵	zh-CN
bvih	扮猪吃老虎	zh-CN
bvnt	不撞南墙不回头	zh-CN
bvqr	不知其所以然	zh-CN
bvth	不知天高地厚	zh-CN
bvvz	不知者不罪	zh-CN
bvwv	不知为不知	zh-CN
bwbj	百闻不如一见	zh-CN
bwwy	不为五斗米折腰	zh-CN
bwyg	霸王硬上弓	zh-CN
bwyu	百无一用是书生	zh-CN
bxbd	不许百姓点灯	zh-CN
bxlq	必先利其器	zh-CN
byns	布宜诺斯艾利斯	zh-CN
bywb	不以物喜，不以己悲	zh-CN
bzku	不做亏心事	zh-CN
bzmp	八字没一撇	zh-CN
bzrc	不遭人妒是庸才	zh-CN
bzwd	不足为外人道	zh-CN
bzwu	包在我身上	zh-CN
cdwl	此地无银三百两	zh-CN
cjcu	曾经沧海难为水	zh-CN
cjtu	从今天开始	zh-CN
cmfw	聪明反被聪明误	zh-CN
cmqk	从目前来看	zh-CN
cmt	从明天开始	zh-CN
cmtu	从明天开始	zh-CN
cuwu	此时无声胜有声	zh-CN
cxzu	从现在开始	zh-CN
cybd	苍蝇不叮无缝的蛋	zh-CN
cyuu	此一时，彼一时	zh-CN
dbry	东边日出西边雨	zh-CN
dbth	大白天说梦话	zh-CN
dbtm	道不同不相为谋	zh-CN
dbvs	打不着狐狸惹身骚	zh-CN
dbzl	蹬鼻子上脸	zh-CN
dclp	打错了算盘	zh-CN
ddbl	当断不断，反受其乱	zh-CN
ddlw	躲得了初一躲不过十五	zh-CN
debx	大恩不言谢	zh-CN
dfbl	东方不亮西方亮	zh-CN
dfhy	洞房花烛夜	zh-CN
dfvi	豆腐渣工程	zh-CN
dfyf	东风压倒西风	zh-CN
dghr	打狗还得看主人	zh-CN
dgyv	道高一尺，魔高一丈	zh-CN
dhqd	打虎亲兄弟	zh-CN
dkfm	大开方便之门	zh-CN
dkth	打开天窗说亮话	zh-CN
dlbr	得理不饶人	zh-CN
dlib	大路朝天，各走一边	zh-CN
dlpg	得了便宜还卖乖	zh-CN
dlqf	得来全不费工夫	zh-CN
dmbl	独木不成林	zh-CN
dmbm	大门不出二门不迈	zh-CN
dmgl	当面鼓对面锣	zh-CN
dmlg	当面锣对面鼓	zh-CN
dmnp	多米诺骨牌	zh-CN
dmqv	到目前为止	zh-CN
dmug	当面是人，背后是鬼	zh-CN
dnbf	大难不死，必有后福	zh-CN
dnlf	大难临头各自飞	zh-CN
dpud	打破砂锅问到底	zh-CN
dpyg	得便宜卖乖	zh-CN
drbg	大人不记小人过	zh-CN
drbl	打人不打脸	zh-CN
drjg	端人家碗，受人家管	zh-CN
drrr	得饶人处且饶人	zh-CN
dryl	大人有大量	zh-CN
dsnr	爹死娘嫁人，各人顾各人	zh-CN
dtbj	低头不见抬头见	zh-CN
dubr	对事不对人	zh-CN
dubt	大事不糊涂	zh-CN
dudl	大树底下好乘凉	zh-CN
dudm	丁是丁，卯是卯	zh-CN
duhl	大事化小，小事化了	zh-CN
duim	大水冲了龙王庙	zh-CN
dupj	读书破万卷	zh-CN
duwq	道是无晴却有晴	zh-CN
dvdv	打着灯笼找不着	zh-CN
dvfr	洞中方一日	zh-CN
dvlz	打肿脸充胖子	zh-CN
dxbb	多行不义必自毙	zh-CN
dxbu	大学毕业生	zh-CN
dxzv	到现在为止	zh-CN
dydy	大眼瞪小眼	zh-CN
dyiy	大鱼吃小鱼	zh-CN
dyjj	东一句西一句	zh-CN
dylb	东一榔头西一棒	zh-CN
dylz	东一榔头西一棒子	zh-CN
dytv	当一天和尚撞一天钟	zh-CN
dyuu	多一事不如少一事	zh-CN
dyuv	大意失荆州	zh-CN
dyyu	大隐隐于市	zh-CN
dzfl	弟子服其劳	zh-CN
dzjx	达则兼济天下	zh-CN
dzzx	刀子嘴豆腐心	zh-CN
ebxp	儿不嫌母丑，狗不嫌家贫	zh-CN
edbn	儿大不由娘	zh-CN
egeu	恩格尔系数	zh-CN
elty	厄立特里亚	zh-CN
enqd	儿女情长，英雄气短	zh-CN
erxv	恶人先告状	zh-CN
esdd	饿死胆小的	zh-CN
esud	饿死事小，失节事大	zh-CN
etw	耳听为虚，眼见为实	zh-CN
etwu	耳听为虚，眼见为实	zh-CN
eusu	二十四小时	zh-CN
euyj	二十一世纪	zh-CN
ewbj	耳闻不如一见	zh-CN
exdu	恶向胆边生	zh-CN
exqy	儿行千里母担忧	zh-CN
eytw	二一添作五	zh-CN
fbie	法不传六耳	zh-CN
ffbd	凡夫不可语道	zh-CN
fgby	富贵不能淫	zh-CN
fiwl	覆巢无完卵	zh-CN
fixy	放长线钓大鱼	zh-CN
flbh	费力不讨好	zh-CN
flbr	翻脸不认人	zh-CN
fllq	风里来，雨里去	zh-CN
fmnj	风马牛不相及	zh-CN
fnjc	飞鸟尽良弓藏	zh-CN
fqbn	夫妻本是同林鸟	zh-CN
fqdv	反其道而行之	zh-CN
frvw	防人之心不可无	zh-CN
fugn	俯首甘为孺子牛	zh-CN
fulv	风水轮流转	zh-CN
fuwy	翻手为云，覆手为雨	zh-CN
fvfv	非政府组织	zh-CN
fvsv	放之四海而皆准	zh-CN
fvvj	发展中国家	zh-CN
fvyx	佛争一炷香	zh-CN
fwzy	非我族类，其心必异	zh-CN
fxhf	福兮祸所伏	zh-CN
fxtf	放下屠刀，立地成佛	zh-CN
fxxh	风萧萧兮易水寒	zh-CN
fyrg	非一日之功	zh-CN
fyrh	非一日之寒	zh-CN
fyu	腹有诗书气自华	zh-CN
fyuh	腹有诗书气自华	zh-CN
gbhm	敢把皇帝拉下马	zh-CN
gbij	高不成低不就	zh-CN
gbvq	高标准严要求	zh-CN
gdwb	各打五十大板	zh-CN
gdzx	公道自在人心	zh-CN
gfbr	功夫不负有心人	zh-CN
gfys	股份有限公司	zh-CN
ghru	隔行如隔山	zh-CN
gibh	高处不胜寒	zh-CN
gilk	刚出狼窝，又入虎口	zh-CN
gjaj	国家安全局	zh-CN
gjbm	恭敬不如从命	zh-CN
glbl	给脸不要脸	zh-CN
glum	古来圣贤皆寂寞	zh-CN
glvd	过了这个村就没这个店	zh-CN
glvl	过了这个村就没这个店了	zh-CN
gnby	敢怒不敢言	zh-CN
gney	敢怒而不敢言	zh-CN
gnuv	国内生产总值	zh-CN
gqb	顾前不顾后	zh-CN
gqbh	顾前不顾后	zh-CN
grbl	果然不出所料	zh-CN
grdu	贵人多忘事	zh-CN
grsu	个人所得税	zh-CN
grzx	各人自扫门前雪	zh-CN
gsdj	哥斯达黎加	zh-CN
gtbw	顾头不顾尾	zh-CN
gthx	光天化日之下	zh-CN
gtsy	管他三七二十一	zh-CN
gugl	公说公有理	zh-CN
guyl	更上一层楼	zh-CN
gwgj	过五关斩六将	zh-CN
gxvq	广西壮族自治区	zh-CN
gyl	狗咬吕洞宾	zh-CN
gytr	挂羊头卖狗肉	zh-CN
gytt	过一天算一天	zh-CN
gyuq	工欲善其事，必先利其器	zh-CN
gyuu	工欲善其事	zh-CN
gyzj	赶鸭子上架	zh-CN
gzbw	赶早不赶晚	zh-CN
gzly	狗嘴里吐不出象牙	zh-CN
gzty	狗嘴吐不出象牙	zh-CN
gzyt	顾左右而言他	zh-CN
hbdq	恨不得有条地缝钻进去	zh-CN
hbtd	话不投机半句多	zh-CN
hbtl	化悲痛为力量	zh-CN
hbum	话不说不明	zh-CN
hdbz	虎毒不食子	zh-CN
hddz	好大的面子	zh-CN
hdlj	皇帝轮流坐，明年到我家	zh-CN
hdux	华东师范大学	zh-CN
hebx	哈尔滨工业大学	zh-CN
hfwz	虎父无犬子	zh-CN
hfxq	化腐朽为神奇	zh-CN
hggb	化干戈为玉帛	zh-CN
hgyq	缓过一口气	zh-CN
hgyu	好钢用在刀刃上	zh-CN
hhbb	好话不说二遍	zh-CN
hhbk	好汉不吃眼前亏	zh-CN
hhbr	惶惶不可终日	zh-CN
hhby	好汉不提当年勇	zh-CN
hhhg	画虎画皮难画骨	zh-CN
hhiy	行行出状元	zh-CN
hhyn	祸害遗千年	zh-CN
hiyj	很长一段时间	zh-CN
hjhq	很久很久以前	zh-CN
hjyy	行家一出手，就知有没有	zh-CN
hkdi	会哭的孩子有奶吃	zh-CN
hklv	花开两朵，各表一枝	zh-CN
hkpy	海阔凭鱼跃	zh-CN
hlew	何乐而不为	zh-CN
hlit	好了疮疤忘了痛	zh-CN
hlpq	虎落平阳被犬欺	zh-CN
hltl	后浪推前浪	zh-CN
hlut	好了伤疤忘了疼	zh-CN
hlyv	坏了一锅粥	zh-CN
hmbc	好马不吃回头草	zh-CN
hmlv	横眉冷对千夫指	zh-CN
hmpa	好马配好鞍	zh-CN
hncj	海内存知己	zh-CN
hnjq	患难见真情	zh-CN
hnux	华南师范大学	zh-CN
hpgz	和平共处五项原则	zh-CN
hqhm	好奇害死猫	zh-CN
hqmu	花钱买罪受	zh-CN
hrbm	好人不长命	zh-CN
hrbs	活人不能让尿憋死	zh-CN
hrvw	害人之心不可有，防人之心不可无	zh-CN
hrvy	害人之心不可有	zh-CN
hsbh	好死不如赖活	zh-CN
hsgn	黑塞哥维那	zh-CN
hskt	哈萨克斯坦	zh-CN
htb	换汤不换药	zh-CN
htbg	恨铁不成钢	zh-CN
htby	横挑鼻子竖挑眼	zh-CN
htxj	滑天下之大稽	zh-CN
hty	回头一笑百媚生	zh-CN
hubl	海水不可斗量	zh-CN
hupv	横竖撇点折	zh-CN
hxdf	好心当成驴肝肺	zh-CN
hxmb	好心没好报	zh-CN
hxzt	好戏在后头	zh-CN
hziw	猴子称大王	zh-CN
ibbn	吃不饱穿不暖	zh-CN
ibds	吃不到葡萄说葡萄酸	zh-CN
ibld	吃饱了撑的	zh-CN
iblh	成不了气候	zh-CN
iblv	吃饱了撑着	zh-CN
iblz	吃不了兜着走	zh-CN
ibzj	成败在此一举	zh-CN
idji	船到江心补漏迟	zh-CN
idjy	赤道几内亚	zh-CN
idqq	拆东墙，补西墙	zh-CN
idqv	船到桥头自然直	zh-CN
idtv	吹得天花乱坠	zh-CN
idul	车到山前必有路	zh-CN
ifiu	春风吹又生	zh-CN
ifjw	除非己莫为	zh-CN
ifpu	长风破浪会有时	zh-CN
igzm	陈谷子烂芝麻	zh-CN
ihut	丑话说在前头	zh-CN
ihvp	窗户纸一点就破	zh-CN
ihzy	吹胡子瞪眼	zh-CN
iihz	赤橙黄绿青蓝紫	zh-CN
ijbq	出简不出全	zh-CN
ijhl	长江后浪推前浪	zh-CN
ikzq	吃亏在眼前	zh-CN
ilbd	吃了豹子胆	zh-CN
ilbh	吃力不讨好	zh-CN
ilbu	吃粮不管事	zh-CN
imyi	柴米油盐酱醋茶	zh-CN
iqwy	除却巫山不是云	zh-CN
irbt	吃人不吐骨头	zh-CN
irby	吃软不吃硬	zh-CN
irbz	成人不自在	zh-CN
irjd	吃人家的嘴短	zh-CN
irjg	吃人家饭，受人家管	zh-CN
irlg	常任理事国	zh-CN
irxh	仇人相见，分外眼红	zh-CN
isdd	撑死胆大的	zh-CN
issi	楚虽三户，亡秦必楚	zh-CN
itbt	长痛不如短痛	zh-CN
ittg	赤条条来去无牵挂	zh-CN
iuby	成事不足，败事有余	zh-CN
iunh	初生牛犊不怕虎	zh-CN
ivmz	陈芝麻烂谷子	zh-CN
ivwk	成者王侯败者寇	zh-CN
ivwl	吃着碗里，望着锅里	zh-CN
ivyg	朝中有人好做官	zh-CN
ixd	吃香的喝辣的	zh-CN
ixfp	丑媳妇总得见公婆	zh-CN
ixht	船小好调头	zh-CN
ixjb	城乡结合部	zh-CN
iyqv	吃一堑，长一智	zh-CN
iysi	尺有所短，寸有所长	zh-CN
iytz	穿一条裤子	zh-CN
iyxh	成也萧何，败也萧何	zh-CN
iyyh	初一一回十五一回	zh-CN
izhz	常在河边走	zh-CN
jbtu	金榜题名时	zh-CN
jbwz	久病无孝子	zh-CN
jdbl	旧的不去，新的不来	zh-CN
jddl	叫地地不灵	zh-CN
jdlt	鸡蛋里挑骨头	zh-CN
jdpt	鸡蛋碰石头	zh-CN
jdub	剪刀石头布	zh-CN
jejt	吉尔吉斯斯坦	zh-CN
jfjy	见风就是雨	zh-CN
jfvc	疾风知劲草	zh-CN
jfvu	酒逢知己千杯少	zh-CN
jgjy	鞠躬尽瘁，死而后已。	zh-CN
jguh	见鬼说鬼话	zh-CN
jhfl	久旱逢甘霖	zh-CN
jhmk	计划没有变化快	zh-CN
jhqx	饥寒起盗心	zh-CN
jhty	酒后吐真言	zh-CN
jhul	姜还是老的辣	zh-CN
jivt	就吃这一套	zh-CN
jjbj	敬酒不吃吃罚酒	zh-CN
jjbr	岌岌不可终日	zh-CN
jjfv	急惊风撞着慢郎中	zh-CN
jjsg	嫁鸡随鸡，嫁狗随狗	zh-CN
jjyj	家家有本难念的经	zh-CN
jksk	捷克斯洛伐克	zh-CN
jlhr	解铃还须系铃人	zh-CN
jlvg	捡了芝麻，丢了西瓜	zh-CN
jlvv	既来之，则安之	zh-CN
jlzy	鸡烂嘴巴硬	zh-CN
jmhy	旧貌换新颜	zh-CN
jmut	金木水火土	zh-CN
jmyh	救民于水火	zh-CN
jnel	九牛二虎之力	zh-CN
jphh	就怕货比货	zh-CN
jraf	见人矮三分	zh-CN
jrqw	拒人千里之外	zh-CN
jruh	见人说人话	zh-CN
jryw	拒人于千里之外	zh-CN
jrzx	吉人自有天相	zh-CN
jsbr	己所不欲，勿施于人	zh-CN
jtdu	惊天地泣鬼神	zh-CN
jtgy	姜太公钓鱼	zh-CN
jtli	脚踏两只船	zh-CN
jtsp	狡兔死走狗烹	zh-CN
jtty	叫天天不应	zh-CN
jtwx	具体问题具体分析	zh-CN
jubr	今时不同往日	zh-CN
judi	江山代有才人出	zh-CN
judj	家书抵万金	zh-CN
july	近水楼台先得月	zh-CN
junr	几十年如一日	zh-CN
juqw	决胜千里之外	zh-CN
juvq	积善之家，必有余庆	zh-CN
jvcx	绝知此事要躬行	zh-CN
jvvh	近朱者赤，近墨者黑	zh-CN
jvyz	今朝有酒今朝醉	zh-CN
jxbu	酒香不怕巷子深	zh-CN
jyuv	经一事，长一智	zh-CN
jzad	君子爱财，取之有道	zh-CN
jzbv	尽在不言中	zh-CN
jzdu	君子动口不动手	zh-CN
jzx	箭在弦上，不得不发	zh-CN
jzxf	箭在弦上，不得不发	zh-CN
jzyi	君子远庖厨	zh-CN
jzyv	君子一言，驷马难追	zh-CN
kdjv	看得见摸得着	zh-CN
kdvm	快刀斩乱麻	zh-CN
kgmj	开弓没有回头箭	zh-CN
khev	口惠而实不至	zh-CN
kkuh	空口说白话	zh-CN
klmg	克里姆林宫	zh-CN
klvi	可怜之人必有可恨之处	zh-CN
ktrk	慷他人之慨	zh-CN
kutl	空手套白狼	zh-CN
kvin	开张吃三年	zh-CN
kvmh	苛政猛于虎	zh-CN
kwbj	可望不可即	zh-CN
kwej	可望而不可即	zh-CN
kybq	可遇不可求	zh-CN
kyrs	可与人言无二三	zh-CN
lahc	柳暗花明又一村	zh-CN
lbdj	联邦调查局	zh-CN
lbqa	萝卜青菜，各有所爱	zh-CN
lbqb	劣币驱逐良币	zh-CN
ldqz	留得青山在	zh-CN
ldrg	礼多人不怪	zh-CN
ldrk	来得容易去得快	zh-CN
ldtb	老大徒伤悲	zh-CN
ldyp	乱点鸳鸯谱	zh-CN
leb	来而不往非礼也	zh-CN
lebu	两耳不闻窗外事	zh-CN
lebz	老而不死是为贼	zh-CN
lgdu	两个多小时	zh-CN
lgju	两国交兵，不斩来使	zh-CN
lhbc	脸红脖子粗	zh-CN
lhjj	烈火见真金	zh-CN
lhmr	癞蛤蟆想吃天鹅肉	zh-CN
lhpd	老虎屁股摸不得	zh-CN
libz	驴唇不对马嘴	zh-CN
liht	脸朝黄土背朝天	zh-CN
liyv	乱成一锅粥	zh-CN
ljil	老将出马，一个顶俩	zh-CN
ljll	廉价劳动力	zh-CN
lkyk	雷克雅未克	zh-CN
lllj	理论联系实际	zh-CN
llvt	老来这一套	zh-CN
lmmx	路漫漫其修远兮	zh-CN
lnfq	烂泥扶不上墙	zh-CN
lnic	老牛吃嫩草	zh-CN
lqqv	礼轻情意重	zh-CN
lsbl	老死不相往来	zh-CN
lsld	临死拉个垫背的	zh-CN
lub	临时抱佛脚	zh-CN
ludx	雷声大，雨点小	zh-CN
lugd	老鼠过街人人喊打	zh-CN
lujt	龙生九子各不同	zh-CN
luvm	庐山真面目	zh-CN
luyd	乱世用重典	zh-CN
lvbl	来者不善，善者不来	zh-CN
lwbr	里外不是人	zh-CN
lwyz	来无影，去无踪	zh-CN
lxfz	量小非君子	zh-CN
lydg	路有冻死骨	zh-CN
lyrl	里约热内卢	zh-CN
lytm	鲤鱼跳龙门	zh-CN
lyvl	路遥知马力	zh-CN
lyvv	流言止于智者	zh-CN
lyyh	两眼一抹黑	zh-CN
lzdl	烂在肚子里	zh-CN
lzdy	林子大了，什么鸟都有	zh-CN
lzhh	浪子回头金不换	zh-CN
lzyh	老子英雄儿好汉	zh-CN
mbgt	面不改色心不跳	zh-CN
mbjv	名不见经传	zh-CN
mbvn	摸不着头脑	zh-CN
mdbg	磨刀不误砍柴工	zh-CN
mdjj	马达加斯加	zh-CN
mgih	慢工出细活	zh-CN
mgpy	卖狗皮膏药	zh-CN
mgtu	莫管他人瓦上霜	zh-CN
mhxl	梅花香自苦寒来	zh-CN
migp	没吃过猪肉，还没见过猪跑	zh-CN
mjgm	没见过世面	zh-CN
mkhb	猫哭耗子假慈悲	zh-CN
mkly	密克罗尼西亚	zh-CN
mllx	马里兰大学	zh-CN
mlvh	米粒之珠，也放光华	zh-CN
mmbz	买卖不成仁义在	zh-CN
mmhv	眉毛胡子一把抓	zh-CN
mnmr	某年某月某日	zh-CN
mnxf	没那闲工夫	zh-CN
mqsq	麻雀虽小，五脏俱全	zh-CN
mrb	明人不说暗话	zh-CN
mrbh	明人不说暗话	zh-CN
mrbu	明人不做暗事	zh-CN
mrbz	骂人不带脏字	zh-CN
mrqm	盲人骑瞎马	zh-CN
mtxw	冒天下之大不韪	zh-CN
mubq	马善被人骑	zh-CN
mubx	瞒上不瞒下	zh-CN
muit	名师出高徒	zh-CN
mulx	麻省理工大学	zh-CN
mutl	没事偷着乐	zh-CN
muzt	谋事在人，成事在天	zh-CN
mvsy	满招损，谦受益	zh-CN
mvu	摸着石头过河	zh-CN
mvuh	明知山有虎	zh-CN
mvux	明知山有虎，偏向虎山行	zh-CN
mxyv	木秀于林，风必摧之	zh-CN
mybq	没有不透风的墙	zh-CN
mybx	没有不散的筵席	zh-CN
mygy	没有规矩不成方圆	zh-CN
mymc	没有免费的午餐	zh-CN
myut	民以食为天	zh-CN
mzjf	灭自己威风	zh-CN
mzpi	满嘴跑火车	zh-CN
nbht	牛不喝水强按头	zh-CN
nbry	你不仁我不义	zh-CN
ncxq	怒从心头起	zh-CN
ndbd	那倒不一定	zh-CN
ndqx	拿得起放得下	zh-CN
ndub	女大十八变	zh-CN
nedq	男儿当自强	zh-CN
nexj	男儿膝下有黄金	zh-CN
neyt	男儿有泪不轻弹	zh-CN
ngtu	哪管他人瓦上霜	zh-CN
nhbh	哪壶不开提哪壶	zh-CN
nhkd	内行看门道	zh-CN
njbq	内举不避亲	zh-CN
nkxy	宁可信其有	zh-CN
nljj	拿了鸡毛当令箭	zh-CN
nlkq	哪凉快哪呆着去	zh-CN
nlyh	捏了一把汗	zh-CN
nmgq	内蒙古自治区	zh-CN
nns	年年岁岁花相似	zh-CN
nnuq	男女授受不亲	zh-CN
npjl	女怕嫁错郎	zh-CN
nprh	男怕入错行	zh-CN
npsh	泥菩萨过河	zh-CN
nrjr	拿人家的手软	zh-CN
nrsn	能人所不能	zh-CN
ntbz	牛头不对马嘴	zh-CN
nvjj	拿着鸡毛当令箭	zh-CN
nvyh	捏着一把汗	zh-CN
nxhq	宁夏回族自治区	zh-CN
nyb	哪有不湿鞋	zh-CN
nyut	难于上青天	zh-CN
nyvt	你有张良计，我有过墙梯	zh-CN
nzbu	脑子不好使	zh-CN
nzhf	男子汉大丈夫	zh-CN
pdlu	跑得了和尚	zh-CN
pgzu	破罐子破摔	zh-CN
plfb	赔了夫人又折兵	zh-CN
plhm	跑了和尚跑不了庙	zh-CN
plyh	碰了一鼻子灰	zh-CN
ptlx	抛头颅洒热血	zh-CN
publ	平时不努力	zh-CN
pubx	平时不烧香	zh-CN
pupl	婆说婆有理	zh-CN
pvbf	皮之不存，毛将焉附	zh-CN
pvyl	披着羊皮的狼	zh-CN
pxhx	偏向虎山行	zh-CN
pxrx	皮笑肉不笑	zh-CN
pybh	碰一鼻子灰	zh-CN
pymh	便宜没好货	zh-CN
pywh	便宜无好货	zh-CN
qbdl	气不打一处来	zh-CN
qbvd	前不着村，后不着店	zh-CN
qcla	青菜萝卜各有所爱	zh-CN
qdgy	七大姑八大姨	zh-CN
qdin	枪打出头鸟	zh-CN
qdnf	千叮咛万嘱咐	zh-CN
qdty	求大同，存小异	zh-CN
qdvt	墙倒众人推	zh-CN
qfdc	棋逢对手，将遇良才	zh-CN
qfni	巧妇难为无米之炊	zh-CN
qfsy	秋风扫落叶	zh-CN
qgbt	缺胳膊少腿	zh-CN
qgnu	清官难断家务事	zh-CN
qgql	桥归桥，路归路	zh-CN
qjbj	请将不如激将	zh-CN
qjsl	千金散尽还复来	zh-CN
qjub	强将手下无弱兵	zh-CN
qjvt	千金之子，坐不垂堂	zh-CN
qkdy	乾坤大挪移	zh-CN
qlge	曲里拐弯儿	zh-CN
qlsm	千里送鹅毛	zh-CN
qlxn	娶了媳妇忘了娘	zh-CN
qlyq	千里姻缘一线牵	zh-CN
qlyv	欠了一屁股债	zh-CN
qndt	强扭的瓜不甜	zh-CN
qnkx	墙内开花墙外香	zh-CN
qplh	前怕狼，后怕虎	zh-CN
qpvg	七品芝麻官	zh-CN
qqev	群起而攻之	zh-CN
qrzl	前人栽树，后人乘凉	zh-CN
qurn	请神容易送神难	zh-CN
qvbt	牵着不走，打着倒退	zh-CN
qvgu	强中更有强中手	zh-CN
qvrj	弃之如敝屐	zh-CN
qvrl	弃之如敝履	zh-CN
qvzu	强中自有强中手	zh-CN
qyby	前言不搭后语	zh-CN
qypv	欠一屁股债	zh-CN
qyyn	求爷爷告奶奶	zh-CN
qzdu	穷则独善其身	zh-CN
qzxw	擒贼先擒王	zh-CN
rbfr	人不犯我，我不犯人	zh-CN
rbk	人不可貌相，海水不可斗量	zh-CN
rbkl	人不可貌相，海水不可斗量	zh-CN
rbkx	人不可貌相	zh-CN
rblg	日不落帝国	zh-CN
rbqq	惹不起还躲不起	zh-CN
rbzg	肉包子打狗	zh-CN
rdhh	人多好干活	zh-CN
rglu	人过留名，雁过留声	zh-CN
rgly	热锅里的蚂蚁	zh-CN
rguy	热锅上的蚂蚁	zh-CN
rjjx	日久见人心	zh-CN
rjvq	人间重晚晴	zh-CN
rlzl	肉烂在锅里	zh-CN
rpiv	人怕出名猪怕壮	zh-CN
rrdv	人人得而诛之	zh-CN
rrfr	人若犯我，我必犯人	zh-CN
rrwj	如入无人之境	zh-CN
rsbs	人算不如天算	zh-CN
rsrm	人死如灯灭	zh-CN
rubq	人善被人欺	zh-CN
rudu	人生地不熟	zh-CN
rulu	人生路不熟	zh-CN
rutg	人是铁饭是钢	zh-CN
rvey	任重而道远	zh-CN
rviu	人之初，性本善	zh-CN
rvju	人之将死，其言也善	zh-CN
rwd	人为刀俎，我为鱼肉	zh-CN
rwdr	人为刀俎，我为鱼肉	zh-CN
rwgl	人往高处走，水往低处流	zh-CN
rwxu	润物细无声	zh-CN
rwy	人无远虑，必有近忧	zh-CN
rwyy	人无远虑，必有近忧	zh-CN
rxb	人心不足蛇吞象	zh-CN
rxbx	人心不足蛇吞象	zh-CN
rxgp	人心隔肚皮	zh-CN
rxqy	人心齐泰山移	zh-CN
rxvn	瑞雪兆丰年	zh-CN
rydf	人有旦夕祸福	zh-CN
rylx	仁义礼智信	zh-CN
ryrv	若要人不知	zh-CN
rys	日有所思，夜有所梦	zh-CN
rysm	日有所思，夜有所梦	zh-CN
rzjj	人在江湖，身不由己	zh-CN
rzwt	人在屋檐下，不得不低头	zh-CN
rzwx	人在屋檐下	zh-CN
sbbb	三步并作两步	zh-CN
sblh	三百六十行	zh-CN
sbyu	三步一岗，五步一哨	zh-CN
scbu	三寸不烂之舌	zh-CN
sdgm	斯德哥尔摩	zh-CN
sfqy	随风潜入夜	zh-CN
sfsx	送佛送到西	zh-CN
sfxg	三分像人，七分像鬼	zh-CN
sgdu	三个多小时	zh-CN
sghi	三个和尚没水吃	zh-CN
sgij	三个臭皮匠	zh-CN
sgvl	赛过诸葛亮	zh-CN
shvd	四海之内皆兄弟	zh-CN
sjhh	三句话不离本行	zh-CN
sjjd	所见即所得	zh-CN
slwy	斯洛文尼亚	zh-CN
slyq	松了一口气	zh-CN
smdy	死马当活马医	zh-CN
smvx	司马昭之心	zh-CN
snbv	三年不开张	zh-CN
snqy	三年清知府，十万雪花银	zh-CN
spnv	撒泡尿照照	zh-CN
sqey	三七二十一	zh-CN
srxu	三人行，必有我师	zh-CN
ssnt	岁岁年年人不同	zh-CN
ssxd	三岁小孩都知道	zh-CN
stdw	三天打鱼，两天晒网	zh-CN
stfx	斯坦福大学	zh-CN
stkx	酸甜苦辣咸	zh-CN
stsw	三天三夜说不完	zh-CN
svbt	死猪不怕开水烫	zh-CN
swzd	死无葬身之地	zh-CN
sxwe	三下五除二	zh-CN
sybr	岁月不饶人	zh-CN
sydx	所以动心忍性	zh-CN
sywx	死亦为鬼雄	zh-CN
sztd	色字头上一把刀	zh-CN
tbxq	特别行政区	zh-CN
tdhq	跳到黄河洗不清	zh-CN
tdjl	贪多嚼不烂	zh-CN
tdwh	天打五雷轰	zh-CN
teqc	退而求其次	zh-CN
tfid	头发长见识短	zh-CN
tfjy	听风就是雨	zh-CN
tgbi	同工不同酬	zh-CN
tghy	天高皇帝远	zh-CN
tgml	天刚蒙蒙亮	zh-CN
tgrf	天高任鸟飞	zh-CN
timv	铁杵磨成针	zh-CN
tjbl	天机不可泄露	zh-CN
tjbm	偷鸡不着蚀把米	zh-CN
tjhq	跳进黄河洗不清	zh-CN
tjjl	团结就是力量	zh-CN
tjkt	塔吉克斯坦	zh-CN
tjyh	听君一席话	zh-CN
tklg	塔克拉玛干	zh-CN
tkmt	土库曼斯坦	zh-CN
tlbh	螳螂捕蝉，黄雀在后	zh-CN
tlbx	桃李不言，下自成蹊	zh-CN
tlmx	桃李满天下	zh-CN
tlng	特立尼达和多巴哥	zh-CN
tmbw	天命不可违	zh-CN
tptf	踏破铁鞋无觅处，得来全不费工夫	zh-CN
tqyx	听其言而观其行	zh-CN
trqu	天然去雕饰	zh-CN
tryl	天若有情天亦老	zh-CN
tstt	太岁头上动土	zh-CN
ttdm	条条大路通罗马	zh-CN
tttr	剃头挑子一头热	zh-CN
ttyj	头痛医头，脚痛医脚	zh-CN
tubb	天上不会掉馅饼	zh-CN
tudb	天上掉馅饼	zh-CN
tudh	天时地利人和	zh-CN
tusg	台上三分钟，台下十年功	zh-CN
tutr	同是天涯沦落人	zh-CN
tuwy	天生我材必有用	zh-CN
twjl	天无绝人之路	zh-CN
twlp	天王老子都不怕	zh-CN
txbu	天下本无事	zh-CN
txmc	天下没有白吃的午餐	zh-CN
txwh	天下乌鸦一般黑	zh-CN
txwx	天下无不散之筵席	zh-CN
txyr	谈笑有鸿儒	zh-CN
txyv	他乡遇故知	zh-CN
tyby	天有不测风云	zh-CN
tycl	太阳从西边出来	zh-CN
tyrl	天涯若比邻	zh-CN
tywu	退一万步说	zh-CN
tyxr	天要下雨，娘要嫁人	zh-CN
tyxw	跳跃性思维	zh-CN
tzhl	投资回报率	zh-CN
tznu	天作孽犹可恕	zh-CN
ubby	十八般武艺	zh-CN
ubdq	生不带来，死不带去	zh-CN
ubjn	胜不骄，败不馁	zh-CN
ubum	失败是成功之母	zh-CN
ubvj	神不知鬼不觉	zh-CN
ubvv	山不转水转	zh-CN
uccd	说曹操曹操到	zh-CN
udbt	说的比唱的好听	zh-CN
udhs	树倒猢狲散	zh-CN
udji	生旦净末丑	zh-CN
udmb	圣多美和普林西比	zh-CN
udnt	蜀道难，难于上青天	zh-CN
uduh	上刀山，下火海	zh-CN
uduu	胜读十年书	zh-CN
udyb	伤敌一千，自损八百	zh-CN
udyu	书到用时方恨少	zh-CN
udzj	生当作人杰	zh-CN
ufbg	是福不是祸，是祸躲不过	zh-CN
ughy	山高皇帝远	zh-CN
ugmt	视功名如粪土	zh-CN
uhbr	水火不相容	zh-CN
uhux	上海师范大学	zh-CN
uiul	山重水复疑无路	zh-CN
ujbr	时间不等人	zh-CN
ujcs	圣基茨和尼维斯	zh-CN
ujdt	伤筋动骨一百天	zh-CN
ujgk	杀鸡给猴看	zh-CN
ujiv	实践出真知	zh-CN
ujvu	食君之禄，忠君之事	zh-CN
ujyd	杀鸡焉用牛刀	zh-CN
ukrr	是可忍，孰不可忍	zh-CN
uljw	神龙见首不见尾	zh-CN
ullq	水里来火里去	zh-CN
ulvt	少来这一套	zh-CN
ulzl	是骡子是马，拉出来溜溜	zh-CN
ulzm	是骡子是马	zh-CN
umvf	生米煮成熟饭	zh-CN
umzf	生米做成熟饭	zh-CN
unb	少年不努力	zh-CN
unbl	少年不努力	zh-CN
unhx	十年河东，十年河西	zh-CN
unjy	十年九不遇	zh-CN
unmj	十年磨一剑	zh-CN
unp	说你胖你就喘	zh-CN
unpi	说你胖你就喘	zh-CN
unpu	十年怕井绳	zh-CN
unrr	十年如一日	zh-CN
unu	十年生死两茫茫	zh-CN
unur	十年树木，百年树人	zh-CN
uqbq	上气不接下气	zh-CN
uqnu	双拳难敌四手	zh-CN
urb	杀人不见血	zh-CN
urbx	杀人不见血	zh-CN
urby	杀人不眨眼	zh-CN
uriq	杀人偿命，欠债还钱	zh-CN
ury	授人以鱼，不如授人以渔	zh-CN
urzj	山人自有妙计	zh-CN
usdd	瘦死的骆驼比马大	zh-CN
usld	瘦死骆驼比马大	zh-CN
utab	沙特阿拉伯	zh-CN
utw	上天无路，入地无门	zh-CN
utwm	上天无路，入地无门	zh-CN
uubr	伸手不打笑脸人	zh-CN
uubv	伸手不见五指	zh-CN
uuik	说时迟，那时快	zh-CN
uurn	上山容易下山难	zh-CN
uuub	事实胜于雄辩	zh-CN
uuwj	识时务者为俊杰	zh-CN
uuyn	世上已千年	zh-CN
uuzx	时势造英雄	zh-CN
uvfb	上阵父子兵	zh-CN
uvfr	山中方一日	zh-CN
uvqy	水至清则无鱼	zh-CN
uvtl	上知天文，下知地理	zh-CN
uvwh	山中无老虎	zh-CN
uvwk	胜者为王败者寇	zh-CN
uwbl	十万八千里	zh-CN
uwcy	身无彩凤双飞翼	zh-CN
uwdx	生物多样性	zh-CN
uwfl	手无缚鸡之力	zh-CN
uwss	圣文森特和格林纳丁斯	zh-CN
uwvs	士为知己者死	zh-CN
uxwn	上下五千年	zh-CN
uyfh	扇阴风，点鬼火	zh-CN
uyiy	师夷长技以制夷	zh-CN
uyjn	事因经过始知难	zh-CN
uyjv	树欲静而风不止	zh-CN
uylx	上有老下有小	zh-CN
uyqw	说一千道一万	zh-CN
uyss	生于斯长于斯	zh-CN
uyyg	术业有专攻	zh-CN
uyyl	山雨欲来风满楼	zh-CN
uzdk	狮子大开口	zh-CN
uzff	身在福中不知福	zh-CN
vbbb	治标不治本	zh-CN
vcku	注册会计师	zh-CN
vehn	丈二和尚摸不着头脑	zh-CN
vfgg	政府工作报告	zh-CN
vfzy	照方子抓药	zh-CN
vgrx	中国人民大学	zh-CN
vhrg	中华人民共和国	zh-CN
vibv	忠臣不事二主	zh-CN
vjbl	真金不怕火炼	zh-CN
vjlx	煮酒论英雄	zh-CN
vjsv	珠江三角洲	zh-CN
vkby	中看不中用	zh-CN
vkyi	只可意会，不可言传	zh-CN
vlvt	皱了皱眉头	zh-CN
vmji	朱门酒肉臭	zh-CN
vmlf	珠穆朗玛峰	zh-CN
vna	智能ABC	zh-CN
vpyr	只怕有心人	zh-CN
vqbv	知其不可而为之	zh-CN
vqsr	知其所以然	zh-CN
vrbx	真人不露相	zh-CN
vrug	众人拾柴火焰高	zh-CN
vrvx	知人知面不知心	zh-CN
vryd	置人于死地	zh-CN
vtrf	长他人志气，灭自己威风	zh-CN
vtrq	长他人志气	zh-CN
vudq	纸上得来终觉浅	zh-CN
vudr	只是当时已惘然	zh-CN
vuwg	这山望着那山高	zh-CN
vuyf	壮士一去兮不复返	zh-CN
vvmu	占着茅坑不拉屎	zh-CN
vvqe	只知其一不知其二	zh-CN
vvut	站着说话不嫌腰疼	zh-CN
vvwv	知之为知之	zh-CN
vvy	睁只眼闭只眼	zh-CN
vvyh	睁着眼睛说瞎话	zh-CN
vvyr	只重衣衫不重人	zh-CN
vwdy	朝闻道，夕死可矣	zh-CN
vxbq	忠孝不能两全	zh-CN
vxvd	只许州官放火，不许百姓点灯	zh-CN
vxvh	只许州官放火	zh-CN
vxyx	只羡鸳鸯不羡仙	zh-CN
vydg	周瑜打黄盖	zh-CN
vydt	中央电视台	zh-CN
vygt	中央广播电台	zh-CN
vyqj	中央情报局	zh-CN
vyrf	中央人民政府	zh-CN
vyrt	中央人民广播电台	zh-CN
vyuh	睁眼说瞎话	zh-CN
vyuv	只缘身在此山中	zh-CN
vywi	只因未到伤心处	zh-CN
vyyy	睁一眼闭一眼	zh-CN
vzmf	知子莫若父	zh-CN
vzvl	执子之手，与子偕老	zh-CN
wbbz	万变不离其宗	zh-CN
wbjp	万般皆下品	zh-CN
wbry	我不入地狱谁入地狱	zh-CN
wdbf	无毒不丈夫	zh-CN
wdmy	五斗米折腰	zh-CN
wdyx	无敌于天下	zh-CN
wfbl	无风不起浪	zh-CN
wgbl	无功不受禄	zh-CN
wge	温故而知新	zh-CN
wgex	温故而知新	zh-CN
wgyq	无官一身轻	zh-CN
whgy	无后顾之忧	zh-CN
whjh	王侯将相宁有种乎	zh-CN
whkn	外行看热闹	zh-CN
wjus	吾将上下而求索	zh-CN
wkld	挽狂澜于既倒	zh-CN
wknq	无可奈何花落去	zh-CN
wktl	唯恐天下不乱	zh-CN
wkwk	无可无不可	zh-CN
wlcx	无理寸步难行	zh-CN
wlgr	温良恭俭让	zh-CN
wlvd	无立锥之地	zh-CN
wmbm	闻名不如见面	zh-CN
wqbu	无巧不成书	zh-CN
wrm	为人民服务	zh-CN
wrmw	为人民服务	zh-CN
wsbj	无所不用其极	zh-CN
wtru	为他人作嫁衣裳	zh-CN
wtrx	为他人着想	zh-CN
wubb	五十步笑百步	zh-CN
wubr	万事不求人	zh-CN
wujf	万事俱备，只欠东风	zh-CN
wukn	万事开头难	zh-CN
wuvm	五十知天命	zh-CN
wvfy	无政府主义	zh-CN
wvvw	无知者无畏	zh-CN
wvys	恶之欲其死	zh-CN
wwel	无往而不利	zh-CN
wwmd	万万没想到	zh-CN
wydg	唯有读书高	zh-CN
wyev	勿以恶小而为之	zh-CN
wyuw	勿以善小而不为	zh-CN
wywd	无用武之地	zh-CN
wyxc	为伊消得人憔悴	zh-CN
wyxg	物以稀为贵	zh-CN
wzbt	乌兹别克斯坦	zh-CN
wzdt	稳坐钓鱼台	zh-CN
wzfz	王子犯法与庶民同罪	zh-CN
xajx	西安交通大学	zh-CN
xbgx	行不更名，坐不改姓	zh-CN
xbru	下笔如有神	zh-CN
xbxn	信不信由你	zh-CN
xcbm	秀才不出门	zh-CN
xcyb	秀才遇到兵	zh-CN
xcyq	秀才遇到兵，有理说不清	zh-CN
xczi	秀才造反，三年不成	zh-CN
xdiu	相当程度上	zh-CN
xdtj	兄弟同心，其利断金	zh-CN
xeuv	学而时习之	zh-CN
xeyu	学而优则仕	zh-CN
xfap	媳妇熬成婆	zh-CN
xfhu	相逢何必曾相识	zh-CN
xfyi	相逢一笑泯恩仇	zh-CN
xgbi	响鼓不需重锤	zh-CN
xgir	习惯成自然	zh-CN
xgjx	香港浸会大学	zh-CN
xgkx	香港科技大学	zh-CN
xglj	小概率事件	zh-CN
xglx	香港理工大学	zh-CN
xguh	新官上任三把火	zh-CN
xgv	香港中文大学	zh-CN
xgyv	行高于人，众必非之	zh-CN
xgzr	相关责任人	zh-CN
xhiu	鲜花插在牛粪上	zh-CN
xilx	咸吃萝卜淡操心	zh-CN
xjif	心急吃不了热豆腐	zh-CN
xjja	雄赳赳，气昂昂	zh-CN
xjpx	新加坡国立大学	zh-CN
xjwq	新疆维吾尔自治区	zh-CN
xlbe	迅雷不及掩耳	zh-CN
xlil	心理承受能力	zh-CN
xpvj	新瓶装旧酒	zh-CN
xqlj	小桥流水人家	zh-CN
xtxl	先天下之忧而忧，后天下之乐而乐	zh-CN
xtzh	挟天子以令诸侯	zh-CN
xvls	新账老账一起算	zh-CN
xvyv	闲着也是闲着	zh-CN
xwjw	小巫见大巫	zh-CN
xxmc	小心没大错	zh-CN
xxrz	先小人后君子	zh-CN
xxuq	先下手为强	zh-CN
xylt	心有灵犀一点通	zh-CN
xywh	夕阳无限好	zh-CN
xyyy	小隐隐于野	zh-CN
xzzq	西藏自治区	zh-CN
ybbl	一把鼻涕一把泪	zh-CN
ybcc	一步错，步步错	zh-CN
ybhb	一报还一报	zh-CN
ybil	哑巴吃黄连	zh-CN
ybjf	眼不见，心不烦	zh-CN
ybjj	眼不见为净	zh-CN
ybjx	语不惊人死不休	zh-CN
ybkq	一鼻孔出气	zh-CN
ybpm	犹抱琵琶半遮面	zh-CN
ybqu	养兵千日，用兵一时	zh-CN
ybrg	衣不如新，人不如故	zh-CN
ybst	一步三回头	zh-CN
ybun	一把屎一把尿	zh-CN
ybvq	玉不琢，不成器	zh-CN
ybwq	一波未平一波又起	zh-CN
ybxg	言必信，行必果	zh-CN
ybxq	咽不下这口气	zh-CN
ybxt	一比吓一跳	zh-CN
ybzx	一不做，二不休	zh-CN
ybzy	有鼻子有眼	zh-CN
ycgj	一寸光阴一寸金	zh-CN
ydbj	一动不如一静	zh-CN
yddx	有多大关系	zh-CN
ydiu	一定程度上	zh-CN
ydsb	亚的斯亚贝巴	zh-CN
ydtx	一定条件下	zh-CN
ydyy	有多远滚多远	zh-CN
yezs	一而再，再而三	zh-CN
yfbu	一发不可收	zh-CN
yfd	一夫当关，万夫莫开	zh-CN
yfdk	一夫当关，万夫莫开	zh-CN
yfdy	要风得风，要雨得雨	zh-CN
yfgh	一分耕耘，一分收获	zh-CN
yfqh	一分钱一分货	zh-CN
yftd	有福同享，有难同当	zh-CN
yfur	一方水土养一方人	zh-CN
ygbg	一个比一个	zh-CN
ygbq	一个鼻孔出气	zh-CN
ygbx	一个巴掌拍不响	zh-CN
ygdq	一个多星期	zh-CN
ygdu	一个多小时	zh-CN
ygil	一个唱红脸，一个唱白脸	zh-CN
ygjg	一个接一个	zh-CN
yglf	眼观六路，耳听八方	zh-CN
ygli	阴沟里翻船	zh-CN
yglk	一个萝卜一个坑	zh-CN
ygrd	艺高人胆大	zh-CN
ygt	一个天上一个地下	zh-CN
ygtd	一个头两个大	zh-CN
ygut	一个手指头	zh-CN
ygvj	有过之而无不及	zh-CN
ygya	一个愿打，一个愿挨	zh-CN
ygzd	一竿子到底	zh-CN
ygzs	一棍子打死	zh-CN
yhbt	一行白鹭上青天	zh-CN
yhlp	依葫芦画瓢	zh-CN
yhqx	又好气又好笑	zh-CN
yhuj	野火烧不尽	zh-CN
yhxd	鱼和熊掌不可兼得	zh-CN
yiub	一传十十传百	zh-CN
yiwv	运筹帷幄之中	zh-CN
yizm	一锤子买卖	zh-CN
yjgk	一将功成万骨枯	zh-CN
yjgt	远近高低各不同	zh-CN
yjrh	一家人不说两家话	zh-CN
yjry	由俭入奢易	zh-CN
yjyn	有借有还，再借不难	zh-CN
ykbv	一客不烦二主	zh-CN
yked	一哭二闹三上吊	zh-CN
ykhb	一颗红心两手准备	zh-CN
ykud	一块石头落了地	zh-CN
ylbg	有理不在声高	zh-CN
ylbz	有两把刷子	zh-CN
ylhj	远来和尚好看经	zh-CN
yluq	有理说不清	zh-CN
ylvx	一览众山小	zh-CN
ylzx	有理走遍天下	zh-CN
ymgm	一码归一码	zh-CN
ymiu	羊毛出在羊身上	zh-CN
yms	一亩三分地	zh-CN
ymzl	夜猫子进宅，无事不来	zh-CN
ynbn	有奶便是娘	zh-CN
ynv	一年之计在于春	zh-CN
yny	一年又一年	zh-CN
ypzl	有朋自远方来	zh-CN
yqav	燕雀安知鸿鹄之志	zh-CN
yqb	远亲不如近邻	zh-CN
yqbf	一去不复返	zh-CN
yqdn	一切都有可能	zh-CN
yqfz	有其父必有其子	zh-CN
yqjn	一切皆有可能	zh-CN
yqjv	一切尽在不言中	zh-CN
yqnm	有钱能使鬼推磨	zh-CN
yqql	欲穷千里目，更上一层楼	zh-CN
yqqm	欲穷千里目	zh-CN
yqti	异曲同工之处	zh-CN
yqtm	异曲同工之妙	zh-CN
yrbq	一日不见如隔三秋	zh-CN
yrfe	一日夫妻百日恩	zh-CN
yrie	一人吃饱，全家不饿	zh-CN
yrwy	月如无恨月长圆	zh-CN
yrzv	庸人自扰之	zh-CN
yslc	压死骆驼的最后一根稻草	zh-CN
yszd	欲速则不达	zh-CN
ytdh	一条道跑到黑	zh-CN
ytlh	一条路走到黑	zh-CN
yuit	严师出高徒	zh-CN
yurn	由奢入俭难	zh-CN
yuzh	一失足成千古恨	zh-CN
yvbg	有志不在年高	zh-CN
yvby	一朝被蛇咬	zh-CN
yvdc	眼中钉，肉中刺	zh-CN
yvfx	医者父母心	zh-CN
yvq	一朝权在手	zh-CN
yvqd	愚者千虑，必有一得	zh-CN
yvqx	一朝权在手，便把令来行	zh-CN
yvtu	硬着头皮上	zh-CN
yvvi	有志者事竟成	zh-CN
yvyf	一眨眼功夫	zh-CN
yws	一问三不知	zh-CN
ywup	一碗水端平	zh-CN
ywx	一物降一物	zh-CN
yxmi	英雄莫问出处	zh-CN
yxng	英雄难过美人关	zh-CN
yxst	英雄所见略同	zh-CN
yxug	疑心生暗鬼	zh-CN
yxvu	一心只读圣贤书	zh-CN
yxwd	英雄无用武之地	zh-CN
yxzs	有限责任公司	zh-CN
yyhl	依样画葫芦	zh-CN
yylb	有一利必有一弊	zh-CN
yylt	银样镴枪头	zh-CN
yytv	冤有头，债有主	zh-CN
yztq	远在天边，近在眼前	zh-CN
yzvd	以子之矛，攻子之盾	zh-CN
zdbx	最毒不过妇人心	zh-CN
zdfx	最毒妇人心	zh-CN
zfyl	子非鱼，安知鱼之乐	zh-CN
zgbt	怎敢不低头	zh-CN
zhyv	最后一分钟	zh-CN
zugd	坐山观虎斗	zh-CN
zvig	再正常不过	zh-CN
zvji	早知今日，何必当初	zh-CN
zwgh	自我感觉良好	zh-CN
zwvj	醉翁之意不在酒	zh-CN
zxdi	宰相肚里能撑船	zh-CN
zybb	走一步看一步	zh-CN
zyqn	增益其所不能	zh-CN
zytv	做一天和尚撞一天钟	zh-CN
zywj	自以为得计	zh-CN
zyyz	子欲养而亲不在	zh-CN
zzbr	自在不成人	zh-CN
zzjj	砸自己的脚	zh-CN
zzjl	走自己的路	zh-CN
zznh	自作孽不可活	zh-CN
jysi	床前明月光，疑是地上霜。举头望明月，低头思故乡。	zh-CN
bdbu	不打不相识	zh-CN
bdjg	不当家不知柴米贵	zh-CN
bdyv	不得已而为之	zh-CN
bjbu	八九不离十	zh-CN
bjly	病急乱投医	zh-CN
buyt	不是冤家不聚头	zh-CN
bwqb	不问青红皂白	zh-CN
fhyr	防患于未然	zh-CN
fubt	肥水不流外人田	zh-CN
gdly	光打雷不下雨	zh-CN
gdzi	功到自然成	zh-CN
ggbu	狗改不了吃屎	zh-CN
gykd	狗眼看人低	zh-CN
jpvj	旧瓶装新酒	zh-CN
jrum	尽人事听天命	zh-CN
jubu	井水不犯河水	zh-CN
lvdd	列支敦士登	zh-CN
lybd	立于不败之地	zh-CN
mbvu	名不正言不顺	zh-CN
qiyl	青出于蓝而胜于蓝	zh-CN
qryu	情人眼里出西施	zh-CN
qyfu	牵一发而动全身	zh-CN
slbj	四两拨千斤	zh-CN
tpti	踏破铁鞋无觅处	zh-CN
tvyj	弹指一挥间	zh-CN
tzbc	兔子不吃窝边草	zh-CN
ubdl	舍不得孩子套不住狼	zh-CN
ubnu	胜败乃兵家常事	zh-CN
uhvl	事后诸葛亮	zh-CN
ulbs	十里不同俗	zh-CN
ulbw	上梁不正下梁歪	zh-CN
uvbx	身正不怕影子斜	zh-CN
uzch	身在曹营心在汉	zh-CN
vjdm	针尖对麦芒	zh-CN
vuvf	重赏之下，必有勇夫	zh-CN
vvqu	智者千虑，必有一失	zh-CN
vvsu	置之死地而后生	zh-CN
vyvy	睁一只眼，闭一只眼	zh-CN
wlbz	无利不起早	zh-CN
xbuf	刑不上大夫	zh-CN
ybbb	以不变应万变	zh-CN
ydbu	有得必有失	zh-CN
yhuu	一回生二回熟	zh-CN
yqru	以其人之道，还治其人之身	zh-CN
yrby	用人不疑，疑人不用	zh-CN
yrwf	一日为师，终生为父	zh-CN
yrzd	一人做事一人当	zh-CN
yujl	一石激起千层浪	zh-CN
yxbi	英雄不问出处	zh-CN
yxby	一心不能二用	zh-CN
yxrf	以小人之心，度君子之腹	zh-CN
yybu	有眼不识泰山	zh-CN
yyjr	一语惊醒梦中人	zh-CN